Curs,Codi centre,Denominació completa,Codi municipi_5,Codi municipi_6,Nom municipi,Dones,Homes,Total
2023/2024,08064751,ESCOLA MAR I CEL,08074,080749,CUBELLES,16,4,20
2023/2024,43013087,INSTITUT ESCOLA CORBATERA,43049,430496,CORNUDELLA DE MONTSANT,21,3,24
2023/2024,43013075,INSTITUT ESCOLA ÀNGEL DE TOBIES,43163,431634,EL VENDRELL,40,24,64
2023/2024,43012988,INSTITUT DE MIAMI,43092,430923,MONT-ROIG DEL CAMP,23,10,33
2023/2024,43012976,INSTITUT ESCOLA MEDITERRANI,43148,431482,TARRAGONA,22,12,34
2023/2024,43012903,ESCOLA EL BOSC - ZER EL FRANCOLÍ,43091,430918,MONT-RAL,1,2,3
2023/2024,43012812,INSTITUT ESCOLA L'AGULLA,43043,430430,EL CATLLAR,40,10,50
2023/2024,43012769,CEE FONT DEL LLEÓ,43123,431233,REUS,18,2,20
2023/2024,43012319,INSTITUT ESCOLA EL PERELLÓ,43104,431042,EL PERELLÓ,43,12,55
2023/2024,43012307,INSTITUT ESCOLA DANIEL MANGRANÉ,43155,431554,TORTOSA,44,14,58
2023/2024,43012289,INSTITUT ESCOLA 3 D'ABRIL,43094,430944,MÓRA LA NOVA,39,11,50
2023/2024,43012113,INSTITUT ESCOLA MARE DE DÉU DEL PORTAL,43022,430228,BATEA,28,5,33
2023/2024,43012095,ESCOLA JOAN MIRÓ,43092,430923,MONT-ROIG DEL CAMP,30,6,36
2023/2024,43012083,INSTITUT ESCOLA PI DEL BURGAR,43123,431233,REUS,45,13,58
2023/2024,43011492,ESCOLA LA CANALETA,43171,431711,VILA-SECA,31,8,39
2023/2024,43011479,INSTITUT TARRAGONA,43148,431482,TARRAGONA,49,14,63
2023/2024,43011418,INSTITUT RODA DE BERÀ,43131,431310,RODA DE BERÀ,24,16,40
2023/2024,43011303,ZER MONTSANT,43035,430350,CABACÉS,0,4,4
2023/2024,43011212,ESCOLA LA BÒBILA,43038,430385,CAMBRILS,27,5,32
2023/2024,43011200,EOI DE SALOU,43905,439057,SALOU,4,1,5
2023/2024,43011194,ESCOLA EL CUCURULL,43131,431310,RODA DE BERÀ,13,5,18
2023/2024,43011170,INSTITUT CRISTÒFOL DESPUIG,43155,431554,TORTOSA,30,18,48
2023/2024,43011145,ESCOLA ELS GANXETS,43123,431233,REUS,13,4,17
2023/2024,43011121,ESCOLA VILAMAR,43037,430379,CALAFELL,15,3,18
2023/2024,43011029,ZER EBRE,43125,431251,RIBA-ROJA D'EBRE,3,1,4
2023/2024,43010980,EOI RIBERA D'EBRE,43093,430939,MÓRA D'EBRE,4,0,4
2023/2024,43010888,INSTITUT DE TECNIFICACIÓ,43014,430141,AMPOSTA,29,28,57
2023/2024,43010864,ESCOLA ISABEL BESORA,43123,431233,REUS,23,5,28
2023/2024,43010852,INSTITUT ROSETA MAURI,43123,431233,REUS,47,20,67
2023/2024,43010839,ESCOLA SERRA MAJOR - ZER L'AGLÀ,43174,431747,LA VILELLA BAIXA,5,0,5
2023/2024,43010815,ESCOLA ELS COSSETANS,43051,430516,CUNIT,25,5,30
2023/2024,43010773,ESCOLA CONSOL FERRÉ,43014,430141,AMPOSTA,25,7,32
2023/2024,43010748,INSTITUT ELS PALLARESOS,43100,431009,ELS PALLARESOS,36,24,60
2023/2024,43010621,ESCOLA CINGLE ROIG - ZER BAIX CAMP NORD,43169,431690,VILAPLANA,3,1,4
2023/2024,43010608,INSTITUT SERRA DE MIRAMAR,43161,431613,VALLS,30,19,49
2023/2024,43010591,ESCOLA ARQUITECTE JUJOL,43100,431009,ELS PALLARESOS,10,5,15
2023/2024,43010581,ESCOLA MAS CLARIANA,43038,430385,CAMBRILS,24,3,27
2023/2024,43010578,INSTITUT FONTANELLES,43031,430311,LES BORGES DEL CAMP,35,17,52
2023/2024,43010554,ZER LES VINYES,43076,430764,MARÇÀ,2,2,4
2023/2024,43010530,ESCOLA MIRAMAR,43171,431711,VILA-SECA,25,5,30
2023/2024,43010529,ESCOLA CAVALLER ARNAU,43129,431299,RIUDOMS,15,3,18
2023/2024,43010505,ESCOLA LA VITXETA,43123,431233,REUS,28,1,29
2023/2024,43010499,CFA PAU CASALS,43043,430430,EL CATLLAR,15,4,19
2023/2024,43010487,ESCOLA MARCEL·LÍ ESQUIUS,43092,430923,MONT-ROIG DEL CAMP,17,3,20
2023/2024,43010414,INSTITUT COSTER DE LA TORRE,43028,430287,LA BISBAL DEL PENEDÈS,44,22,66
2023/2024,43010402,ESCOLA EL ROQUISSAR,43012,430120,ALTAFULLA,16,2,18
2023/2024,43010396,ESCOLA DE PONENT,43148,431482,TARRAGONA,19,1,20
2023/2024,43010372,INSTITUT LA TALAIA,43037,430379,CALAFELL,47,27,74
2023/2024,43010347,INSTITUT MARTA MATA,43905,439057,SALOU,43,22,65
2023/2024,43010335,INSTITUT LA MAR DE LA FRAU,43038,430385,CAMBRILS,30,18,48
2023/2024,43010323,CFA MONTBLANC,43086,430862,MONTBLANC,3,1,4
2023/2024,43010311,CFA RIBERA D'EBRE,43093,430939,MÓRA D'EBRE,4,3,7
2023/2024,43010220,ESCOLA DE MASPUJOLS,43081,430810,MASPUJOLS,13,1,14
2023/2024,43010189,INSTITUT MEDITERRÀNIA,43163,431634,EL VENDRELL,31,22,53
2023/2024,43010165,ESCOLA MARTA MATA,43163,431634,EL VENDRELL,22,6,28
2023/2024,43010153,ESCOLA VORA MAR,43905,439057,SALOU,34,4,38
2023/2024,43010141,ESCOLA GUILLEM FORTUNY,43038,430385,CAMBRILS,28,4,32
2023/2024,43010098,ESCOLA LA GINESTA,43037,430379,CALAFELL,26,6,32
2023/2024,43010086,CFA VILASECA,43171,431711,VILA-SECA,5,2,7
2023/2024,43010074,CFA VALLS,43161,431613,VALLS,4,2,6
2023/2024,43010062,CFA EL VENDRELL,43163,431634,EL VENDRELL,5,3,8
2023/2024,43010037,EOI DEL VENDRELL,43163,431634,EL VENDRELL,4,3,7
2023/2024,43009977,INSTITUT D'ALTAFULLA,43012,430120,ALTAFULLA,38,18,56
2023/2024,43009898,ESCOLA CASTELL DE CALAFELL,43037,430379,CALAFELL,22,9,31
2023/2024,43009886,ESCOLA JOSEP VECIANA,43103,431037,PERAFORT,15,2,17
2023/2024,43009862,EOI DE TORTOSA,43155,431554,TORTOSA,6,4,10
2023/2024,43009850,INSTITUT ERNEST LLUCH I MARTÍ,43051,430516,CUNIT,52,26,78
2023/2024,43009771,CFA TORTOSA,43155,431554,TORTOSA,7,3,10
2023/2024,43009722,INSTITUT CAL·LÍPOLIS,43148,431482,TARRAGONA,102,50,152
2023/2024,43009710,EOI DE REUS,43123,431233,REUS,11,2,13
2023/2024,43009618,ZER MESTRAL,43155,431554,TORTOSA,2,2,4
2023/2024,43009606,ZER BENISSANET-MIRAVET,43026,430265,BENISSANET,3,1,4
2023/2024,43009497,INSTITUT FONTS DEL GLORIETA,43005,430056,ALCOVER,25,10,35
2023/2024,43009461,ZER TERRA ALTA-CENTRE,43048,430483,CORBERA D'EBRE,4,0,4
2023/2024,43009451,ESCOLA SALOU,43905,439057,SALOU,33,3,36
2023/2024,43009394,ZER LA FONT DE L'AIGUADÍ,43067,430672,GINESTAR,1,2,3
2023/2024,43009370,ZER TERRA ALTA NORD,43175,431750,VILALBA DELS ARCS,2,2,4
2023/2024,43009369,ESCOLA SAAVEDRA,43148,431482,TARRAGONA,15,4,19
2023/2024,43009345,ZER RIBERA D'EBRE NORD,43152,431520,LA TORRE DE L'ESPANYOL,3,1,4
2023/2024,43009321,ZER RIU I SERRA,43025,430252,BENIFALLET,3,0,3
2023/2024,43009311,ZER MONT CARO,43133,431331,ROQUETES,4,0,4
2023/2024,43009308,ZER MEDITERRÀNIA,43004,430043,ALCANAR,3,1,4
2023/2024,43009242,ESCOLA L'ANTINA,43153,431536,TORREDEMBARRA,28,5,33
2023/2024,43009230,ESCOLA TARRAGONA,43148,431482,TARRAGONA,23,7,30
2023/2024,43009229,ZER PORTS-ALGARS,43018,430189,ARNES,2,1,3
2023/2024,43009217,ESCOLA DEL POBLE NOU DEL DELTA - ZER MEDITERRÀNIA,43014,430141,AMPOSTA,3,0,3
2023/2024,43009187,INSTITUT MARTÍ L'HUMÀ,43086,430862,MONTBLANC,40,30,70
2023/2024,43009141,ZER POBLET,43176,431763,VIMBODÍ I POBLET,4,0,4
2023/2024,43009138,ZER LA PARELLADA,43059,430593,FIGUEROLA DEL CAMP,2,2,4
2023/2024,43009126,ZER BAIX CAMP SUD,43167,431671,VILANOVA D'ESCORNALBOU,3,1,4
2023/2024,43009096,ZER ELS CEPS,43079,430799,MASLLORENÇ,2,2,4
2023/2024,43009084,ZER MONTSIÀ,43078,430786,MASDENVERGE,3,2,5
2023/2024,43009072,ZER CONCA DE BARBERÀ,43147,431476,SOLIVELLA,4,1,5
2023/2024,43009059,ZER BAIX CAMP NORD,43007,430075,L'ALEIXAR,4,1,5
2023/2024,43009047,ZER BAIX PRIORAT,43114,431140,PORRERA,2,1,3
2023/2024,43009035,ZER ATZAVARA,43165,431652,VILABELLA,1,3,4
2023/2024,43009023,ZER L'AGLÀ,43069,430691,GRATALLOPS,2,1,3
2023/2024,43009011,ZER RIU AVALL,43155,431554,TORTOSA,3,1,4
2023/2024,43009001,ZER MONTSANT-SERRA DE PRADES,43116,431166,PRADES,4,0,4
2023/2024,43008912,ESCOLA CINTA CURTO,43155,431554,TORTOSA,14,3,17
2023/2024,43008857,CFA REUS,43123,431233,REUS,6,4,10
2023/2024,43008754,CFA SEBASTIÀ JUAN ARBÓ,43014,430141,AMPOSTA,6,1,7
2023/2024,43008729,CFA TARRAGONA,43148,431482,TARRAGONA,9,5,14
2023/2024,43008638,INSTITUT ANTONI BALLESTER,43092,430923,MONT-ROIG DEL CAMP,30,22,52
2023/2024,43008547,ESCOLA CAMBRILS,43038,430385,CAMBRILS,26,5,31
2023/2024,43008535,ESCOLA SOLCUNIT,43051,430516,CUNIT,25,6,31
2023/2024,43008523,INSTITUT VILA-SECA,43171,431711,VILA-SECA,50,22,72
2023/2024,43008511,INSTITUT JOAN PUIG I FERRETER,43145,431457,LA SELVA DEL CAMP,34,19,53
2023/2024,43008501,INSTITUT PONT DEL DIABLE,43148,431482,TARRAGONA,34,11,45
2023/2024,43008481,INSTITUT COLLBLANC,43907,439076,LA CANONJA,41,31,72
2023/2024,43008456,INSTITUT LES PLANES,43138,431384,SANTA BÀRBARA,24,15,39
2023/2024,43008444,INSTITUT JOSEP TAPIRÓ,43123,431233,REUS,52,27,79
2023/2024,43008432,INSTITUT SANT PERE I SANT PAU,43148,431482,TARRAGONA,45,16,61
2023/2024,43008420,INSTITUT ROQUETES,43133,431331,ROQUETES,52,21,73
2023/2024,43008419,INSTITUT CAMARLES,43903,439039,CAMARLES,26,17,43
2023/2024,43008407,INSTITUT EL MORELL,43095,430957,EL MORELL,34,30,64
2023/2024,43008390,INSTITUT TORREFORTA,43148,431482,TARRAGONA,45,21,66
2023/2024,43008389,ESCOLA SANT LLATZER,43155,431554,TORTOSA,14,3,17
2023/2024,43007661,INSTITUT RAMON DE LA TORRE,43153,431536,TORREDEMBARRA,49,26,75
2023/2024,43007658,INSTITUT JOAN GUINJOAN I GISPERT,43129,431299,RIUDOMS,50,27,77
2023/2024,43007646,INSTITUT DE CONSTANTÍ,43047,430477,CONSTANTÍ,32,15,47
2023/2024,43007580,INSTITUT DE L'ARBOÇ,43016,430167,L'ARBOÇ,41,27,68
2023/2024,43007543,INSTITUT JAUME I,43905,439057,SALOU,66,25,91
2023/2024,43007385,INSTITUT D'HORTICULTURA I JARDINERIA,43123,431233,REUS,11,21,32
2023/2024,43007257,INSTITUT CAMÍ DE MAR,43037,430379,CALAFELL,58,52,110
2023/2024,43007233,INSTITUT DE FLIX,43060,430607,FLIX,30,16,46
2023/2024,43007221,INSTITUT ELS ALFACS,43136,431362,LA RÀPITA,44,35,79
2023/2024,43007208,INSTITUT BERENGUER D'ENTENÇA,43162,431628,VANDELLÒS I L'HOSPITALET DE L'INFANT,41,12,53
2023/2024,43007178,ESCOLA MOWGLI,43123,431233,REUS,16,1,17
2023/2024,43007166,INSTITUT LLUÍS DOMÈNECH I MONTANER,43123,431233,REUS,46,53,99
2023/2024,43007129,INSTITUT JULIO ANTONIO,43093,430939,MÓRA D'EBRE,32,40,72
2023/2024,43007117,ESCOLA PAX,43148,431482,TARRAGONA,30,2,32
2023/2024,43007105,ESCOLA MONTSANT,43123,431233,REUS,14,3,17
2023/2024,43007087,INSTITUT SÒL DE RIU,43004,430043,ALCANAR,36,23,59
2023/2024,43007051,CFA JOSEPA MASSANÉS I DALMAU,43148,431482,TARRAGONA,6,6,12
2023/2024,43007038,INSTITUT ESCOLA D'HOTELERIA I TURISME,43038,430385,CAMBRILS,28,23,51
2023/2024,43006988,CEE GARBÍ,43163,431634,EL VENDRELL,22,0,22
2023/2024,43006976,INSTITUT CANDELERA,43013,430136,L'AMETLLA DE MAR,26,21,47
2023/2024,43006964,INSTITUT DE DELTEBRE,43901,439018,DELTEBRE,44,28,72
2023/2024,43006952,INSTITUT TORREDEMBARRA,43153,431536,TORREDEMBARRA,35,32,67
2023/2024,43006940,EOI DE TARRAGONA,43148,431482,TARRAGONA,30,6,36
2023/2024,43006873,ESCOLA RIUMAR,43901,439018,DELTEBRE,13,4,17
2023/2024,43006861,ESCOLA ENXANETA,43161,431613,VALLS,16,2,18
2023/2024,43006851,ESCOLA MOLÍ DE VENT,43153,431536,TORREDEMBARRA,28,4,32
2023/2024,43006708,INSTITUT JOAN SEGURA I VALLS,43139,431397,SANTA COLOMA DE QUERALT,15,8,23
2023/2024,43006691,INSTITUT PRIORAT,43055,430555,FALSET,39,22,61
2023/2024,43006681,INSTITUT DE LA SÉNIA,43044,430445,LA SÉNIA,34,12,46
2023/2024,43006678,INSTITUT GABRIEL FERRATER I SOLER,43123,431233,REUS,56,29,85
2023/2024,43006654,INSTITUT CAMBRILS,43038,430385,CAMBRILS,34,19,53
2023/2024,43006642,INSTITUT TERRA ALTA,43064,430640,GANDESA,34,19,53
2023/2024,43006630,INSTITUT PERE MARTELL,43148,431482,TARRAGONA,47,92,139
2023/2024,43006617,INSTITUT JOAN AMIGÓ I CALLAU,43054,430542,L'ESPLUGA DE FRANCOLÍ,19,7,26
2023/2024,43006587,ESCOLA ÀNGELS GARRIGA,43163,431634,EL VENDRELL,29,7,36
2023/2024,43006575,ESCOLA ELADI HOMS,43161,431613,VALLS,20,3,23
2023/2024,43006563,ESCOLA MARCEL·LÍ DOMINGO,43148,431482,TARRAGONA,25,2,27
2023/2024,43006551,ESCOLA HORTA VELLA,43136,431362,LA RÀPITA,27,7,34
2023/2024,43006541,ESCOLA TERESA MIQUEL I PÀMIES,43123,431233,REUS,27,8,35
2023/2024,43006496,INSTITUT MANUEL SALES I FERRÉ,43156,431567,ULLDECONA,35,16,51
2023/2024,43006393,ESCOLA EUROPA,43905,439057,SALOU,33,8,41
2023/2024,43006371,ESCOLA SANT ROC - ZER CONCA DE BARBERÀ,43130,431303,ROCAFORT DE QUERALT,4,0,4
2023/2024,43006356,ESCOLA MARINADA,43038,430385,CAMBRILS,26,7,33
2023/2024,43006332,ESCOLA MESTRAL,43171,431711,VILA-SECA,20,3,23
2023/2024,43006241,ESCOLA LA PLANA,43171,431711,VILA-SECA,10,2,12
2023/2024,43006228,ESCOLA ROSA SENSAT,43123,431233,REUS,16,4,20
2023/2024,43006216,ESCOLA CÈLIA ARTIGA,43123,431233,REUS,15,2,17
2023/2024,43006186,ESCOLA SORIANO MONTAGUT,43014,430141,AMPOSTA,26,7,33
2023/2024,43006174,ESCOLA LES MORERES,43001,430017,AIGUAMÚRCIA,6,3,9
2023/2024,43006125,INSTITUT CAMPCLAR,43148,431482,TARRAGONA,58,21,79
2023/2024,43006101,INSTITUT MONTSIÀ,43014,430141,AMPOSTA,46,66,112
2023/2024,43006061,ESCOLA RUBIÓ I ORS,43123,431233,REUS,31,9,40
2023/2024,43006046,ESCOLA DIVINA PASTORA - ZER MESTRAL,43155,431554,TORTOSA,3,1,4
2023/2024,43005972,INSTITUT RAMON BARBAT I MIRACLE,43171,431711,VILA-SECA,54,37,91
2023/2024,43005959,ESCOLA CÈSAR AUGUST,43148,431482,TARRAGONA,28,5,33
2023/2024,43005947,ESCOLA CAL·LÍPOLIS,43171,431711,VILA-SECA,27,8,35
2023/2024,43005935,ESCOLA SANT BERNAT CALVÓ,43123,431233,REUS,26,7,33
2023/2024,43005911,ESCOLA CAMPCLAR,43148,431482,TARRAGONA,21,4,25
2023/2024,43005901,ESCOLA JOAN REBULL,43123,431233,REUS,34,2,36
2023/2024,43005893,ESCOLA CENTCELLES,43047,430477,CONSTANTÍ,18,5,23
2023/2024,43005765,ESCOLA EDUARD TODA I GÜELL,43123,431233,REUS,27,3,30
2023/2024,43005753,ESCOLA DOCTOR ALBERICH I CASAS,43123,431233,REUS,30,6,36
2023/2024,43005704,INSTITUT FRANCESC VIDAL I BARRAQUER,43148,431482,TARRAGONA,80,58,138
2023/2024,43005698,ESCOLA MARJAL - ZER MEDITERRÀNIA,43004,430043,ALCANAR,8,2,10
2023/2024,43005686,ESCOLA RIU CLAR,43148,431482,TARRAGONA,16,2,18
2023/2024,43005674,ESCOLA RAVAL DE CRISTO - ZER MONT CARO,43133,431331,ROQUETES,8,1,9
2023/2024,43005662,ESCOLA JOSEP NIN,43135,431359,SALOMÓ,6,5,11
2023/2024,43005650,ESCOLA EL DIVÍ MESTRE - ZER TERRA ALTA NORD,43175,431750,VILALBA DELS ARCS,4,0,4
2023/2024,43005637,ESCOLA MANUEL DE CASTELLVÍ I FELIU - ZER ATZAVARA,43165,431652,VILABELLA,5,2,7
2023/2024,43005625,ESCOLA SANT ANTONI ABAT - ZER MONT CARO,43155,431554,TORTOSA,4,1,5
2023/2024,43005613,ESCOLA SETZE DE FEBRER - ZER MEDITERRÀNIA,43902,439023,SANT JAUME D'ENVEJA,4,1,5
2023/2024,43005601,ESCOLA EL TORMO - ZER RIBERA D'EBRE NORD,43152,431520,LA TORRE DE L'ESPANYOL,6,0,6
2023/2024,43005595,ESCOLA LA PARELLADA,43140,431401,SANTA OLIVA,18,6,24
2023/2024,43005583,ESCOLA ELS QUATRE VENTS,43137,431378,SANT JAUME DELS DOMENYS,19,3,22
2023/2024,43005571,ESCOLA LES COMES,43132,431325,RODONYÀ,14,2,16
2023/2024,43005561,ESCOLA MARE DE DÉU DEL ROSER,43128,431286,RIUDECOLS,10,1,11
2023/2024,43005558,ESCOLA SANT MATEU,43127,431270,RIUDECANYES,10,1,11
2023/2024,43005546,ESCOLA DE LA RIBA - ZER EL FRANCOLÍ,43124,431248,LA RIBA,5,2,7
2023/2024,43005534,ESCOLA LES ERES DE RASQUERA - ZER LA FONT DE L'AIGUADÍ,43121,431212,RASQUERA,7,0,7
2023/2024,43005522,ESCOLA SANTA MARINA,43118,431188,PRATDIP,6,4,10
2023/2024,43005510,ESCOLA SERRA DE PRADES - ZER MONTSANT-SERRA DE PRADES,43116,431166,PRADES,4,1,5
2023/2024,43005509,ESCOLA ROSSEND GIOL - ZER BAIX PRIORAT,43114,431140,PORRERA,1,2,3
2023/2024,43005492,ESCOLA SANTA MAGDALENA - ZER LA PARELLADA,43113,431135,EL PONT D'ARMENTERA,4,1,5
2023/2024,43005480,ESCOLA MARE DE DÉU DEL LLEDÓ,43109,431093,LA POBLA DE MAFUMET,27,5,32
2023/2024,43005479,ESCOLA 1 D'ABRIL - ZER EBRE,43099,430995,LA PALMA D'EBRE,1,2,3
2023/2024,43005467,ESCOLA LES CODINETES,43097,430976,LA NOU DE GAIÀ,14,2,16
2023/2024,43005455,ESCOLA PIUS XII - ZER L'AGLÀ,43085,430859,EL MOLAR,2,2,4
2023/2024,43005443,ESCOLA ROC LLOP I CONVALIA - ZER BENISSANET-MIRAVET,43084,430846,MIRAVET,5,1,6
2023/2024,43005421,ESCOLA BERENGUER DE MONTOLIU - ZER ELS CEPS,43079,430799,MASLLORENÇ,3,3,6
2023/2024,43005418,ESCOLA SANT SALVADOR - ZER MONTSIÀ,43068,430688,GODALL,4,1,5
2023/2024,43005406,ESCOLA EL VERGER - ZER RIBERA D'EBRE NORD,43065,430653,GARCIA,3,1,4
2023/2024,43005391,ESCOLA SANT LLORENÇ - ZER MONTSIÀ,43063,430635,LA GALERA,4,2,6
2023/2024,43005388,ESCOLA MESTRE JOSEP RONCERO I PALLARÈS - ZER MONTSIÀ,43062,430629,FREGINALS,3,2,5
2023/2024,43005376,ESCOLA PUIGMARÍ - ZER BAIX CAMP SUD,43053,430537,DUESAIGÜES,1,2,3
2023/2024,43005364,ESCOLA LES ERES,43050,430509,CREIXELL,20,1,21
2023/2024,43005340,ESCOLA SANTA ANNA,43042,430424,CASTELLVELL DEL CAMP,17,2,19
2023/2024,43005339,ESCOLA MONTSANT - ZER MONTSANT,43027,430271,LA BISBAL DE FALSET,2,0,2
2023/2024,43005327,ESCOLA RAMON SUGRAÑES,43011,430115,ALMOSTER,12,3,15
2023/2024,43005315,ESCOLA D'ALFARA DE CARLES,43008,430081,ALFARA DE CARLES,3,1,4
2023/2024,43005303,ESCOLA SANT JORDI - ZER RIU I SERRA,43006,430069,ALDOVER,4,1,5
2023/2024,43005297,ESCOLA JOAN PERUCHO,43002,430022,ALBINYANA,10,7,17
2023/2024,43005194,ESCOLA MEDITERRANI,43906,439060,L'AMPOLLA,15,4,19
2023/2024,43005170,ESCOLA LA FLORESTA,43148,431482,TARRAGONA,14,3,17
2023/2024,43005169,ESCOLA PAU DELCLÒS,43148,431482,TARRAGONA,32,1,33
2023/2024,43005157,ESCOLA MONTOLIU,43126,431264,LA RIERA DE GAIÀ,13,3,16
2023/2024,43005145,ESCOLA ELS AMETLLERS,43111,431114,LA POBLA DE MONTORNÈS,14,5,19
2023/2024,43005133,ESCOLA MARE DE DÉU DEL PRIORAT,43020,430206,BANYERES DEL PENEDÈS,15,3,18
2023/2024,43005121,ESCOLA SANTA CATERINA,43178,431785,VINYOLS I ELS ARCS,12,4,16
2023/2024,43005108,ESCOLA LES ERES - ZER RIBERA D'EBRE NORD,43177,431779,VINEBRE,5,1,6
2023/2024,43005081,ESCOLA MARE DE DÉU DELS TORRENTS - ZER POBLET,43176,431763,VIMBODÍ I POBLET,5,0,5
2023/2024,43005017,ESCOLA DEL MONTGOI - ZER POBLET,43172,431726,VILAVERD,3,0,3
2023/2024,43005005,ESCOLA SANT BERNAT CALVÓ,43171,431711,VILA-SECA,26,5,31
2023/2024,43004979,ESCOLA TORROJA I MIRET,43171,431711,VILA-SECA,26,5,31
2023/2024,43004931,ESCOLA SANTA MARIA DEL MAR,43905,439057,SALOU,32,4,36
2023/2024,43004921,ESCOLA BERNARDÍ TOLRÀ,43170,431704,VILA-RODONA,12,4,16
2023/2024,43004888,ESCOLA FONT DE L'ARC - ZER BAIX CAMP SUD,43167,431671,VILANOVA D'ESCORNALBOU,6,1,7
2023/2024,43004864,ESCOLA PERE VIRGILI,43166,431665,VILALLONGA DEL CAMP,21,3,24
2023/2024,43004815,ESCOLA PAU CASALS,43163,431634,EL VENDRELL,26,4,30
2023/2024,43004803,INSTITUT ANDREU NIN,43163,431634,EL VENDRELL,80,72,152
2023/2024,43004797,INSTITUT BAIX PENEDÈS,43163,431634,EL VENDRELL,43,24,67
2023/2024,43004748,ESCOLA ÀNGEL GUIMERÀ,43163,431634,EL VENDRELL,30,6,36
2023/2024,43004700,ESCOLA VALDELORS,43162,431628,VANDELLÒS I L'HOSPITALET DE L'INFANT,8,4,12
2023/2024,43004657,ESCOLA MESTRAL,43162,431628,VANDELLÒS I L'HOSPITALET DE L'INFANT,34,9,43
2023/2024,43004633,ESCOLA EUGENI D'ORS,43161,431613,VALLS,29,6,35
2023/2024,43004611,INSTITUT JAUME HUGUET,43161,431613,VALLS,75,66,141
2023/2024,43004608,INSTITUT NARCÍS OLLER,43161,431613,VALLS,68,29,97
2023/2024,43004530,ESCOLA PÚBLICA BALTIS DE VALLS,43161,431613,VALLS,18,4,22
2023/2024,43004529,ESCOLA MARE DE DÉU DE LA CANDELA,43161,431613,VALLS,16,3,19
2023/2024,43004517,ESCOLA ROCABRUNA - ZER EL FRANCOLÍ,43161,431613,VALLS,6,2,8
2023/2024,43004505,ESCOLA MARE DE DÉU DEL ROSER,43160,431606,VALLMOLL,14,2,16
2023/2024,43004487,ESCOLA MONTSANT - ZER MONTSANT-SERRA DE PRADES,43157,431573,ULLDEMOLINS,1,2,3
2023/2024,43004463,ESCOLA RAMÓN Y CAJAL,43156,431567,ULLDECONA,31,9,40
2023/2024,43004441,INSTITUT DE L'EBRE,43155,431554,TORTOSA,79,68,147
2023/2024,43004438,INSTITUT DERTOSA,43155,431554,TORTOSA,63,33,96
2023/2024,43004268,ESCOLA REMOLINS,43155,431554,TORTOSA,17,4,21
2023/2024,43004256,ESCOLA FERRERIES,43155,431554,TORTOSA,27,7,34
2023/2024,43004232,ESCOLA LA MERCÈ,43155,431554,TORTOSA,23,3,26
2023/2024,43004189,ESCOLA SANT JAUME,43902,439023,SANT JAUME D'ENVEJA,18,1,19
2023/2024,43004116,ESCOLA DEL LLIGALLO DEL GÀNGUIL - ZER MESTRAL,43903,439039,CAMARLES,7,1,8
2023/2024,43004074,ESCOLA L'ASSUMPCIÓ,43901,439018,DELTEBRE,20,5,25
2023/2024,43004050,ESCOLA 21 D'ABRIL,43904,439044,L'ALDEA,15,3,18
2023/2024,43004037,ESCOLA MARIA GARCÍA I CABANES,43904,439044,L'ALDEA,15,3,18
2023/2024,43004013,ESCOLA SANT MIQUEL,43901,439018,DELTEBRE,25,8,33
2023/2024,43003987,ESCOLA PORT RODÓ - ZER MESTRAL,43155,431554,TORTOSA,11,0,11
2023/2024,43003975,ESCOLA SANT ÀNGEL,43903,439039,CAMARLES,14,3,17
2023/2024,43003951,ESCOLA BÍTEM - ZER RIU AVALL,43155,431554,TORTOSA,5,3,8
2023/2024,43003884,ESCOLA ANTONI ROIG,43153,431536,TORREDEMBARRA,28,6,34
2023/2024,43003847,ESCOLA MARCEL·LÍ DOMINGO,43150,431508,TIVISSA,12,1,13
2023/2024,43003835,ESCOLA JOSEP RIBA - ZER LES VINYES,43150,431508,TIVISSA,3,0,3
2023/2024,43003801,ESCOLA LA PINEDA - ZER RIU AVALL,43149,431495,TIVENYS,7,0,7
2023/2024,43003768,ESCOLA ELS ÀNGELS,43148,431482,TARRAGONA,30,4,34
2023/2024,43003756,ESCOLA TORREFORTA,43148,431482,TARRAGONA,24,10,34
2023/2024,43003732,INSTITUT PONS D'ICART,43148,431482,TARRAGONA,43,14,57
2023/2024,43003720,ESCOLA EL MIRACLE,43148,431482,TARRAGONA,23,2,25
2023/2024,43003690,ESCOLA DE PRÀCTIQUES,43148,431482,TARRAGONA,28,6,34
2023/2024,43003653,INSTITUT COMTE DE RIUS,43148,431482,TARRAGONA,39,53,92
2023/2024,43003641,INSTITUT ANTONI DE MARTÍ I FRANQUÈS,43148,431482,TARRAGONA,79,50,129
2023/2024,43003321,ESCOLA SANT PERE I SANT PAU,43148,431482,TARRAGONA,14,6,20
2023/2024,43003306,ESCOLA SERRALLO,43148,431482,TARRAGONA,16,2,18
2023/2024,43003227,ESCOLA SANT SALVADOR,43148,431482,TARRAGONA,28,11,39
2023/2024,43003185,ESCOLA LA CANONJA,43907,439076,LA CANONJA,34,7,41
2023/2024,43003136,ESCOLA BONAVISTA,43148,431482,TARRAGONA,32,8,40
2023/2024,43003124,ESCOLA SAGRAT COR - ZER CONCA DE BARBERÀ,43147,431476,SOLIVELLA,5,1,6
2023/2024,43003100,ESCOLA ABEL FERRATER,43145,431457,LA SELVA DEL CAMP,29,4,33
2023/2024,43003082,ESCOLA GUILLEM DE CLARAMUNT,43144,431444,LA SECUITA,15,2,17
2023/2024,43003069,ESCOLA SALVADOR NINOT,43142,431423,SARRAL,14,1,15
2023/2024,43003011,ESCOLA COR DE ROURE,43139,431397,SANTA COLOMA DE QUERALT,14,3,17
2023/2024,43003008,ESCOLA JAUME BALMES,43138,431384,SANTA BÀRBARA,25,5,30
2023/2024,43002892,ESCOLA CARLES III,43136,431362,LA RÀPITA,36,8,44
2023/2024,43002831,ESCOLA MESTRE MARCEL·LÍ DOMINGO,43133,431331,ROQUETES,39,6,45
2023/2024,43002776,ESCOLA SALVADOR ESPRIU,43131,431310,RODA DE BERÀ,27,6,33
2023/2024,43002752,ESCOLA BEAT BONAVENTURA GRAN,43129,431299,RIUDOMS,28,1,29
2023/2024,43002661,ESCOLA SANT AGUSTÍ - ZER EBRE,43125,431251,RIBA-ROJA D'EBRE,5,3,8
2023/2024,43002594,INSTITUT BAIX CAMP,43123,431233,REUS,105,55,160
2023/2024,43002582,INSTITUT SALVADOR VILASECA,43123,431233,REUS,48,23,71
2023/2024,43002570,INSTITUT GAUDÍ,43123,431233,REUS,77,30,107
2023/2024,43002272,ESCOLA GENERAL PRIM,43123,431233,REUS,21,4,25
2023/2024,43002259,ESCOLA MARIÀ FORTUNY,43123,431233,REUS,31,4,35
2023/2024,43002247,ESCOLA MISERICÒRDIA,43123,431233,REUS,18,2,20
2023/2024,43002235,ESCOLA POMPEU FABRA,43123,431233,REUS,18,3,21
2023/2024,43002211,ESCOLA PRAT DE LA RIBA,43123,431233,REUS,14,3,17
2023/2024,43002171,ESCOLA JOAN PLANA,43119,431191,PUIGPELAT,15,0,15
2023/2024,43002144,ESCOLA MARE DE DÉU DE LA FONTCALDA - ZER PORTS-ALGARS,43117,431172,PRAT DE COMTE,2,1,3
2023/2024,43002053,ESCOLA GARBÍ - ZER MONTSANT-SERRA DE PRADES,43112,431129,POBOLEDA,3,1,4
2023/2024,43002016,ESCOLA L'AMETLLER - ZER TERRA ALTA NORD,43110,431107,LA POBLA DE MASSALUCA,2,2,4
2023/2024,43001966,ESCOLA SANT RAMON,43108,431080,EL PLA DE SANTA MARIA,14,4,18
2023/2024,43001954,ESCOLA ANTONI TOUS - ZER CONCA DE BARBERÀ,43107,431074,PIRA,5,2,7
2023/2024,43001942,ESCOLA CÈSAR MARTINELL - ZER TERRA ALTA-CENTRE,43106,431068,EL PINELL DE BRAI,4,3,7
2023/2024,43001851,ESCOLA SANT ROC - ZER RIU I SERRA,43102,431021,PAÜLS,3,2,5
2023/2024,43001826,ESCOLA SANT SEBASTIÀ,43100,431009,ELS PALLARESOS,22,2,24
2023/2024,43001796,ESCOLA SANT SEBASTIÀ,43098,430982,NULLES,8,3,11
2023/2024,43001735,ESCOLA VENTURA GASSOL,43095,430957,EL MORELL,30,3,33
2023/2024,43001681,ESCOLA LLUÍS VIÑAS I VIÑOLES,43093,430939,MÓRA D'EBRE,26,2,28
2023/2024,43001668,ESCOLA MARE DE DÉU DE LA ROCA,43092,430923,MONT-ROIG DEL CAMP,26,5,31
2023/2024,43001656,ESCOLA TERESA GODES I DOMÈNECH,43090,430901,EL MONTMELL,15,1,16
2023/2024,43001607,ESCOLA JOSEP M. SOLER I GENÉ,43088,430884,MONTBRIÓ DEL CAMP,18,6,24
2023/2024,43001553,ESCOLA LES MURALLES,43086,430862,MONTBLANC,27,5,32
2023/2024,43001498,ESCOLA ONZE DE SETEMBRE - ZER BAIX PRIORAT,43082,430825,EL MASROIG,2,2,4
2023/2024,43001462,ESCOLA ELS TIL·LERS - ZER EL FRANCOLÍ,43080,430803,LA MASÓ,4,0,4
2023/2024,43001437,ESCOLA ROSA GISBERT - ZER MONTSIÀ,43078,430786,MASDENVERGE,7,2,9
2023/2024,43001395,ESCOLA TERESA SUBIRATS I MESTRE - ZER MONTSIÀ,43077,430770,MAS DE BARBERANS,3,1,4
2023/2024,43001383,ESCOLA ANICET VILLAR - ZER LES VINYES,43076,430764,MARÇÀ,2,2,4
2023/2024,43001361,ESCOLA LES COMETES,43074,430748,LLORENÇ DEL PENEDÈS,19,5,24
2023/2024,43001346,ESCOLA MONTSAGRE,43071,430712,HORTA DE SANT JOAN,9,2,11
2023/2024,43001334,ESCOLA SANT FELIU - ZER LES VINYES,43070,430705,ELS GUIAMETS,2,1,3
2023/2024,43001310,ESCOLA LLICORELLA - ZER L'AGLÀ,43069,430691,GRATALLOPS,2,1,3
2023/2024,43001280,ESCOLA PÀMIES - ZER LA FONT DE L'AIGUADÍ,43067,430672,GINESTAR,8,0,8
2023/2024,43001231,ESCOLA PUIG CAVALLER,43064,430640,GANDESA,24,6,30
2023/2024,43001127,ESCOLA ENRIC GRAU I FONTSERÈ,43060,430607,FLIX,22,2,24
2023/2024,43001115,ESCOLA MARE DE DÉU DE L'ESPERANÇA - ZER LA PARELLADA,43059,430593,FIGUEROLA DEL CAMP,5,1,6
2023/2024,43001097,ESCOLA LOS CASTELLETS - ZER TERRA ALTA NORD,43056,430568,LA FATARELLA,6,0,6
2023/2024,43001051,ESCOLA ANTONI VILANOVA,43055,430555,FALSET,21,3,24
2023/2024,43001036,ESCOLA MARTÍ POCH,43054,430542,L'ESPLUGA DE FRANCOLÍ,15,1,16
2023/2024,43001000,ESCOLA DE XERTA,43052,430521,XERTA,9,2,11
2023/2024,43000998,ESCOLA POMPEU FABRA,43051,430516,CUNIT,24,5,29
2023/2024,43000950,ESCOLA DOCTOR FERRAN - ZER TERRA ALTA-CENTRE,43048,430483,CORBERA D'EBRE,6,1,7
2023/2024,43000895,ESCOLA MOSSÈN RAMON BERGADÀ,43047,430477,CONSTANTÍ,31,8,39
2023/2024,43000871,ESCOLA MARIA JESÚS ORTÍ I ABELLA,43044,430445,LA SÉNIA,29,7,36
2023/2024,43000809,ESCOLA LA GESSERA - ZER PORTS-ALGARS,43041,430419,CASERES,1,2,3
2023/2024,43000792,ESCOLA SANT ISIDRE - ZER LES VINYES,43040,430402,CAPÇANES,3,1,4
2023/2024,43000779,INSTITUT RAMON BERENGUER IV,43038,430385,CAMBRILS,38,30,68
2023/2024,43000721,ESCOLA MOSSÈN JACINT VERDAGUER,43037,430379,CALAFELL,30,9,39
2023/2024,43000706,ESCOLA SANTA CREU DE CALAFELL,43037,430379,CALAFELL,36,11,47
2023/2024,43000688,ESCOLA DE CABRA DEL CAMP - ZER LA PARELLADA,43036,430363,CABRA DEL CAMP,3,3,6
2023/2024,43000676,ESCOLA EL CASTELL - ZER MONTSANT,43035,430350,CABACÉS,3,0,3
2023/2024,43000652,ESCOLA SANT JAUME DE BRÀFIM - ZER ATZAVARA,43034,430347,BRÀFIM,5,3,8
2023/2024,43000640,ESCOLA MARE DE DÉU DE LA CANDELA,43033,430332,BOTARELL,16,0,16
2023/2024,43000639,ESCOLA SANT BLAI - ZER TERRA ALTA-CENTRE,43032,430326,BOT,6,0,6
2023/2024,43000627,ESCOLA ROCABRUNA,43031,430311,LES BORGES DEL CAMP,12,5,17
2023/2024,43000615,ESCOLA L'ESTEL - ZER ELS CEPS,43030,430304,BONASTRE,2,4,6
2023/2024,43000603,ESCOLA DE BLANCAFORT - ZER POBLET,43029,430290,BLANCAFORT,4,0,4
2023/2024,43000597,ESCOLA ULL DEL VENT,43028,430287,LA BISBAL DEL PENEDÈS,20,6,26
2023/2024,43000561,ESCOLA ANTONI NAT - ZER BENISSANET-MIRAVET,43026,430265,BENISSANET,7,1,8
2023/2024,43000551,ESCOLA LLORENÇ VALLESPÍ I VIDIELLA - ZER RIU I SERRA,43025,430252,BENIFALLET,4,1,5
2023/2024,43000548,ESCOLA LA MUNTANYETA,43024,430249,BELLVEI,20,3,23
2023/2024,43000512,ESCOLA EL SARRAÍ - ZER BAIX PRIORAT,43023,430234,BELLMUNT DEL PRIORAT,2,1,3
2023/2024,43000470,ESCOLA VALLDEMUR - ZER CONCA DE BARBERÀ,43021,430213,BARBERÀ DE LA CONCA,5,2,7
2023/2024,43000433,ESCOLA SANT MIQUEL,43019,430192,ASCÓ,15,2,17
2023/2024,43000421,ESCOLA LA MIRANDA - ZER PORTS-ALGARS,43018,430189,ARNES,4,1,5
2023/2024,43000378,ESCOLA SANT JULIÀ,43016,430167,L'ARBOÇ,27,10,37
2023/2024,43000329,INSTITUT RAMON BERENGUER IV,43014,430141,AMPOSTA,50,29,79
2023/2024,43000275,ESCOLA MIQUEL GRANELL,43014,430141,AMPOSTA,25,7,32
2023/2024,43000263,ESCOLA SANT JORDI,43013,430136,L'AMETLLA DE MAR,34,3,37
2023/2024,43000251,ESCOLA LA PORTALADA,43012,430120,ALTAFULLA,29,3,32
2023/2024,43000226,ESCOLA LA BARQUERA - ZER ATZAVARA,43010,430108,ALIÓ,4,0,4
2023/2024,43000214,ESCOLA JOSEP FUSTÉ,43009,430094,ALFORJA,14,2,16
2023/2024,43000184,ESCOLA TERESA SALVAT I LLAURADÓ - ZER BAIX CAMP NORD,43007,430075,L'ALEIXAR,4,1,5
2023/2024,43000135,ESCOLA MARE DE DÉU DEL REMEI,43005,430056,ALCOVER,28,6,34
2023/2024,43000081,ESCOLA JOAN BAPTISTA SERRA,43004,430043,ALCANAR,44,3,47
2023/2024,43000020,ESCOLA SANT MIQUEL,43001,430017,AIGUAMÚRCIA,5,1,6
2023/2024,25010450,INSTITUT NOU ALCARRÀS,25011,250117,ALCARRÀS,8,3,11
2023/2024,25010413,ESCOLA MINERVA,25120,251207,LLEIDA,28,7,35
2023/2024,25010383,INSTITUT ESCOLA D'OLIANA,25149,251497,OLIANA,23,10,33
2023/2024,25010361,INSTITUT CENTRE D'ESPORTS DE MUNTANYA DEL PALLARS,25171,251713,LA POBLA DE SEGUR,9,13,22
2023/2024,25010358,INSTITUT ESCOLA VALL DE LORD,25193,251930,SANT LLORENÇ DE MORUNYS,15,7,22
2023/2024,25010334,INSTITUT ESCOLA MAGRANERS,25120,251207,LLEIDA,20,13,33
2023/2024,25010310,INSTITUT SALT DEL DURAN,25137,251370,MOLLERUSSA,28,6,34
2023/2024,25010280,INSTITUT ESCOLA TORRE QUERALT,25120,251207,LLEIDA,33,10,43
2023/2024,25010231,ESCOLA DE SALÀS DE PALLARS - ZER PALLARS JUSSÀ,25190,251902,SALÀS DE PALLARS,3,1,4
2023/2024,25010127,INSTITUT CASTELL DELS TEMPLERS,25120,251207,LLEIDA,26,15,41
2023/2024,25010085,ESCOLA JOSEP MAÑÉ I GAVALDÀ - ZER PONENT,25120,251207,LLEIDA,6,0,6
2023/2024,25009836,INSTITUT LA MITJANA,25120,251207,LLEIDA,42,12,54
2023/2024,25009800,ESCOLA TORRELAMEU - ZER ARGELAGA,25231,252311,TORRELAMEU,5,0,5
2023/2024,25009733,INSTITUT JOAN SOLÀ,25228,252287,TORREFARRERA,43,18,61
2023/2024,25009721,INSTITUT D'ALPICAT,25023,250236,ALPICAT,19,9,28
2023/2024,25009356,ESCOLA LES ARRELS,25137,251370,MOLLERUSSA,16,4,20
2023/2024,25009344,ESCOLA LA MITJANA,25120,251207,LLEIDA,28,4,32
2023/2024,25009186,INSTITUT LA VALIRA,25203,252038,LA SEU D'URGELL,16,8,24
2023/2024,25009113,ESCOLA MESTRE RAMON ESTADELLA I TORRADEFLOT,25110,251109,GUISSONA,31,0,31
2023/2024,25009101,ESCOLA EL VINYET,25207,252075,SOLSONA,18,0,18
2023/2024,25009095,ESCOLA LES SAVINES,25072,250729,CERVERA,14,4,18
2023/2024,25009071,ESCOLA PAÏSOS CATALANS,25120,251207,LLEIDA,31,2,33
2023/2024,25009034,ESCOLA CIUTAT JARDÍ,25120,251207,LLEIDA,28,4,32
2023/2024,25009009,ZER EL SOLSONÈS,25207,252075,SOLSONA,4,1,5
2023/2024,25008984,CFA TREMP,25234,252347,TREMP,3,0,3
2023/2024,25008935,ESCOLA LA RÀPITA - ZER EL JONC,25240,252402,VALLFOGONA DE BALAGUER,4,0,4
2023/2024,25008923,CFA ENRIC GRANADOS,25120,251207,LLEIDA,8,7,15
2023/2024,25008893,ESCOLA PARC DEL SALADAR,25011,250117,ALCARRÀS,38,3,41
2023/2024,25008790,ESCOLA MARIA-MERCÈ MARÇAL,25217,252173,TÀRREGA,27,5,32
2023/2024,25008789,ESCOLA MONT-ROIG,25040,250404,BALAGUER,17,4,21
2023/2024,25008777,ESCOLA PARC DE L'AIGUA,25120,251207,LLEIDA,29,4,33
2023/2024,25008765,ESCOLA LA VALL FOSCA - ZER PALLARS JUSSÀ,25227,252271,LA TORRE DE CABDELLA,5,1,6
2023/2024,25008753,CFA SOLSONÈS,25207,252075,SOLSONA,6,1,7
2023/2024,25008741,CFA VAL D'ARAN,25243,252430,VIELHA E MIJARAN,2,1,3
2023/2024,25008649,ESCOLA FRANCESCO TONUCCI,25120,251207,LLEIDA,20,2,22
2023/2024,25008625,CFA MOLLERUSSA,25137,251370,MOLLERUSSA,6,4,10
2023/2024,25008595,CFA TÀRREGA,25217,252173,TÀRREGA,4,3,7
2023/2024,25008583,CFA LA SEU D'URGELL,25203,252038,LA SEU D'URGELL,5,1,6
2023/2024,25008571,CFA JOAN COMORERA,25072,250729,CERVERA,4,2,6
2023/2024,25008561,CFA BALAGUER,25040,250404,BALAGUER,2,3,5
2023/2024,25008558,EOI DE LA SEU D'URGELL,25203,252038,LA SEU D'URGELL,5,3,8
2023/2024,25008546,EOI DE TÀRREGA,25217,252173,TÀRREGA,7,1,8
2023/2024,25008534,ESCOLA DE LA VALL DE BOÍ - ZER ALTA RIBAGORÇA,25043,250432,LA VALL DE BOÍ,8,0,8
2023/2024,25008352,INSTITUT DE LA POBLA DE SEGUR,25171,251713,LA POBLA DE SEGUR,22,12,34
2023/2024,25008236,ZER PEDRERA,25081,250812,L'ESPLUGA CALBA,2,1,3
2023/2024,25008224,ZER ARGELAGA,25254,252542,VILANOVA DE LA BARCA,2,1,3
2023/2024,25008212,ESCOLA PRÀCTIQUES II,25120,251207,LLEIDA,29,3,32
2023/2024,25008157,ZER RIU ONDARA,25225,252252,TORNABOUS,3,1,4
2023/2024,25008145,ZER ALT SEGRIÀ,25251,252516,VILANOVA DE SEGRIÀ,3,1,4
2023/2024,25008133,ZER PONENT,25120,251207,LLEIDA,4,1,5
2023/2024,25008111,ZER LA COMA,25211,252115,SUDANELL,3,1,4
2023/2024,25008108,ZER L'ERAL,25200,252000,SARROCA DE LLEIDA,4,2,6
2023/2024,25008091,ZER VENT SERÈ,25068,250680,CASTELLNOU DE SEANA,4,1,5
2023/2024,25008081,ZER EL JONC,25062,250621,CAMARASA,3,2,5
2023/2024,25008078,ZER EL ROMANÍ,25138,251386,MONTGAI,4,2,6
2023/2024,25008066,ZER ESPERNALLAC,25070,250707,CASTELLSERÀ,4,1,5
2023/2024,25008054,ZER VALL DE L'ARANYÓ,25067,250674,CASTELLDANS,3,1,4
2023/2024,25008042,ZER RIU SET,25009,250096,L'ALBI,3,2,5
2023/2024,25007992,ESCOLA D'ALMENAR,25021,250215,ALMENAR,20,3,23
2023/2024,25007943,ZER PLAURCÉN,25168,251689,EL POAL,4,1,5
2023/2024,25007931,ZER VAL D'ARAN,25025,250254,NAUT ARAN,3,2,5
2023/2024,25007921,ZER L'HORTA DE LLEIDA,25120,251207,LLEIDA,4,1,5
2023/2024,25007918,ZER L'OLIVER,25133,251333,MAIALS,5,1,6
2023/2024,25007906,ZER SERRA LLARGA,25015,250156,ALGERRI,1,3,4
2023/2024,25007891,ZER ALTA RIBAGORÇA,25245,252458,VILALLER,5,1,6
2023/2024,25007888,ZER GARRIGUES ALTES,25118,251180,JUNCOSA,3,2,5
2023/2024,25007876,ZER RIU CORB,25046,250463,BELIANES,4,1,5
2023/2024,25007864,ZER URGELLET,25203,252038,LA SEU D'URGELL,5,0,5
2023/2024,25007852,ZER EL SIÓ,25138,251386,MONTGAI,4,0,4
2023/2024,25007840,ZER MONTSEC,25037,250371,LES AVELLANES I SANTA LINYA,4,2,6
2023/2024,25007839,ZER PALLARS JUSSÀ,25115,251155,ISONA I CONCA DELLÀ,3,2,5
2023/2024,25007827,ZER NARIEDA,25155,251556,ORGANYÀ,4,1,5
2023/2024,25007815,ZER ELAIA,25101,251018,LA GRANADELLA,2,2,4
2023/2024,25007803,ZER ALT PALLARS SOBIRÀ,25126,251266,LLAVORSÍ,5,0,5
2023/2024,25007797,ZER BARIDÀ-BATLLIA,25139,251399,MONTELLÀ I MARTINET,4,1,5
2023/2024,25007773,ZER LA SEGARRA,25905,259059,RIBERA D'ONDARA,3,2,5
2023/2024,25007761,ZER GUICIVERVI,25244,252445,VILAGRASSA,4,1,5
2023/2024,25007700,INSTITUT ERMENGOL IV,25047,250479,BELLCAIRE D'URGELL,32,8,40
2023/2024,25007611,CFA VICTORINA VILA,25120,251207,LLEIDA,7,5,12
2023/2024,25007529,INSTITUT SERÒS,25204,252043,SERÒS,29,21,50
2023/2024,25007517,INSTITUT LA SERRA,25137,251370,MOLLERUSSA,40,18,58
2023/2024,25007505,INSTITUT DE GUISSONA,25110,251109,GUISSONA,47,28,75
2023/2024,25007499,INSTITUT L'OLIVERA,25101,251018,LA GRANADELLA,7,6,13
2023/2024,25007189,INSTITUT MARIA RÚBIES,25120,251207,LLEIDA,44,19,63
2023/2024,25007153,INSTITUT D'ALCARRÀS,25011,250117,ALCARRÀS,53,18,71
2023/2024,25007025,INSTITUT MORELLÓ,25086,250864,ESTERRI D'ÀNEU,7,7,14
2023/2024,25006781,INSTITUT ALFONS COSTAFREDA,25217,252173,TÀRREGA,54,39,93
2023/2024,25006771,INSTITUT RONDA,25120,251207,LLEIDA,80,18,98
2023/2024,25006744,CEE ESPERANÇA,25120,251207,LLEIDA,14,4,18
2023/2024,25006732,INSTITUT TORREVICENS,25120,251207,LLEIDA,122,31,153
2023/2024,25006720,INSTITUT D'HOTELERIA I TURISME,25120,251207,LLEIDA,18,17,35
2023/2024,25006598,INSTITUT LO PLA D'URGELL,25050,250501,BELLPUIG,35,19,54
2023/2024,25006574,INSTITUT DE PONTS,25172,251728,PONTS,19,7,26
2023/2024,25006549,ESCOLA D'ESPLUGA DE SERRA - ZER ALTA RIBAGORÇA,25234,252347,TREMP,2,0,2
2023/2024,25006525,INSTITUT JOSEP VALLVERDÚ,25058,250582,LES BORGES BLANQUES,55,21,76
2023/2024,25006513,INSTITUT MANUEL DE MONTSUAR,25120,251207,LLEIDA,50,10,60
2023/2024,25006501,ESCOLA ALBA,25078,250788,CORBINS,29,3,32
2023/2024,25006495,INSTITUT JOSEP LLADONOSA,25120,251207,LLEIDA,38,22,60
2023/2024,25006483,INSTITUT CANIGÓ,25019,250194,ALMACELLES,31,18,49
2023/2024,25006410,CFA SEGRIÀ,25120,251207,LLEIDA,8,4,12
2023/2024,25006409,ESCOLA JOC DE LA BOLA,25120,251207,LLEIDA,31,3,34
2023/2024,25006291,INSTITUT HUG ROGER III,25209,252094,SORT,27,16,43
2023/2024,25006288,INSTITUT DE TREMP,25234,252347,TREMP,43,22,65
2023/2024,25006276,ESCOLA SANT JORDI,25120,251207,LLEIDA,15,2,17
2023/2024,25006264,ESCOLA ESPIGA,25120,251207,LLEIDA,27,2,29
2023/2024,25006252,EOI DE LLEIDA,25120,251207,LLEIDA,33,8,41
2023/2024,25006240,INSTITUT EL PONT DE SUERT,25173,251734,EL PONT DE SUERT,32,16,48
2023/2024,25006239,INSTITUT D'ARAN,25243,252430,VIELHA E MIJARAN,39,20,59
2023/2024,25006227,INSTITUT D'ALMENAR,25021,250215,ALMENAR,32,14,46
2023/2024,25006148,INSTITUT D'OSTALARIA DE LES-VAL D'ARAN,25121,251214,LES,6,7,13
2023/2024,25006069,ESCOLA D'ARDÈVOL - ZER EL SOLSONÈS,25167,251673,PINÓS,3,0,3
2023/2024,25005983,ESCOLA SANT SERNI - ZER BARIDÀ-BATLLIA,25175,251752,PRATS I SANSOR,5,0,5
2023/2024,25005910,ESCOLA ABAT RUERA - ZER PEDRERA,25180,251804,PUIGGRÒS,4,1,5
2023/2024,25005892,ESCOLA MALDANELL - ZER RIU CORB,25130,251305,MALDÀ,2,0,2
2023/2024,25005880,ESCOLA FREDERIC GODAS,25120,251207,LLEIDA,28,6,34
2023/2024,25005727,INSTITUT ALMATÀ,25040,250404,BALAGUER,55,24,79
2023/2024,25005685,INSTITUT LA SEGARRA,25072,250729,CERVERA,56,23,79
2023/2024,25005673,ESCOLA JOAN MARAGALL,25120,251207,LLEIDA,16,7,23
2023/2024,25005582,INSTITUT TERRES DE PONENT,25137,251370,MOLLERUSSA,51,7,58
2023/2024,25005557,CEE SILOÉ,25137,251370,MOLLERUSSA,10,2,12
2023/2024,25005545,ESCOLA POMPEU FABRA,25137,251370,MOLLERUSSA,31,2,33
2023/2024,25005533,ESCOLA PAU CLARIS,25203,252038,LA SEU D'URGELL,21,3,24
2023/2024,25005454,INSTITUT FRANCESC RIBALTA,25207,252075,SOLSONA,45,22,67
2023/2024,25005442,INSTITUT ESCOLA DEL TREBALL,25120,251207,LLEIDA,54,42,96
2023/2024,25005430,ESCOLA JOAN XXIII,25120,251207,LLEIDA,19,4,23
2023/2024,25005429,INSTITUT ELS PLANELLS,25034,250349,ARTESA DE SEGRE,28,9,37
2023/2024,25005260,INSTITUT RIBERA DEL SIÓ,25003,250030,AGRAMUNT,34,15,49
2023/2024,25005171,ESCOLA MESTRE IGNASI PERAIRE,25137,251370,MOLLERUSSA,23,8,31
2023/2024,25005144,ESCOLA ÀNGEL SERAFÍ I CASANOVAS,25209,252094,SORT,21,2,23
2023/2024,25005120,ESCOLA TERESA BERGADÀ,25016,250169,ALGUAIRE,19,1,20
2023/2024,25005119,ESCOLA PINYANA,25013,250138,ALFARRÀS,22,1,23
2023/2024,25005107,ESCOLA SANT BONIFACI - ZER RIU SET,25255,252555,VINAIXA,3,1,4
2023/2024,25005090,ESCOLA MESTRAL - ZER ARGELAGA,25254,252542,VILANOVA DE LA BARCA,5,2,7
2023/2024,25005077,ESCOLA MOSSÈN TON CLAVÉ - ZER VENT SERÈ,25252,252521,VILA-SANA,8,0,8
2023/2024,25005065,ESCOLA DE VILANOVA DE SEGRIÀ - ZER ALT SEGRIÀ,25251,252516,VILANOVA DE SEGRIÀ,6,2,8
2023/2024,25005053,ESCOLA MARE DE DÉU DEL PUIG DE MEIÀ - ZER EL ROMANÍ,25250,252509,VILANOVA DE MEIÀ,3,0,3
2023/2024,25005016,ESCOLA MARINADA,25248,252483,VILANOVA DE BELLPUIG,15,1,16
2023/2024,25004981,ESCOLA VIDAL I ABAD - ZER ALTA RIBAGORÇA,25245,252458,VILALLER,5,0,5
2023/2024,25004966,ESCOLA RAMON PERELLÓ - ZER GUICIVERVI,25244,252445,VILAGRASSA,9,0,9
2023/2024,25004929,ESCOLA GARONA,25243,252430,VIELHA E MIJARAN,36,6,42
2023/2024,25004863,ESCOLA JARDÍ - ZER GUICIVERVI,25242,252424,VERDÚ,6,1,7
2023/2024,25004851,ESCOLA SALVADOR ESPRIU,25240,252402,VALLFOGONA DE BALAGUER,14,2,16
2023/2024,25004826,ESCOLA DE TUIXENT - ZER URGELLET,25910,259101,JOSA I TUIXÉN,2,0,2
2023/2024,25004772,ESCOLA VALLDEFLORS,25234,252347,TREMP,30,2,32
2023/2024,25004759,ESCOLA EL ROSER - ZER ALT SEGRIÀ,25233,252332,TORRE-SERONA,3,0,3
2023/2024,25004747,ESCOLA CARRASSUMADA,25232,252326,TORRES DE SEGRE,15,1,16
2023/2024,25004723,ESCOLA LA BASSA,25230,252304,TORREGROSSA,14,3,17
2023/2024,25004711,ESCOLA LA CREU,25228,252287,TORREFARRERA,28,3,31
2023/2024,25004656,ESCOLA DE TORREBESSES - ZER L'ERAL,25226,252265,TORREBESSES,3,0,3
2023/2024,25004644,ESCOLA ESPÍGOL - ZER RIU ONDARA,25225,252252,TORNABOUS,7,1,8
2023/2024,25004607,ESCOLA SANT GIL,25223,252234,TORÀ,15,0,15
2023/2024,25004577,ESCOLA DE TÍRVIA - ZER ALT PALLARS SOBIRÀ,25221,252213,TÍRVIA,2,0,2
2023/2024,25004565,ESCOLA ALFRED POTRONY,25220,252206,TÉRMENS,11,1,12
2023/2024,25004531,ESCOLA ÀNGEL GUIMERÀ,25217,252173,TÀRREGA,30,3,33
2023/2024,25004528,EA ONDARA,25217,252173,TÀRREGA,26,15,41
2023/2024,25004498,INSTITUT MANUEL DE PEDROLO,25217,252173,TÀRREGA,37,15,52
2023/2024,25004462,ESCOLA JACINT VERDAGUER,25217,252173,TÀRREGA,30,5,35
2023/2024,25004413,ESCOLA DE SUNYER - ZER L'ERAL,25212,252120,SUNYER,3,0,3
2023/2024,25004401,ESCOLA EL ROSER - ZER LA COMA,25211,252115,SUDANELL,7,0,7
2023/2024,25004395,ESCOLA JAUME MIRET,25210,252108,SOSES,17,1,18
2023/2024,25004243,ESCOLA SETELSIS,25207,252075,SOLSONA,31,4,35
2023/2024,25004231,ESCOLA DEL SOLERÀS - ZER GARRIGUES ALTES,25206,252069,EL SOLERÀS,3,0,3
2023/2024,25004221,ESCOLA EL TIMÓ - ZER PLAURCÉN,25205,252056,SIDAMON,7,1,8
2023/2024,25004218,ESCOLA MIQUEL BARÓ DABAN,25204,252043,SERÒS,18,2,20
2023/2024,25004188,INSTITUT JOAN BRUDIEU,25203,252038,LA SEU D'URGELL,55,32,87
2023/2024,25004140,ESCOLA MOSSÈN ALBERT VIVES,25203,252038,LA SEU D'URGELL,32,3,35
2023/2024,25004115,ESCOLA LA ROCA - ZER L'ERAL,25200,252000,SARROCA DE LLEIDA,3,0,3
2023/2024,25004103,ESCOLA EL TALLAT - ZER RIU CORB,25902,259025,SANT MARTÍ DE RIUCORB,6,1,7
2023/2024,25004085,ESCOLA VALL ONDARA - ZER LA SEGARRA,25905,259059,RIBERA D'ONDARA,6,0,6
2023/2024,25004073,ESCOLA MARE DE DÉU DE LA MERCÈ,25194,251945,SANT RAMON,12,1,13
2023/2024,25004036,ESCOLA L'ESTEL,25192,251924,SANT GUIM DE FREIXENET,14,3,17
2023/2024,25004024,ESCOLA DE SANAÜJA - ZER LA SEGARRA,25191,251919,SANAÜJA,1,2,3
2023/2024,25004000,ESCOLA LA ROSELLA,25189,251898,ROSSELLÓ,23,2,25
2023/2024,25003974,ESCOLA DE FREIXINET DE SOLSONA - ZER EL SOLSONÈS,25186,251863,RINER,3,1,4
2023/2024,25003950,ESCOLA ARNAU MIR - ZER URGELLET,25185,251850,RIBERA D'URGELLET,5,0,5
2023/2024,25003895,ESCOLA ELS MINAIRONS - ZER ALT PALLARS SOBIRÀ,25901,259010,VALL DE CARDÓS,6,0,6
2023/2024,25003871,ESCOLA MONTSENT DE PALLARS - ZER ALT PALLARS SOBIRÀ,25183,251832,RIALP,5,0,5
2023/2024,25003861,ESCOLA SANT JORDI,25182,251826,PUIGVERD DE LLEIDA,12,0,12
2023/2024,25003858,ESCOLA DE PUIGVERD D'AGRAMUNT - ZER EL SIÓ,25181,251811,PUIGVERD D'AGRAMUNT,1,1,2
2023/2024,25003846,ESCOLA EL PUIG - ZER BARIDÀ-BATLLIA,25179,251790,PRULLANS,3,0,3
2023/2024,25003810,ESCOLA DE PREIXENS - ZER EL SIÓ,25177,251771,PREIXENS,2,1,3
2023/2024,25003809,ESCOLA MONTALBÀ - ZER RIU CORB,25176,251765,PREIXANA,4,0,4
2023/2024,25003792,ESCOLA BLANCA DE VILLALONGA - ZER ALT SEGRIÀ,25174,251749,LA PORTELLA,7,0,7
2023/2024,25003755,ESCOLA RIBAGORÇANA,25173,251734,EL PONT DE SUERT,16,2,18
2023/2024,25003718,ESCOLA DE PONTS,25172,251728,PONTS,23,2,25
2023/2024,25003688,ESCOLA ELS RAIERS,25171,251713,LA POBLA DE SEGUR,22,3,25
2023/2024,25003676,ESCOLA ELS SET FOCS - ZER ELAIA,25170,251706,BELLAGUARDA,3,0,3
2023/2024,25003652,ESCOLA EL ROSER - ZER PLAURCÉN,25168,251689,EL POAL,6,1,7
2023/2024,25003627,ESCOLA DE SANT CLIMENÇ - ZER EL SOLSONÈS,25166,251667,PINELL DE SOLSONÈS,3,0,3
2023/2024,25003585,ESCOLA SANT MIQUEL - ZER NARIEDA,25165,251654,PERAMOLA,3,0,3
2023/2024,25003551,ESCOLA RAMON GOMBAL - ZER ESPERNALLAC,25164,251641,PENELLES,3,0,3
2023/2024,25003536,ESCOLA DE LA COMA - ZER EL SOLSONÈS,25163,251636,LA COMA I LA PEDRA,3,0,3
2023/2024,25003500,ESCOLA DE LES PALLARGUES - ZER LA SEGARRA,25911,259118,ELS PLANS DE SIÓ,3,2,5
2023/2024,25003494,ESCOLA ARNAU BERENGUER,25158,251581,EL PALAU D'ANGLESOLA,15,2,17
2023/2024,25003482,ESCOLA LEANDRE CRISTÒFOL - ZER MONTSEC,25156,251569,OS DE BALAGUER,4,0,4
2023/2024,25003470,ESCOLA L'ESPÍGOL - ZER MONTSEC,25156,251569,OS DE BALAGUER,7,1,8
2023/2024,25003469,ESCOLA MIRET I SANS - ZER NARIEDA,25155,251556,ORGANYÀ,7,0,7
2023/2024,25003330,ESCOLA AIGUADORA - ZER EL SOLSONÈS,25146,251462,NAVÈS,3,2,5
2023/2024,25003305,ESCOLA SANT ISIDRE - ZER LA COMA,25142,251425,MONTOLIU DE LLEIDA,3,1,4
2023/2024,25003299,ESCOLA ROSA CAMPÀ,25140,251403,MONTFERRER I CASTELLBÒ,11,1,12
2023/2024,25003275,ESCOLA RIDOLAINA,25139,251399,MONTELLÀ I MARTINET,7,0,7
2023/2024,25003263,ESCOLA PERE SARRET - ZER BARIDÀ-BATLLIA,25139,251399,MONTELLÀ I MARTINET,3,0,3
2023/2024,25003241,ESCOLA COLOMINA - ZER EL ROMANÍ,25138,251386,MONTGAI,3,0,3
2023/2024,25003238,ESCOLA DE BUTSÈNIT - ZER EL SIÓ,25138,251386,MONTGAI,1,1,2
2023/2024,25003202,INSTITUT MOLLERUSSA,25137,251370,MOLLERUSSA,39,42,81
2023/2024,25003147,ESCOLA SANT MIQUEL,25135,251351,MIRALCAMP,13,3,16
2023/2024,25003135,ESCOLA JOAN ROS I PORTA - ZER EL JONC,25134,251348,MENÀRGUENS,5,0,5
2023/2024,25003123,ESCOLA OTOGESA - ZER L'OLIVER,25133,251333,MAIALS,9,0,9
2023/2024,25003111,ESCOLA DE MASSALCOREIG - ZER L'OLIVER,25131,251312,MASSALCOREIG,5,1,6
2023/2024,25003093,ESCOLA DE LLOBERA - ZER EL SOLSONÈS,25129,251291,LLOBERA,5,0,5
2023/2024,25003056,ESCOLA PORTELLA BLANCA - ZER BARIDÀ-BATLLIA,25127,251272,LLES DE CERDANYA,3,0,3
2023/2024,25003032,ESCOLA DE LLAVORSÍ - ZER ALT PALLARS SOBIRÀ,25126,251266,LLAVORSÍ,4,0,4
2023/2024,25003019,ESCOLA ARC D'ADÀ - ZER L'OLIVER,25125,251253,LLARDECANS,2,2,4
2023/2024,25002982,ESCOLA DE LLADURS - ZER EL SOLSONÈS,25124,251240,LLADURS,3,1,4
2023/2024,25002970,ESCOLA EL SITJAR,25122,251229,LINYOLA,25,1,26
2023/2024,25002957,ESCOLA ESTUDI ALEJANDRO CASONA,25121,251214,LES,10,0,10
2023/2024,25002921,ESCOLA EL VILOT - ZER PONENT,25120,251207,LLEIDA,5,1,6
2023/2024,25002854,ESCOLA EL SEGRIÀ - ZER L'HORTA DE LLEIDA,25120,251207,LLEIDA,7,1,8
2023/2024,25002799,INSTITUT CAPARRELLA,25120,251207,LLEIDA,56,84,140
2023/2024,25002787,INSTITUT JOAN ORÓ,25120,251207,LLEIDA,49,30,79
2023/2024,25002726,INSTITUT GUINDÀVOLS,25120,251207,LLEIDA,44,38,82
2023/2024,25002696,INSTITUT MARIUS TORRES,25120,251207,LLEIDA,55,25,80
2023/2024,25002684,INSTITUT SAMUEL GILI I GAYA,25120,251207,LLEIDA,42,19,61
2023/2024,25002672,ESCOLA DE PRÀCTIQUES I,25120,251207,LLEIDA,14,4,18
2023/2024,25002659,ESCOLA SANT JOSEP DE CALASSANÇ,25120,251207,LLEIDA,20,1,21
2023/2024,25002131,ESCOLA CREU DEL BATLLE - ZER L'HORTA DE LLEIDA,25120,251207,LLEIDA,3,0,3
2023/2024,25002121,ESCOLA PRÍNCEP DE VIANA,25120,251207,LLEIDA,17,4,21
2023/2024,25002106,ESCOLA PARDINYES,25120,251207,LLEIDA,18,2,20
2023/2024,25002091,ESCOLA MAGÍ MORERA I GALÍCIA,25120,251207,LLEIDA,17,4,21
2023/2024,25002088,ESCOLA RIU SEGRE,25120,251207,LLEIDA,25,9,34
2023/2024,25002076,ESCOLA LA SEU VELLA,25120,251207,LLEIDA,11,2,13
2023/2024,25002064,ESCOLA CAMPS ELISIS,25120,251207,LLEIDA,23,6,29
2023/2024,25002003,ESCOLA SANTA MARIA DE GARDENY,25120,251207,LLEIDA,25,8,33
2023/2024,25001990,ESCOLA ANTONI BERGÓS - ZER L'HORTA DE LLEIDA,25120,251207,LLEIDA,3,0,3
2023/2024,25001953,ESCOLA ENRIC FARRENY,25120,251207,LLEIDA,14,4,18
2023/2024,25001928,ESCOLA MANUEL ORTIZ I CASTELLÓ,25119,251193,JUNEDA,26,2,28
2023/2024,25001916,ESCOLA L'ESPÍGOL - ZER GARRIGUES ALTES,25118,251180,JUNCOSA,4,1,5
2023/2024,25001886,ESCOLA AESO - ZER PALLARS JUSSÀ,25115,251155,ISONA I CONCA DELLÀ,7,1,8
2023/2024,25001801,ESCOLA MARE DE DÉU DE L'HORTA,25113,251137,IVARS D'URGELL,14,2,16
2023/2024,25001795,ESCOLA SANT SEBASTIÀ - ZER SERRA LLARGA,25112,251121,IVARS DE NOGUERA,4,0,4
2023/2024,25001761,ESCOLA RAMON FAUS I ESTEVE,25110,251109,GUISSONA,33,5,38
2023/2024,25001758,ESCOLA DE GUIMERÀ - ZER GUICIVERVI,25109,251095,GUIMERÀ,2,0,2
2023/2024,25001722,ESCOLA SANT JAUME - ZER L'OLIVER,25102,251023,LA GRANJA D'ESCARP,5,3,8
2023/2024,25001710,ESCOLA DE LA GRANADELLA - ZER ELAIA,25101,251018,LA GRANADELLA,3,2,5
2023/2024,25001709,ESCOLA SANTA MARGARIDA - ZER ALT BERGUEDÀ,25100,251001,GÓSOL,2,1,3
2023/2024,25001692,ESCOLA FRANCESC ARENES,25099,250997,GOLMÉS,16,0,16
2023/2024,25001618,ESCOLA GUILLEM ISARN,25096,250962,LA FULIOLA,14,2,16
2023/2024,25001606,ESCOLA MINYONS D'URGELL,25093,250931,FONDARELLA,11,2,13
2023/2024,25001539,ESCOLA LA CLOSA,25086,250864,ESTERRI D'ÀNEU,14,2,16
2023/2024,25001473,ESCOLA PORCEL DE CERVERA - ZER PEDRERA,25081,250812,L'ESPLUGA CALBA,4,0,4
2023/2024,25001436,ESCOLA SOL NAIXENT - ZER EL ROMANÍ,25079,250791,CUBELLS,2,1,3
2023/2024,25001424,ESCOLA SOL IXENT,25078,250788,CORBINS,15,1,16
2023/2024,25001400,ESCOLA SANT CLIMENT - ZER NARIEDA,25077,250772,COLL DE NARGÓ,4,1,5
2023/2024,25001357,ESCOLA DE CIUTADILLA - ZER GUICIVERVI,25074,250740,CIUTADILLA,2,0,2
2023/2024,25001333,ESCOLA EL CÉRVOL - ZER RIU SET,25073,250735,CERVIÀ DE LES GARRIGUES,5,0,5
2023/2024,25001321,ESCOLA MOSSÈN JOSEP ARQUES,25072,250729,CERVERA,26,4,30
2023/2024,25001311,INSTITUT ANTONI TORROJA,25072,250729,CERVERA,30,14,44
2023/2024,25001291,ESCOLA JAUME BALMES,25072,250729,CERVERA,26,3,29
2023/2024,25001281,ESCOLA EL TERRALL - ZER ESPERNALLAC,25070,250707,CASTELLSERÀ,7,1,8
2023/2024,25001278,ESCOLA SANTA MARIA - ZER SERRA LLARGA,25069,250693,CASTELLÓ DE FARFANYA,4,0,4
2023/2024,25001266,ESCOLA L'ESTEL - ZER VENT SERÈ,25068,250680,CASTELLNOU DE SEANA,6,0,6
2023/2024,25001254,ESCOLA TIMORELL - ZER VALL DE L'ARANYÓ,25067,250674,CASTELLDANS,5,1,6
2023/2024,25001242,ESCOLA CASTELL-CIUTAT - ZER URGELLET,25203,252038,LA SEU D'URGELL,4,0,4
2023/2024,25001229,ESCOLA DOS RIUS - ZER EL JONC,25062,250621,CAMARASA,4,1,5
2023/2024,25001199,ESCOLA SANT RÒC,25059,250595,BOSSÒST,11,1,12
2023/2024,25001141,ESCOLA JOAN XXIII,25058,250582,LES BORGES BLANQUES,24,8,32
2023/2024,25001138,ESCOLA CASTETH LEON - ZER VAL D'ARAN,25057,250576,ES BÒRDES,2,0,2
2023/2024,25001126,ESCOLA VALLMAJOR - ZER ELAIA,25056,250560,BOVERA,3,0,3
2023/2024,25001096,ESCOLA SANT JOAN,25053,250539,BENAVENT DE SEGRIÀ,15,1,16
2023/2024,25001084,ESCOLA JOAQUIM PALACÍN,25052,250523,BELLVÍS,14,3,17
2023/2024,25001059,ESCOLA MARE DE DÉU DE TALLÓ,25051,250518,BELLVER DE CERDANYA,16,1,17
2023/2024,25001011,ESCOLA VALERI SERRA,25050,250501,BELLPUIG,20,2,22
2023/2024,25001001,ESCOLA SANT BARTOMEU - ZER ESPERNALLAC,25049,250498,BELLMUNT D'URGELL,1,2,3
2023/2024,25000985,ESCOLA RAMON FARRERONS,25048,250485,BELL-LLOC D'URGELL,13,4,17
2023/2024,25000961,ESCOLA BONAVISTA,25047,250479,BELLCAIRE D'URGELL,12,2,14
2023/2024,25000951,ESCOLA PERE TEIXINÉ - ZER RIU CORB,25046,250463,BELIANES,5,0,5
2023/2024,25000869,ESCOLA SANT ROC - ZER RIU ONDARA,25041,250411,BARBENS,7,1,8
2023/2024,25000857,ESCOLA LA NOGUERA,25040,250404,BALAGUER,14,3,17
2023/2024,25000833,INSTITUT CIUTAT DE BALAGUER,25040,250404,BALAGUER,41,20,61
2023/2024,25000781,ESCOLA ÀNGEL GUIMERÀ,25040,250404,BALAGUER,19,0,19
2023/2024,25000778,ESCOLA GASPAR DE PORTOLÀ,25040,250404,BALAGUER,27,6,33
2023/2024,25000730,ESCOLA FRANCESC FELIU,25038,250387,AITONA,25,9,34
2023/2024,25000717,ESCOLA DE TARTAREU - ZER MONTSEC,25037,250371,LES AVELLANES I SANTA LINYA,2,0,2
2023/2024,25000699,ESCOLA DE LES AVELLANES - ZER MONTSEC,25037,250371,LES AVELLANES I SANTA LINYA,2,1,3
2023/2024,25000675,ESCOLA MARE DE DÉU DE LA GUARDIOLA - ZER EL ROMANÍ,25035,250352,LA SENTIU DE SIÓ,4,0,4
2023/2024,25000638,ESCOLA ELS PLANELLS,25034,250349,ARTESA DE SEGRE,29,1,30
2023/2024,25000626,ESCOLA ELS TIL.LERS,25033,250334,ARTESA DE LLEIDA,9,5,14
2023/2024,25000602,ESCOLA ALBIRKA,25029,250292,ARBECA,16,1,17
2023/2024,25000584,ESCOLA SANTA CREU,25027,250273,ANGLESOLA,14,3,17
2023/2024,25000560,ESCOLA RUDA - ZER VAL D'ARAN,25025,250254,NAUT ARAN,8,0,8
2023/2024,25000559,ESCOLA SANT MARTÍ - ZER VAL D'ARAN,25025,250254,NAUT ARAN,2,0,2
2023/2024,25000535,ESCOLA LOSERON - ZER VAL D'ARAN,25025,250254,NAUT ARAN,6,0,6
2023/2024,25000511,ESCOLA INOCENCIO PARDOS - ZER PONENT,25912,259123,GIMENELLS I EL PLA DE LA FONT,3,0,3
2023/2024,25000481,ESCOLA SANT ISIDRE - ZER PONENT,25912,259123,GIMENELLS I EL PLA DE LA FONT,6,1,7
2023/2024,25000468,ESCOLA DOCTOR SERÉS,25023,250236,ALPICAT,26,5,31
2023/2024,25000341,ESCOLA ANTÒNIA SIMÓ ARNÓ,25019,250194,ALMACELLES,36,4,40
2023/2024,25000316,ESCOLA D'ALINS - ZER ALT PALLARS SOBIRÀ,25017,250175,ALINS,3,0,3
2023/2024,25000286,ESCOLA SANT BLAI - ZER SERRA LLARGA,25015,250156,ALGERRI,4,0,4
2023/2024,25000274,ESCOLA D'ALFÉS - ZER L'ERAL,25014,250143,ALFÉS,3,0,3
2023/2024,25000225,ESCOLA MARE DE DÉU DEL CARME,25012,250122,ALCOLETGE,25,6,31
2023/2024,25000195,ESCOLA COMTES DE TORREGROSSA,25011,250117,ALCARRÀS,33,8,41
2023/2024,25000183,ESCOLA LA DULA - ZER L'ERAL,25010,250100,ALCANÓ,3,0,3
2023/2024,25000171,ESCOLA ELS AUBIS - ZER RIU SET,25009,250096,L'ALBI,6,0,6
2023/2024,25000161,ESCOLA L'ÀLBER,25008,250083,ALBESA,12,3,15
2023/2024,25000158,ESCOLA SANT SALVADOR,25007,250077,ALBATÀRREC,14,2,16
2023/2024,25000146,ESCOLA MARE DE DÉU DE MONTSERRAT - ZER VALL DE L'ARANYÓ,25006,250061,L'ALBAGÉS,2,2,4
2023/2024,25000122,ESCOLA SANT ESTEVE - ZER URGELLET,25005,250058,ALÀS I CERC,3,0,3
2023/2024,25000110,ESCOLA ARRELS - ZER L'HORTA DE LLEIDA,25004,250045,ELS ALAMÚS,6,0,6
2023/2024,25000067,ESCOLA MACIÀ-COMPANYS,25003,250030,AGRAMUNT,24,5,29
2023/2024,25000031,ESCOLA ANDREU FARRAN - ZER MONTSEC,25002,250024,ÀGER,4,0,4
2023/2024,17011081,INSTITUT ESCOLA CENT FONTS-SANT JOSEP,17164,171642,SANT HILARI SACALM,25,5,30
2023/2024,17011066,INSTITUT ESCOLA JOSEP POUS I PAGÈS,17066,170669,FIGUERES,18,4,22
2023/2024,17011054,ESCOLA DE CAMPLLONG,17038,170388,CAMPLLONG,3,0,3
2023/2024,17011042,INSTITUT ESCOLA MOSSEN JOAN BATLLE,17023,170237,BLANES,24,10,34
2023/2024,17010931,ESCOLA LES CURCULLES-ZER EMPORDÀ,17119,171194,PALAU DE SANTA EULÀLIA,2,0,2
2023/2024,17010921,INSTITUT ESCOLA MONTSENY,17027,170274,BREDA,45,10,55
2023/2024,17010840,INSTITUT LA SUREDA,17117,171175,PALAFRUGELL,27,9,36
2023/2024,17010839,INSTITUT DE PERALADA,17132,171328,PERALADA,14,9,23
2023/2024,17010827,INSTITUT ESCOLA GREDA,17114,171143,OLOT,48,5,53
2023/2024,17010815,INSTITUT ESCOLA VILA-ROMÀ,17118,171181,PALAMÓS,45,12,57
2023/2024,17010803,INSTITUT ESCOLA VALL DE RIBES,17145,171450,RIBES DE FRESER,22,6,28
2023/2024,17010797,INSTITUT ESCOLA CARITAT SERINYANA - CAP DE CREUS,17032,170329,CADAQUÉS,26,6,32
2023/2024,17010700,INSTITUT SANT QUIRZE,17095,170950,LLORET DE MAR,15,11,26
2023/2024,17010694,INSTITUT ESCOLA EL BRUEL-EMPURIABRAVA,17047,170470,CASTELLÓ D'EMPÚRIES,34,11,45
2023/2024,17010682,INSTITUT DE SARRIÀ DE TER,17186,171864,SARRIÀ DE TER,31,29,60
2023/2024,17010451,CFA TRAMUNTANA,17066,170669,FIGUERES,13,6,19
2023/2024,17010441,CFA NOU GIRONA,17079,170792,GIRONA,7,4,11
2023/2024,17010414,INSTITUT ERMESSENDA DE GIRONA,17079,170792,GIRONA,41,17,58
2023/2024,17010189,INSTITUT VALL DE LLÉMENA,17163,171637,SANT GREGORI,26,11,37
2023/2024,17010049,ESCOLA BALANDRAU,17079,170792,GIRONA,15,2,17
2023/2024,17010037,INSTITUT EL BRUC,17146,171463,RIELLS I VIABREA,10,5,15
2023/2024,17009898,INSTITUT ESCOLA LLORET DE MAR,17095,170950,LLORET DE MAR,52,16,68
2023/2024,17009850,ESCOLA LES ARRELS,17155,171557,SALT,33,6,39
2023/2024,17009813,INSTITUT ESCOLA MESTRE ANDREU,17167,171674,SANT JOAN DE LES ABADESSES,35,7,42
2023/2024,17009801,INSTITUT ESCOLA SALVADOR VILARRASA,17019,170195,BESALÚ,35,11,46
2023/2024,17009795,INSTITUT ESCOLA FRANCESC CAMBÓ I BATLLE,17211,172116,VERGES,27,14,41
2023/2024,17009783,INSTITUT LA MIQUELA,17020,170209,BESCANÓ,25,11,36
2023/2024,17009710,ESCOLA EMPORDANET,17022,170221,LA BISBAL D'EMPORDÀ,18,0,18
2023/2024,17009631,ZER CAP DE CREUS,17140,171404,EL PORT DE LA SELVA,3,2,5
2023/2024,17009473,ZER EMPORDANET-GAVARRES,17130,171306,LA PERA,4,0,4
2023/2024,17009345,ESCOLA CAMINS,17015,170157,BANYOLES,21,2,23
2023/2024,17009308,INSTITUT DE SILS,17193,171931,SILS,26,12,38
2023/2024,17009278,ESCOLA FANALS D'ARO,17048,170486,CASTELL-PLATJA D'ARO,15,2,17
2023/2024,17009242,ESCOLA NOU DE QUART,17142,171426,QUART,16,1,17
2023/2024,17009205,INSTITUT DE VILABLAREIX,17215,172155,VILABLAREIX,41,22,63
2023/2024,17009199,ESCOLA ELS ESTANYS,17193,171931,SILS,12,4,16
2023/2024,17009138,ESCOLA PUIG DE LES CADIRETES,17089,170890,LLAGOSTERA,28,5,33
2023/2024,17009126,ESCOLA EL BOSC DE LA PABORDIA,17079,170792,GIRONA,26,4,30
2023/2024,17008997,ESCOLA FORALLAC,17902,179026,FORALLAC,12,3,15
2023/2024,17008951,INSTITUT MAÇANET DE LA SELVA,17103,171030,MAÇANET DE LA SELVA,26,12,38
2023/2024,17008894,ESCOLA ALZINES BALLADORES,17159,171595,SANT FELIU DE BUIXALLEU,13,1,14
2023/2024,17008882,ESCOLA LA BÒBILA,17139,171390,LES PRESES,16,0,16
2023/2024,17008821,EOI DE BANYOLES,17015,170157,BANYOLES,4,1,5
2023/2024,17008808,ESCOLA CARME GUASCH I DARNÉ,17066,170669,FIGUERES,27,3,30
2023/2024,17008781,ESCOLA LA BENAULA,17033,170335,CALDES DE MALAVELLA,17,1,18
2023/2024,17008778,ESCOLA EL MORROT,17114,171143,OLOT,16,1,17
2023/2024,17008687,ESCOLA LES DEVESES,17155,171557,SALT,30,8,38
2023/2024,17008675,ESCOLA PERICOT,17079,170792,GIRONA,27,6,33
2023/2024,17008651,INSTITUT DE CALDES DE MALAVELLA,17033,170335,CALDES DE MALAVELLA,31,10,41
2023/2024,17008641,ESCOLA DE CABANES,17030,170307,CABANES,9,3,12
2023/2024,17008547,ESCOLA LES ARRELS,17103,171030,MAÇANET DE LA SELVA,14,4,18
2023/2024,17008523,ESCOLA PI VERD,17117,171175,PALAFRUGELL,31,4,35
2023/2024,17008501,ESCOLA ALDRIC,17044,170448,CASSÀ DE LA SELVA,28,2,30
2023/2024,17008493,ESCOLA VALL-LLOBREGA,17209,172095,VALL-LLOBREGA,15,0,15
2023/2024,17008481,ESCOLA L'ESCULAPI,17062,170622,L'ESCALA,16,4,20
2023/2024,17008471,ESCOLA LES FALGUERES,17049,170499,CELRÀ,29,0,29
2023/2024,17008468,ESCOLA LA SÍNIA,17034,170340,CALONGE I SANT ANTONI,13,3,16
2023/2024,17008444,ESCOLA PARC DE LES AIGÜES,17066,170669,FIGUERES,26,7,33
2023/2024,17008419,ESCOLA LLUMS DEL NORD,17141,171411,PUIGCERDÀ,14,3,17
2023/2024,17008407,INSTITUT SALVADOR SUNYER I AIMERIC,17155,171557,SALT,39,10,49
2023/2024,17008390,INSTITUT DE VILAFANT,17221,172214,VILAFANT,35,15,50
2023/2024,17008389,CFA LA SELVA,17180,171805,SANTA COLOMA DE FARNERS,3,4,7
2023/2024,17008377,CFA RIPOLLÈS,17147,171479,RIPOLL,2,2,4
2023/2024,17008365,CFA PLA DE L'ESTANY,17015,170157,BANYOLES,7,2,9
2023/2024,17008298,ESCOLA EL GEGANT DEL REC,17155,171557,SALT,37,2,39
2023/2024,17008286,ESCOLA DOMENY,17079,170792,GIRONA,27,5,32
2023/2024,17008274,ESCOLA SA FORCANERA,17023,170237,BLANES,29,2,31
2023/2024,17008249,ESCOLA CASTELL DE FARNERS,17180,171805,SANTA COLOMA DE FARNERS,32,3,35
2023/2024,17008237,ESCOLA MONTSERRAT VAYREDA,17152,171523,ROSES,25,2,27
2023/2024,17008146,CFA PALAFRUGELL,17117,171175,PALAFRUGELL,5,3,8
2023/2024,17008110,EOI DE SANT FELIU DE GUÍXOLS,17160,171609,SANT FELIU DE GUÍXOLS,5,2,7
2023/2024,17008080,ESCOLA ÀNGELS ALEMANY I BORIS,17095,170950,LLORET DE MAR,46,8,54
2023/2024,17008018,ESCOLA ARDENYA,17160,171609,SANT FELIU DE GUÍXOLS,28,3,31
2023/2024,17008006,ESCOLA AMISTAT,17066,170669,FIGUERES,27,4,31
2023/2024,17007981,EOI D'OLOT,17114,171143,OLOT,9,1,10
2023/2024,17007919,ESCOLA MAS MASÓ,17155,171557,SALT,36,4,40
2023/2024,17007907,ESCOLA JOANA D'EMPÚRIES,17047,170470,CASTELLÓ D'EMPÚRIES,26,5,31
2023/2024,17007828,ESCOLA PINYA DE ROSA,17023,170237,BLANES,28,4,32
2023/2024,17007695,ZER EMPORDÀ,17228,172288,VILANANT,3,1,4
2023/2024,17007671,CFA LA GARROTXA,17114,171143,OLOT,8,5,13
2023/2024,17007658,CFA SANT FELIU DE GUÍXOLS,17160,171609,SANT FELIU DE GUÍXOLS,7,3,10
2023/2024,17007609,INSTITUT OLIVAR GRAN,17066,170669,FIGUERES,54,40,94
2023/2024,17007531,ZER MONTGRÍ,17018,170182,BELLCAIRE D'EMPORDÀ,4,0,4
2023/2024,17007518,ZER LES SALINES,17102,171024,MAÇANET DE CABRENYS,4,0,4
2023/2024,17007488,ZER REQUESENS,17042,170427,CAPMANY,3,2,5
2023/2024,17007464,ZER COMTE ARNAU,17170,171707,VALLFOGONA DE RIPOLLÈS,2,1,3
2023/2024,17007452,ZER EL LLIERCA,17200,172001,TORTELLÀ,3,1,4
2023/2024,17007440,ZER VALL DE TER,17177,171772,SANT PAU DE SEGÚRIES,3,1,4
2023/2024,17007439,ZER CERDANYA,17094,170947,LLÍVIA,5,0,5
2023/2024,17007427,ZER TRAMUNTANA,17210,172109,VENTALLÓ,4,0,4
2023/2024,17007300,INSTITUT LA BISBAL,17022,170221,LA BISBAL D'EMPORDÀ,68,44,112
2023/2024,17007181,CFA GIRONA,17079,170792,GIRONA,15,4,19
2023/2024,17007178,CFA MARIA VERDAGUER,17066,170669,FIGUERES,9,2,11
2023/2024,17007129,CFA ES PITEUS,17023,170237,BLANES,6,7,13
2023/2024,17007014,CFA LLORET DE MAR,17095,170950,LLORET DE MAR,8,1,9
2023/2024,17006952,ESCOLA LA DRAGA,17015,170157,BANYOLES,28,3,31
2023/2024,17006940,ESCOLA DE LLIURONA,17003,170031,ALBANYÀ,2,1,3
2023/2024,17006939,INSTITUT SANTA EUGÈNIA,17079,170792,GIRONA,78,62,140
2023/2024,17006873,ESCOLA CASTELLUM,17169,171693,SANT JULIÀ DE RAMIS,22,1,23
2023/2024,17006851,INSTITUT ILLA DE RODES,17152,171523,ROSES,48,29,77
2023/2024,17006836,ESCOLA LES MÈLIES,17221,172214,VILAFANT,26,4,30
2023/2024,17006824,INSTITUT VIDRERES,17213,172137,VIDRERES,41,27,68
2023/2024,17006812,INSTITUT DE TOSSA DE MAR,17202,172023,TOSSA DE MAR,24,12,36
2023/2024,17006800,ESCOLA ELS GRECS,17152,171523,ROSES,21,4,25
2023/2024,17006782,ESCOLA CARRILET,17117,171175,PALAFRUGELL,31,6,37
2023/2024,17006770,INSTITUT ROCAGROSSA,17095,170950,LLORET DE MAR,33,44,77
2023/2024,17006769,INSTITUT DE LLANÇÀ,17092,170926,LLANÇÀ,32,19,51
2023/2024,17006757,INSTITUT DE LLAGOSTERA,17089,170890,LLAGOSTERA,35,20,55
2023/2024,17006745,INSTITUT DE LA JONQUERA,17086,170865,LA JONQUERA,32,12,44
2023/2024,17006733,INSTITUT VESCOMTAT DE CABRERA,17083,170834,HOSTALRIC,38,18,56
2023/2024,17006721,ESCOLA MARTA MATA,17079,170792,GIRONA,28,4,32
2023/2024,17006711,ESCOLA M. ÀNGELS ANGLADA,17066,170669,FIGUERES,15,4,19
2023/2024,17006708,INSTITUT DE CELRÀ,17049,170499,CELRÀ,44,24,68
2023/2024,17006691,INSTITUT RIDAURA,17048,170486,CASTELL-PLATJA D'ARO,50,20,70
2023/2024,17006681,INSTITUT GERMANS VILA-RIERA,17039,170391,CAMPRODON,17,6,23
2023/2024,17006666,INSTITUT PLA DE L'ESTANY,17015,170157,BANYOLES,59,30,89
2023/2024,17006605,INSTITUT MONTSORIU,17009,170097,ARBÚCIES,34,20,54
2023/2024,17006083,INSTITUT CASTELLÓ D'EMPÚRIES,17047,170470,CASTELLÓ D'EMPÚRIES,44,28,72
2023/2024,17005923,INSTITUT MONTGRÍ,17199,171997,TORROELLA DE MONTGRÍ,52,26,78
2023/2024,17005911,INSTITUT RAMON COLL I RODÉS,17095,170950,LLORET DE MAR,62,37,99
2023/2024,17005893,INSTITUT BOSC DE LA COMA,17114,171143,OLOT,57,40,97
2023/2024,17005741,INSTITUT PERE BORRELL,17141,171411,PUIGCERDÀ,68,23,91
2023/2024,17005731,INSTITUT S'AGULLA,17023,170237,BLANES,47,30,77
2023/2024,17005704,INSTITUT ABAT OLIBA,17147,171479,RIPOLL,59,37,96
2023/2024,17005662,INSTITUT SERRALLARGA,17023,170237,BLANES,70,51,121
2023/2024,17005650,INSTITUT DE CASSÀ DE LA SELVA,17044,170448,CASSÀ DE LA SELVA,47,20,67
2023/2024,17005649,INSTITUT CENDRASSOS,17066,170669,FIGUERES,64,44,108
2023/2024,17005388,INSTITUT VALLVERA,17155,171557,SALT,85,27,112
2023/2024,17005376,INSTITUT DE SANTA COLOMA DE FARNERS,17180,171805,SANTA COLOMA DE FARNERS,83,29,112
2023/2024,17005364,INSTITUT CAP NORFEU,17152,171523,ROSES,48,22,70
2023/2024,17005352,INSTITUT DE PALAMÓS,17118,171181,PALAMÓS,58,31,89
2023/2024,17005340,EA D'OLOT,17114,171143,OLOT,34,14,48
2023/2024,17005339,CFA LES BERNARDES,17155,171557,SALT,13,6,19
2023/2024,17005261,ESCOLA MONTPALAU - ZER EL LLIERCA,17010,170101,ARGELAGUER,5,0,5
2023/2024,17005251,INSTITUT EL PEDRÓ,17062,170622,L'ESCALA,35,30,65
2023/2024,17005248,ESCOLA MAS CLARÀ,17022,170221,LA BISBAL D'EMPORDÀ,25,3,28
2023/2024,17005182,ESCOLA CAN PUIG,17015,170157,BANYOLES,27,4,31
2023/2024,17005042,INSTITUT CARLES RAHOLA I LLORENS,17079,170792,GIRONA,42,19,61
2023/2024,17005029,ESCOLA L'ESQUIROL - ZER VALL DE TER,17112,171122,OGASSA,3,0,3
2023/2024,17005017,ESCOLA QUATRE VENTS,17023,170237,BLANES,24,8,32
2023/2024,17004955,ESCOLA POMPEU FABRA,17095,170950,LLORET DE MAR,36,11,47
2023/2024,17004943,ESCOLA MONTFALGARS,17079,170792,GIRONA,29,3,32
2023/2024,17004906,ESCOLA SALVADOR ESPRIU,17213,172137,VIDRERES,27,4,31
2023/2024,17004891,ESCOLA JOSEP PALLACH,17066,170669,FIGUERES,30,6,36
2023/2024,17004888,ESCOLA SANTA CECÍLIA - ZER CERDANYA,17024,170242,BOLVIR,4,2,6
2023/2024,17004876,ESCOLA L'OLIVAR VELL,17013,170139,BEGUR,10,3,13
2023/2024,17004864,ESCOLA EL PLA,17155,171557,SALT,29,10,39
2023/2024,17004852,EOI DE GIRONA,17079,170792,GIRONA,36,5,41
2023/2024,17004827,ESCOLA ALZINA RECLAMADORA,17071,170715,FONTCOBERTA,15,1,16
2023/2024,17004761,CEE DOCTOR RAMON SURIÑACH,17147,171479,RIPOLL,8,0,8
2023/2024,17004751,ESCOLA TOMÀS RAGUER,17147,171479,RIPOLL,19,1,20
2023/2024,17004748,CEE MARE DE DÉU DEL MONT,17221,172214,VILAFANT,32,3,35
2023/2024,17004736,CEE ELS ÀNGELS,17118,171181,PALAMÓS,24,3,27
2023/2024,17004724,CEE PALAU,17079,170792,GIRONA,17,1,18
2023/2024,17004712,CEE VENTIJOL,17023,170237,BLANES,35,2,37
2023/2024,17004694,ESCOLA CASSIÀ COSTAL,17079,170792,GIRONA,29,4,33
2023/2024,17004682,ESCOLA L'ESTACIÓ,17160,171609,SANT FELIU DE GUÍXOLS,29,3,32
2023/2024,17004657,ESCOLA ESTEVE CARLES,17095,170950,LLORET DE MAR,21,4,25
2023/2024,17004578,INSTITUT CASTELL D'ESTELA,17007,170078,AMER,26,12,38
2023/2024,17004566,ESCOLA NAPOLEÓ SOLIVA,17023,170237,BLANES,19,3,22
2023/2024,17004530,INSTITUT SANTIAGO SOBREQUÉS I VIDAL,17079,170792,GIRONA,49,21,70
2023/2024,17004529,ESCOLA MIGDIA,17079,170792,GIRONA,28,8,36
2023/2024,17004517,INSTITUT ANTON BUSQUETS I PUNSET,17164,171642,SANT HILARI SACALM,24,9,33
2023/2024,17004499,INSTITUT NARCÍS XIFRA I MASMITJÀ,17079,170792,GIRONA,101,61,162
2023/2024,17004487,INSTITUT RAFAEL CAMPALANS,17008,170084,ANGLÈS,43,21,64
2023/2024,17004463,ESCOLA ANICET DE PAGÈS I DE PUIG,17066,170669,FIGUERES,29,8,37
2023/2024,17004451,ESCOLA JAUME VICENS I VIVES,17152,171523,ROSES,24,4,28
2023/2024,17004438,INSTITUT ALEXANDRE DEULOFEU,17066,170669,FIGUERES,62,23,85
2023/2024,17004360,CEE LA MAÇANA,17155,171557,SALT,8,0,8
2023/2024,17004347,ESCOLA FONT DE LA PÓLVORA,17079,170792,GIRONA,8,1,9
2023/2024,17004335,ESCOLA SANTA EUGÈNIA,17079,170792,GIRONA,17,2,19
2023/2024,17004293,ESCOLA MANUEL DE PEDROLO - ZER LES SALINES,17234,172348,BIURE,2,1,3
2023/2024,17004281,ESCOLA JOSEP MADRENYS,17233,172333,VILOBÍ D'ONYAR,23,3,26
2023/2024,17004244,ESCOLA TRAMUNTANA - ZER EMPORDÀ,17228,172288,VILANANT,3,0,3
2023/2024,17004232,ESCOLA JOSEP DE RIBOT I OLIVAS,17226,172266,VILAMALLA,15,1,16
2023/2024,17004220,ESCOLA ELS VALENTINS - ZER TRAMUNTANA,17225,172253,VILAMACOLUM,4,1,5
2023/2024,17004219,ESCOLA LA DAINA - ZER VALL DE TER,17224,172240,VILALLONGA DE TER,4,0,4
2023/2024,17004207,ESCOLA SANTIAGO RATÉS,17223,172235,VILAJUÏGA,11,1,12
2023/2024,17004190,ESCOLA SOL I VENT,17221,172214,VILAFANT,15,1,16
2023/2024,17004189,ESCOLA ELS CASTANYERS - ZER GUILLERIES,17220,172207,VILADRAU,10,0,10
2023/2024,17004153,ESCOLA DE SANT ESTEVE DE GUIALBES,17218,172180,VILADEMULS,12,3,15
2023/2024,17004128,ESCOLA PUIG SEGALAR - ZER TRAMUNTANA,17217,172174,VILADAMAT,4,0,4
2023/2024,17004116,ESCOLA MADRENC,17215,172155,VILABLAREIX,27,2,29
2023/2024,17004098,ESCOLA TORRE D'EN REIG,17214,172142,VILABERTRAN,14,1,15
2023/2024,17004074,ESCOLA SANT ISCLE,17213,172137,VIDRERES,16,3,19
2023/2024,17004062,ESCOLA SANTA BÀRBARA - ZER ELS CASTELLS,17212,172121,VIDRÀ,2,0,2
2023/2024,17004049,ESCOLA OLIVERES MIL·LENÀRIES - ZER TRAMUNTANA,17210,172109,VENTALLÓ,6,0,6
2023/2024,17004001,ESCOLA VERNTALLAT,17207,172076,LA VALL D'EN BAS,20,1,21
2023/2024,17003951,PARVULARI DE SANT ESTEVE D'EN BAS,17207,172076,LA VALL D'EN BAS,4,0,4
2023/2024,17003941,ESCOLA L'ESTANY - ZER EMPORDANET-GAVARRES,17205,172057,ULLASTRET,4,0,4
2023/2024,17003938,ESCOLA PUIG RODÓ - ZER MONTGRÍ,17204,172044,ULLÀ,7,0,7
2023/2024,17003926,ESCOLA IGNASI MELÉ I FARRÉ,17202,172023,TOSSA DE MAR,31,2,33
2023/2024,17003902,ESCOLA JOAN ROURA I PARELLA - ZER EL LLIERCA,17200,172001,TORTELLÀ,4,3,7
2023/2024,17003872,ESCOLA GUILLEM DE MONTGRÍ,17199,171997,TORROELLA DE MONTGRÍ,38,6,44
2023/2024,17003860,ESCOLA PORTITXOL,17199,171997,TORROELLA DE MONTGRÍ,30,3,33
2023/2024,17003823,ESCOLA VERDAGUER,17193,171931,SILS,25,5,30
2023/2024,17003801,ESCOLA BORA GRAN,17190,171903,SERINYÀ,11,3,14
2023/2024,17003781,ESCOLA JUNCADELLA,17189,171899,LA CELLERA DE TER,13,3,16
2023/2024,17003768,ESCOLA ELS TERRAPRIMS,17187,171870,"SAUS, CAMALLERA I LLAMPAIES",14,1,15
2023/2024,17003756,ESCOLA MONTSERRAT,17186,171864,SARRIÀ DE TER,28,3,31
2023/2024,17003732,ESCOLA CASTANYER,17185,171851,SANT JOAN LES FONTS,16,4,20
2023/2024,17003719,ESCOLA JOAN MARAGALL,17184,171848,SANTA PAU,15,2,17
2023/2024,17003689,ESCOLA PEDRALTA,17181,171812,SANTA CRISTINA D'ARO,23,6,29
2023/2024,17003641,ESCOLA SANT SALVADOR D'HORTA,17180,171805,SANTA COLOMA DE FARNERS,35,4,39
2023/2024,17003631,ESCOLA LA PEDRA DRETA - ZER EMPORDANET-GAVARRES,17901,179011,"CRUÏLLES, MONELLS I SANT SADURNÍ DE L'HEURA",4,1,5
2023/2024,17003628,ESCOLA LLAGUT,17178,171788,SANT PERE PESCADOR,16,4,20
2023/2024,17003616,ESCOLA ELS PINETS - ZER VALL DE TER,17177,171772,SANT PAU DE SEGÚRIES,7,0,7
2023/2024,17003598,ESCOLA VALLGARRIGA,17175,171753,SANT MIQUEL DE FLUVIÀ,10,2,12
2023/2024,17003537,ESCOLA DE VALLFOGONA DE RIPOLLÈS - ZER COMTE ARNAU,17170,171707,VALLFOGONA DE RIPOLLÈS,2,0,2
2023/2024,17003471,ESCOLA SANT JORDI,17166,171668,SANT JORDI DESVALLS,10,2,12
2023/2024,17003461,ESCOLA LES ESCOMES,17165,171655,SANT JAUME DE LLIERCA,14,3,17
2023/2024,17003434,ESCOLA GUILLERIES,17164,171642,SANT HILARI SACALM,26,3,29
2023/2024,17003422,ESCOLA TAIALÀ,17079,170792,GIRONA,30,3,33
2023/2024,17003392,ESCOLA AGUSTÍ GIFRE,17163,171637,SANT GREGORI,31,7,38
2023/2024,17003343,ESCOLA ROCALBA,17161,171616,SANT FELIU DE PALLEROLS,13,3,16
2023/2024,17003321,ESCOLA MOSSÈN BALDIRI REIXACH,17160,171609,SANT FELIU DE GUÍXOLS,24,6,30
2023/2024,17003318,INSTITUT DE SANT FELIU DE GUÍXOLS,17160,171609,SANT FELIU DE GUÍXOLS,68,36,104
2023/2024,17003306,INSTITUT SANT ELM,17160,171609,SANT FELIU DE GUÍXOLS,37,16,53
2023/2024,17003264,ESCOLA GAZIEL,17160,171609,SANT FELIU DE GUÍXOLS,18,9,27
2023/2024,17003227,ESCOLA SANT SEBASTIÀ - ZER REQUESENS,17158,171582,SANT CLIMENT SESCEBES,5,1,6
2023/2024,17003215,ESCOLA LA FARGA,17155,171557,SALT,33,6,39
2023/2024,17003203,INSTITUT SALVADOR ESPRIU,17155,171557,SALT,56,30,86
2023/2024,17003151,ESCOLA SILVESTRE SANTALÓ,17155,171557,SALT,16,5,21
2023/2024,17003136,ESCOLA NARCÍS MONTURIOL,17152,171523,ROSES,14,3,17
2023/2024,17003094,ESCOLA DE RIUDELLOTS DE LA SELVA,17150,171501,RIUDELLOTS DE LA SELVA,15,1,16
2023/2024,17003082,ESCOLA LLUÍS CASTELLS,17149,171498,RIUDAURA,11,1,12
2023/2024,17003070,ESCOLA JOSEP BOADA,17148,171485,RIUDARENES,17,0,17
2023/2024,17002995,ESCOLA JOAN MARAGALL,17147,171479,RIPOLL,25,1,26
2023/2024,17002983,ESCOLA EL BRUC,17146,171463,RIELLS I VIABREA,16,3,19
2023/2024,17002922,ESCOLA SANTA MARGARIDA,17142,171426,QUART,19,1,20
2023/2024,17002880,ESCOLA ALFONS I,17141,171411,PUIGCERDÀ,29,6,35
2023/2024,17002879,ESCOLA LES CLISQUES - ZER CAP DE CREUS,17140,171404,EL PORT DE LA SELVA,6,1,7
2023/2024,17002831,ESCOLA SANT JAUME,17138,171387,PORTBOU,7,2,9
2023/2024,17002818,ESCOLA FRIGOLET,17137,171371,PORQUERES,10,1,11
2023/2024,17002791,ESCOLA L'ENTORN,17137,171371,PORQUERES,25,4,29
2023/2024,17002776,ESCOLA TRAMUNTANA - ZER EMPORDÀ,17135,171352,PONT DE MOLINS,5,0,5
2023/2024,17002764,ESCOLA NÚRIA MORER I PI - ZER COMTE ARNAU,17134,171349,PLANOLES,3,2,5
2023/2024,17002752,ESCOLA SANT CRISTÒFOL,17133,171334,LES PLANES D'HOSTOLES,13,4,17
2023/2024,17002740,ESCOLA RAMON MUNTANER,17132,171328,PERALADA,15,2,17
2023/2024,17002715,ESCOLA PEDRA BLANCA - ZER EMPORDANET-GAVARRES,17130,171306,LA PERA,4,1,5
2023/2024,17002703,ESCOLA PAU,17128,171289,PAU,7,0,7
2023/2024,17002651,ESCOLA QUERMANY,17124,171241,PALS,14,2,16
2023/2024,17002624,ESCOLA MARTÍ INGLÈS,17120,171208,PALAU-SAVERDERA,15,1,16
2023/2024,17002569,ESCOLA LA VILA,17118,171181,PALAMÓS,26,6,32
2023/2024,17002557,INSTITUT BAIX EMPORDÀ,17117,171175,PALAFRUGELL,66,55,121
2023/2024,17002545,INSTITUT FREDERIC MARTÍ I CARRERAS,17117,171175,PALAFRUGELL,40,21,61
2023/2024,17002491,ESCOLA JOSEP BARCELÓ I MATAS,17117,171175,PALAFRUGELL,25,9,34
2023/2024,17002481,ESCOLA TORRES JONAMA,17117,171175,PALAFRUGELL,34,4,38
2023/2024,17002442,ESCOLA LA VALL,17116,171169,OSOR,3,3,6
2023/2024,17002430,ESCOLA MARIA PAGÈS I TRAYTER,17115,171156,ORDIS,5,2,7
2023/2024,17002429,ESCOLA SANT ROC,17114,171143,OLOT,29,4,33
2023/2024,17002399,INSTITUT LA GARROTXA,17114,171143,OLOT,82,43,125
2023/2024,17002387,INSTITUT MONTSACOPA,17114,171143,OLOT,61,21,82
2023/2024,17002326,ESCOLA VOLCÀ BISAROQUES,17114,171143,OLOT,28,4,32
2023/2024,17002314,ESCOLA PLA DE DALT,17114,171143,OLOT,30,3,33
2023/2024,17002296,ESCOLA MALAGRIDA,17114,171143,OLOT,35,5,40
2023/2024,17002260,ESCOLA JOAQUIM VALLMAJÓ,17111,171117,NAVATA,15,1,16
2023/2024,17002259,ESCOLA TORRES JONAMA,17110,171100,MONT-RAS,13,3,16
2023/2024,17002247,ESCOLA MONT CÓS - ZER EL LLIERCA,17109,171096,MONTAGUT I OIX,7,0,7
2023/2024,17002201,ESCOLA FINESTRES,17105,171058,MIERES,6,1,7
2023/2024,17002193,ESCOLA SANTA FE,17169,171693,SANT JULIÀ DE RAMIS,9,2,11
2023/2024,17002181,ESCOLA SANT JORDI,17103,171030,MAÇANET DE LA SELVA,23,8,31
2023/2024,17002168,ESCOLA LES SALINES - ZER LES SALINES,17102,171024,MAÇANET DE CABRENYS,4,1,5
2023/2024,17002107,ESCOLA PERE TORRENT,17095,170950,LLORET DE MAR,41,6,47
2023/2024,17002090,ESCOLA JAUME I - ZER CERDANYA,17094,170947,LLÍVIA,10,1,11
2023/2024,17002089,ESCOLA DE LLERS,17093,170932,LLERS,14,2,16
2023/2024,17002077,ESCOLA POMPEU FABRA,17092,170926,LLANÇÀ,25,4,29
2023/2024,17002065,ESCOLA LES MORERES - ZER VALL DE TER,17091,170911,LLANARS,5,0,5
2023/2024,17002031,ESCOLA LACUSTÀRIA,17089,170890,LLAGOSTERA,32,5,37
2023/2024,17002028,ESCOLA MONTSERRAT VAYREDA I TRULLOL,17088,170887,LLADÓ,11,2,13
2023/2024,17002004,ESCOLA JOSEP PEÑUELAS DEL RIO,17086,170865,LA JONQUERA,29,5,34
2023/2024,17001981,ESCOLA MARE DE DÉU DELS SOCORS,17083,170834,HOSTALRIC,31,4,35
2023/2024,17001954,ESCOLA DE VILA-ROJA,17079,170792,GIRONA,12,1,13
2023/2024,17001930,ESCOLA JOSEP DALMAU I CARLES,17079,170792,GIRONA,25,6,31
2023/2024,17001887,ESCOLA CARME AUGUET,17079,170792,GIRONA,17,0,17
2023/2024,17001838,ESCOLA ÀGORA,17079,170792,GIRONA,19,0,19
2023/2024,17001759,INSTITUT ESCOLA D'HOSTALERIA I TURISME DE GIRONA,17079,170792,GIRONA,35,23,58
2023/2024,17001735,INSTITUT MONTILIVI,17079,170792,GIRONA,102,66,168
2023/2024,17001723,INSTITUT JAUME VICENS VIVES,17079,170792,GIRONA,55,24,79
2023/2024,17001693,CEE FONT DE L'ABELLA,17079,170792,GIRONA,44,6,50
2023/2024,17001516,ESCOLA PLA DE GIRONA,17079,170792,GIRONA,28,2,30
2023/2024,17001486,ESCOLA MONTJUÏC,17079,170792,GIRONA,13,4,17
2023/2024,17001462,ESCOLA VERD,17079,170792,GIRONA,15,2,17
2023/2024,17001450,ESCOLA JOAN BRUGUERA,17079,170792,GIRONA,13,4,17
2023/2024,17001449,ESCOLA ANNEXA - JOAN PUIGBERT,17079,170792,GIRONA,24,6,30
2023/2024,17001425,ESCOLA EIXIMENIS,17079,170792,GIRONA,15,2,17
2023/2024,17001395,ESCOLA SANTA COLOMA - ZER CERDANYA,17078,170789,GER,11,1,12
2023/2024,17001383,ESCOLA JOAQUIM GIFRE,17077,170773,GARRIGUELLA,13,3,16
2023/2024,17001371,ESCOLA DE GARRIGÀS - ZER EMPORDÀ,17075,170754,GARRIGÀS,4,0,4
2023/2024,17001361,ESCOLA TERESA DE PALLEJÀ,17074,170741,FORTIÀ,12,0,12
2023/2024,17001346,ESCOLA FORN D'ANELLS,17073,170736,FORNELLS DE LA SELVA,19,2,21
2023/2024,17001292,ESCOLA LES MORERES,17067,170675,FLAÇÀ,13,3,16
2023/2024,17001280,ESCOLA JOAQUIM CUSÍ I FURTUNET,17066,170669,FIGUERES,29,4,33
2023/2024,43010670,EOI DE VALLS,43161,431613,VALLS,5,0,5
2023/2024,17001279,ESCOLA SANT PAU,17066,170669,FIGUERES,30,3,33
2023/2024,17001221,INSTITUT NARCÍS MONTURIOL,17066,170669,FIGUERES,55,41,96
2023/2024,17001218,INSTITUT RAMON MUNTANER,17066,170669,FIGUERES,44,27,71
2023/2024,17001103,ESCOLA SALVADOR DALÍ,17066,170669,FIGUERES,28,4,32
2023/2024,17001097,ESCOLA CARLES DE FORTUNY,17065,170656,ESPONELLÀ,4,3,7
2023/2024,17001085,ESCOLA ANTONI BALMANYA - ZER REQUESENS,17064,170643,ESPOLLA,3,0,3
2023/2024,17001048,ESCOLA EMPÚRIES,17062,170622,L'ESCALA,37,4,41
2023/2024,17001036,ESCOLA MONT-ROIG - ZER REQUESENS,17060,170600,DARNIUS,3,0,3
2023/2024,17001024,ESCOLA LES GAVARRES - ZER EMPORDANET-GAVARRES,17901,179011,"CRUÏLLES, MONELLS I SANT SADURNÍ DE L'HEURA",6,0,6
2023/2024,17000998,ESCOLA EL RODONELL,17057,170577,CORÇÀ,14,3,17
2023/2024,17000986,ESCOLA LA VALL DEL TERRI,17056,170561,CORNELLÀ DEL TERRI,19,2,21
2023/2024,17000950,ESCOLA PUIG D'ESQUERS - ZER CAP DE CREUS,17054,170545,COLERA,2,1,3
2023/2024,17000937,ESCOLA MOSSÈN JOSEP MARIA ALBERT - ZER EMPORDÀ,17051,170519,CISTELLA,2,0,2
2023/2024,17000925,ESCOLA L'AIXART,17050,170502,CERVIÀ DE TER,11,3,14
2023/2024,17000913,ESCOLA L'AULET,17049,170499,CELRÀ,21,2,23
2023/2024,17000895,ESCOLA ELS ESTANYS,17048,170486,CASTELL-PLATJA D'ARO,27,6,33
2023/2024,17000883,ESCOLA VALL D'ARO,17048,170486,CASTELL-PLATJA D'ARO,17,2,19
2023/2024,17000871,ESCOLA RUIZ AMADO,17047,170470,CASTELLÓ D'EMPÚRIES,28,3,31
2023/2024,17000861,ESCOLA CASTELLROC,17046,170464,CASTELLFOLLIT DE LA ROCA,10,2,12
2023/2024,17000846,ESCOLA PUIG D'ARQUES,17044,170448,CASSÀ DE LA SELVA,27,5,32
2023/2024,17000822,ESCOLA ELS DÒLMENS - ZER REQUESENS,17042,170427,CAPMANY,3,1,4
2023/2024,17000779,ESCOLA DOCTOR ROBERT,17039,170391,CAMPRODON,19,2,21
2023/2024,17000731,ESCOLA PIRINEU,17036,170366,CAMPDEVÀNOL,15,2,17
2023/2024,17000718,ESCOLA LLEVANTÍ DE MAR,17034,170340,CALONGE I SANT ANTONI,16,1,17
2023/2024,17000706,INSTITUT PUIG CARGOL,17034,170340,CALONGE I SANT ANTONI,35,22,57
2023/2024,17000688,ESCOLA PERE ROSSELLÓ,17034,170340,CALONGE I SANT ANTONI,31,1,32
2023/2024,17000676,ESCOLA SANT ESTEVE,17033,170335,CALDES DE MALAVELLA,27,5,32
2023/2024,17000603,ESCOLA SANTA CECÍLIA - ZER LES SALINES,17029,170293,BOADELLA I LES ESCAULES,2,0,2
2023/2024,17000573,ESCOLA SANT ANDREU DE BORRASSÀ,17026,170268,BORRASSÀ,10,0,10
2023/2024,17000561,ESCOLA DE BORDILS,17025,170255,BORDILS,12,7,19
2023/2024,17000551,INSTITUT SA PALOMERA,17023,170237,BLANES,51,41,92
2023/2024,17000470,ESCOLA CARLES FAUST,17023,170237,BLANES,11,6,17
2023/2024,17000469,ESCOLA JOAQUIM RUYRA,17023,170237,BLANES,19,0,19
2023/2024,17000411,ESCOLA JOAN DE MARGARIT,17022,170221,LA BISBAL D'EMPORDÀ,23,5,28
2023/2024,17000408,ESCOLA DOCTOR SOBREQUÉS,17020,170209,BESCANÓ,34,3,37
2023/2024,17000381,ESCOLA EL RAJARET - ZER MONTGRÍ,17018,170182,BELLCAIRE D'EMPORDÀ,7,0,7
2023/2024,17000354,ESCOLA JOAN REGLÀ,17016,170160,BÀSCARA,11,3,14
2023/2024,17000342,ESCOLA DE LA VILA BALDIRI REIXAC,17015,170157,BANYOLES,27,5,32
2023/2024,17000330,INSTITUT JOSEP BRUGULAT,17015,170157,BANYOLES,65,41,106
2023/2024,17000329,ESCOLA PLA DE L'AMETLLER,17015,170157,BANYOLES,29,2,31
2023/2024,17000305,INSTITUT PERE ALSIUS I TORRENT,17015,170157,BANYOLES,47,31,78
2023/2024,17000263,ESCOLA DOCTOR ARRUGA,17013,170139,BEGUR,13,4,17
2023/2024,17000251,ESCOLA GONÇAL COMELLAS,17012,170123,AVINYONET DE PUIGVENTÓS,14,2,16
2023/2024,17000241,ESCOLA FLUVIANETS,17011,170118,L'ARMENTERA,12,3,15
2023/2024,17000160,ESCOLA DOCTOR CARULLA,17009,170097,ARBÚCIES,29,3,32
2023/2024,17000135,ESCOLA POMPEU FABRA,17008,170084,ANGLÈS,24,6,30
2023/2024,17000123,ESCOLA SANT JORDI,17903,179032,SANT JULIÀ DEL LLOR I BONMATÍ,15,1,16
2023/2024,17000093,ESCOLA GASPAR DE QUERALT,17007,170078,AMER,17,2,19
2023/2024,17000071,ESCOLA BAC DE CERDANYA,17006,170062,ALP,13,2,15
2023/2024,17000068,ESCOLA DEL FAR D'EMPORDÀ,17005,170059,EL FAR D'EMPORDÀ,12,0,12
2023/2024,17000056,ESCOLA LA BRANCA - ZER MONTGRÍ,17004,170046,ALBONS,6,0,6
2023/2024,17000032,ESCOLA VILADEMANY,17002,170025,AIGUAVIVA,9,2,11
2023/2024,17000019,ESCOLA LLUÍS MARIÀ VIDAL,17001,170010,AGULLANA,7,4,11
2023/2024,08078439,INSTITUT ESCOLA EL CABRERÈS,08254,082541,L'ESQUIROL,17,2,19
2023/2024,08078403,INSTITUT DE TÈCNIQUES AUDIOVISUALS I DE L'ESPECTACLE DE BCN,08019,080193,BARCELONA,14,12,26
2023/2024,08078385,INSTITUT TIC DE BARCELONA,08019,080193,BARCELONA,11,37,48
2023/2024,08078373,ESCOLA SEGRE,08019,080193,BARCELONA,16,2,18
2023/2024,08078361,INSTITUT ESCOLA SANT FELIP NERI,08019,080193,BARCELONA,21,7,28
2023/2024,08078336,ESCOLA NOVA DE BADIA,08904,089045,BADIA DEL VALLÈS,36,5,41
2023/2024,08078324,INSTITUT ESCOLA MANRESA,08113,081136,MANRESA,64,17,81
2023/2024,08078312,INSTITUT ESCOLA FEIXES,08279,082798,TERRASSA,53,17,70
2023/2024,08078294,INSTITUT ESCOLA DE BADIA,08904,089045,BADIA DEL VALLÈS,28,9,37
2023/2024,08077991,INSTITUT DE LOGÍSTICA DE BARCELONA,08019,080193,BARCELONA,19,28,47
2023/2024,08077988,ESCOLA CASTELLFOLLIT DEL BOIX-ZER TRES BRANQUES,08059,080594,CASTELLFOLLIT DEL BOIX,4,1,5
2023/2024,08077976,INSTITUT MIQUEL BIADA,08121,081213,MATARÓ,66,78,144
2023/2024,08077964,INSTITUT ESCOLA EL MOLÍ,08019,080193,BARCELONA,36,18,54
2023/2024,08077952,INSTITUT ESCOLA PROJECTE,08019,080193,BARCELONA,18,10,28
2023/2024,08077940,INSTITUT ESCOLA MARIA MIRET,08101,081017,L'HOSPITALET DE LLOBREGAT,29,7,36
2023/2024,08077939,ESCOLA DE LA VILA,08167,081672,POLINYÀ,24,9,33
2023/2024,08077851,INSTITUT ESCOLA DE TORRELLES,08289,082896,TORRELLES DE LLOBREGAT,49,15,64
2023/2024,08077782,INSTITUT ESCOLA MIQUEL MARTÍ I POL,08107,081075,LLIÇÀ D'AMUNT,30,12,42
2023/2024,08077514,ESCOLA ALDANA,08019,080193,BARCELONA,21,3,24
2023/2024,08077502,INSTITUT ESCOLA LONDRES,08019,080193,BARCELONA,38,14,52
2023/2024,08077496,INSTITUT ESCOLA SICÍLIA,08019,080193,BARCELONA,29,6,35
2023/2024,08077484,INSTITUT ESCOLA ELISABETS,08019,080193,BARCELONA,29,7,36
2023/2024,08077472,INSTITUT INTERMUNICIPAL DEL PENEDÈS,08240,082401,SANT SADURNÍ D'ANOIA,72,30,102
2023/2024,08077460,INSTITUT ESCOLA SANTA ANNA,08230,082303,PREMIÀ DE DALT,39,9,48
2023/2024,08077459,INSTITUT ESCOLA SANTIGA,08260,082606,SANTA PERPÈTUA DE MOGODA,33,14,47
2023/2024,08077447,INSTITUT DE FORMACIÓ PROFESSIONAL ANTONI ALGUERÓ,08221,082212,SANT JUST DESVERN,20,15,35
2023/2024,08077435,INSTITUT DELS ALIMENTS DE BARCELONA,08019,080193,BARCELONA,31,19,50
2023/2024,08077401,INSTITUT ESCOLA GUILLEM DE BALSARENY,08018,080180,BALSARENY,20,6,26
2023/2024,08077393,INSTITUT ESCOLA LLUÍS MILLET,08118,081189,EL MASNOU,34,11,45
2023/2024,08077381,INSTITUT ESCOLA VIROLET,08187,081878,SABADELL,36,10,46
2023/2024,08077371,INSTITUT ESCOLA EL MORSELL,08148,081483,OLIVELLA,24,7,31
2023/2024,08077356,ESCOLA LES FILADORES,08267,082671,SENTMENAT,5,0,5
2023/2024,08077228,INSTITUT PROFESSIONAL DE TURISME EQÜESTRE DEL MARESME,08261,082613,SANTA SUSANNA,8,10,18
2023/2024,08077174,INSTITUT LA VALL DEL TENES,08248,082482,SANTA EULÀLIA DE RONÇANA,40,26,66
2023/2024,08077162,ESCOLA ATENEU IGUALADÍ,08102,081022,IGUALADA,16,3,19
2023/2024,08077149,INSTITUT ESCOLA EIXAMPLE,08019,080193,BARCELONA,36,12,48
2023/2024,08077137,INSTITUT DE L'ESPORT DE BARCELONA,08019,080193,BARCELONA,27,26,53
2023/2024,08077125,INSTITUT ESCOLA ANTONI UBACH I SOLER,08279,082798,TERRASSA,47,13,60
2023/2024,08077113,ESCOLA VOLTREGÀ,08215,082153,SANT HIPÒLIT DE VOLTREGÀ,23,5,28
2023/2024,08077101,INSTITUT ESCOLA TRES FONTS DE LES CORTS,08019,080193,BARCELONA,41,13,54
2023/2024,08077095,INSTITUT ESCOLA MIRADES,08019,080193,BARCELONA,44,14,58
2023/2024,08077083,INSTITUT VAPOR DEL FIL,08019,080193,BARCELONA,19,4,23
2023/2024,08077071,INSTITUT ESCOLA MAS RAMPINYO,08125,081252,MONTCADA I REIXAC,39,13,52
2023/2024,08077061,INSTITUT ESCOLA ONZE DE SETEMBRE,08238,082384,SANT QUIRZE DEL VALLÈS,26,9,35
2023/2024,08077058,INSTITUT ESCOLA CATALUNYA,08205,082055,SANT CUGAT DEL VALLÈS,42,14,56
2023/2024,08077046,INSTITUT ESCOLA JOAN SALLARÈS I PLA,08187,081878,SABADELL,34,18,52
2023/2024,08077034,INSTITUT ESCOLA EL PI GROS,08203,082037,SANT CEBRIÀ DE VALLALTA,32,12,44
2023/2024,08077022,INSTITUT ESCOLA ELS TRES PINS,08296,082969,VALLROMANES,27,10,37
2023/2024,08077010,INSTITUT ESCOLA COVES D'EN CIMANY,08019,080193,BARCELONA,32,6,38
2023/2024,08077009,INSTITUT ESCOLA CASTELL D'ÒDENA,08143,081430,ÒDENA,34,10,44
2023/2024,08076996,INSTITUT ESCOLA MOSSEN CINTO,08083,080832,FOLGUEROLES,27,8,35
2023/2024,08076984,INSTITUT ESCOLA JOSEP MARIA XANDRI,08233,082331,SANT PERE DE TORELLÓ,26,9,35
2023/2024,08076972,INSTITUT ESCOLA PIERA,08161,081614,PIERA,37,19,56
2023/2024,08076960,INSTITUT ESCOLA RENAIXENÇA,08162,081629,ELS HOSTALETS DE PIEROLA,38,11,49
2023/2024,43010669,EOI D'AMPOSTA,43014,430141,AMPOSTA,7,1,8
2023/2024,08076959,INSTITUT ESCOLA CARLES CAPDEVILA,08017,080174,BALENYÀ,37,14,51
2023/2024,08076947,INSTITUT ESCOLA LLUÍS MILLET,08245,082457,SANTA COLOMA DE GRAMENET,19,11,30
2023/2024,08076935,INSTITUT ESCOLA PUIG I GAIRALT,08101,081017,L'HOSPITALET DE LLOBREGAT,39,30,69
2023/2024,08076923,INSTITUT ESCOLA LLIBERTAT,08015,080155,BADALONA,27,10,37
2023/2024,08076901,INSTITUT ESCOLA TURÓ D'EN CARITG,08015,080155,BADALONA,45,20,65
2023/2024,08076893,INSTITUT VILAFRANCA 2,08305,083054,VILAFRANCA DEL PENEDÈS,12,10,22
2023/2024,08076820,INSTITUT ESCOLA SALA I BADRINAS,08279,082798,TERRASSA,45,10,55
2023/2024,08076650,CFA SANT ADRIÀ DE BESÒS,08194,081944,SANT ADRIÀ DE BESÒS,9,8,17
2023/2024,08076649,INSTITUT DE JARDINERIA I AGRICULTURA LES GARBERES,08051,080517,CASTELLAR DEL VALLÈS,7,9,16
2023/2024,08076637,INSTITUT FP SANT CUGAT DEL VALLÈS,08205,082055,SANT CUGAT DEL VALLÈS,50,27,77
2023/2024,08076613,INSTITUT ESCOLA BARNOLA,08012,080121,AVINYÓ,22,6,28
2023/2024,08076601,INSTITUT ESCOLA PERE VIVER,08279,082798,TERRASSA,43,16,59
2023/2024,08076595,INSTITUT ESCOLA TERESA ALTET,08184,081846,RUBÍ,35,15,50
2023/2024,08076583,INSTITUT ESCOLA ELS PINETONS,08180,081803,RIPOLLET,48,18,66
2023/2024,08076571,INSTITUT ESCOLA EL MARTINET,08180,081803,RIPOLLET,48,10,58
2023/2024,08076561,INSTITUT ESCOLA EL VIVER,08125,081252,MONTCADA I REIXAC,50,12,62
2023/2024,08076558,INSTITUT ESCOLA SANT ESTEVE,08051,080517,CASTELLAR DEL VALLÈS,41,12,53
2023/2024,08076546,INSTITUT ESCOLA CAN LLOBET,08252,082520,BARBERÀ DEL VALLÈS,41,13,54
2023/2024,08076534,INSTITUT ESCOLA MONTAGUT,08261,082613,SANTA SUSANNA,33,11,44
2023/2024,08076522,INSTITUT ESCOLA PALLEROLA,08202,082021,SANT CELONI,54,16,70
2023/2024,08076510,INSTITUT ESCOLA PLA DE L'AVELLÀ,08029,080291,CABRERA DE MAR,44,12,56
2023/2024,08076509,INSTITUT ESCOLA ARTS,08019,080193,BARCELONA,46,8,54
2023/2024,08076492,INSTITUT ESCOLA POMPEU FABRA,08182,081825,EL PONT DE VILOMARA I ROCAFORT,40,15,55
2023/2024,08076480,INSTITUT ESCOLA PALLARESA,08245,082457,SANTA COLOMA DE GRAMENET,44,10,54
2023/2024,08076479,INSTITUT ESCOLA SANT QUINTÍ DE MEDIONA,08236,082362,SANT QUINTÍ DE MEDIONA,31,14,45
2023/2024,08076467,INSTITUT ESCOLA PERE LLISCART,08101,081017,L'HOSPITALET DE LLOBREGAT,50,16,66
2023/2024,08076455,INSTITUT ESCOLA SANT JORDI,08015,080155,BADALONA,23,7,30
2023/2024,08076443,INSTITUT ESCOLA RAFAEL ALBERTI,08015,080155,BADALONA,37,13,50
2023/2024,08076431,INSTITUT ESCOLA BALDOMER SOLÀ,08015,080155,BADALONA,36,15,51
2023/2024,08076421,INSTITUT ESCOLA PEPA COLOMER,08169,081691,EL PRAT DE LLOBREGAT,45,13,58
2023/2024,08076406,INSTITUT NARCISA FREIXAS I CRUELLS,08187,081878,SABADELL,21,8,29
2023/2024,08076391,INSTITUT PEDRALBES,08019,080193,BARCELONA,73,66,139
2023/2024,08076194,INSTITUT TECNOLÒGIC DE BARCELONA,08019,080193,BARCELONA,21,45,66
2023/2024,08076169,INSTITUT ESCOLA GORNAL,08101,081017,L'HOSPITALET DE LLOBREGAT,25,9,34
2023/2024,08076157,INSTITUT ESCOLA ÀNGELA BRANSUELA,08121,081213,MATARÓ,34,13,47
2023/2024,08076145,INSTITUT ESCOLA MAR MEDITERRÀNIA,08121,081213,MATARÓ,43,12,55
2023/2024,08076111,INSTITUT JAUME BOTEY,08101,081017,L'HOSPITALET DE LLOBREGAT,34,13,47
2023/2024,08076091,INSTITUT CA N'ORIAC,08187,081878,SABADELL,18,14,32
2023/2024,08076078,ESCOLA AUDITORI,08019,080193,BARCELONA,17,3,20
2023/2024,08075724,ESCOLA NORAI,08126,081265,MONTGAT,13,0,13
2023/2024,08075712,INSTITUT LES CINC SÉNIES,08121,081213,MATARÓ,40,13,53
2023/2024,08075700,ESCOLA XIRINACS,08019,080193,BARCELONA,22,2,24
2023/2024,08075682,INSTITUT OLÍMPIA,08301,083015,VILADECANS,24,11,35
2023/2024,08075670,INSTITUT ESCOLA TRINITAT NOVA,08019,080193,BARCELONA,52,14,66
2023/2024,08075669,INSTITUT ESCOLA EL TIL·LER,08019,080193,BARCELONA,31,9,40
2023/2024,08075657,INSTITUT ESCOLA ANTAVIANA,08019,080193,BARCELONA,43,23,66
2023/2024,08075645,ESCOLA LA FLOR DE MAIG,08019,080193,BARCELONA,21,5,26
2023/2024,08075633,ESCOLA ANGLESOLA,08019,080193,BARCELONA,22,5,27
2023/2024,08075621,ESCOLA TEIXIDORES DE GRÀCIA,08019,080193,BARCELONA,22,1,23
2023/2024,08075611,ESCOLA GAIA,08019,080193,BARCELONA,27,2,29
2023/2024,08075608,ESCOLA 9 GRAONS,08019,080193,BARCELONA,16,7,23
2023/2024,08075384,INSTITUT ESCOLA LA MINA,08194,081944,SANT ADRIÀ DE BESÒS,48,31,79
2023/2024,08075293,INSTITUT ESCOLA GAVÀ MAR,08089,080898,GAVÀ,45,13,58
2023/2024,08075281,INSTITUT BITÀCOLA,08252,082520,BARBERÀ DEL VALLÈS,15,11,26
2023/2024,08075268,ESCOLA LA MIRADA,08205,082055,SANT CUGAT DEL VALLÈS,28,3,31
2023/2024,08075256,INSTITUT ESCOLA MARTA MATA,08285,082858,TORELLÓ,46,9,55
2023/2024,08075244,ESCOLA LES BASES,08113,081136,MANRESA,13,4,17
2023/2024,08075207,ESCOLA ENTENÇA,08019,080193,BARCELONA,27,2,29
2023/2024,08075074,INSTITUT DE SANTA COLOMA DE GRAMENET,08245,082457,SANTA COLOMA DE GRAMENET,27,20,47
2023/2024,08074847,INSTITUT DE NÀUTICA DE BARCELONA,08019,080193,BARCELONA,10,23,33
2023/2024,08074835,ESCOLA JAUME LLULL,08197,081976,SANT ANDREU DE LLAVANERES,29,3,32
2023/2024,08074823,ESCOLA ELS PICOTS,08107,081075,LLIÇÀ D'AMUNT,26,4,30
2023/2024,08074811,ESCOLA TURÓ DE CAN GILI,08096,080961,GRANOLLERS,19,3,22
2023/2024,08074801,INSTITUT MARTA ESTRADA,08096,080961,GRANOLLERS,19,7,26
2023/2024,08074641,ESCOLA ELS 30 PASSOS,08019,080193,BARCELONA,22,8,30
2023/2024,08074631,INSTITUT LES SALINES,08169,081691,EL PRAT DE LLOBREGAT,76,53,129
2023/2024,08074628,INSTITUT ROSA RIBAS PARELLADA,08169,081691,EL PRAT DE LLOBREGAT,17,8,25
2023/2024,08074410,INSTITUT LA SERRA,08187,081878,SABADELL,21,8,29
2023/2024,08074380,ESCOLA CASTELL DE DOSRIUS,08075,080752,DOSRIUS,27,6,33
2023/2024,08074070,EOI DE CALELLA,08035,080351,CALELLA,4,3,7
2023/2024,08073961,INSTITUT PLA DEL BOSC,08043,080431,CANYELLES,24,12,36
2023/2024,08073958,ESCOLA NOVA D'ARGENTONA,08009,080095,ARGENTONA,20,4,24
2023/2024,08073843,INSTITUT TORDÀRIA,08284,082845,TORDERA,19,9,28
2023/2024,08073651,INSTITUT PIC DEL VENT,08033,080333,CALDES DE MONTBUI,17,7,24
2023/2024,08073193,INSTITUT BADIA I MARGARIT,08102,081022,IGUALADA,41,26,67
2023/2024,08073171,INSTITUT LA RIERA,08015,080155,BADALONA,19,11,30
2023/2024,08073119,INSTITUT CAN PERIQUET,08156,081568,PALAU-SOLITÀ I PLEGAMANS,21,3,24
2023/2024,08073077,INSTITUT MARIA CANELA,08114,081141,MARTORELL,19,12,31
2023/2024,08073031,INSTITUT NEUS CATALÀ,08073,080734,CORNELLÀ DE LLOBREGAT,14,14,28
2023/2024,08073028,INSTITUT DE SANT POL DE MAR,08235,082359,SANT POL DE MAR,27,14,41
2023/2024,08072978,INSTITUT SUNSI MÓRA,08040,080403,CANET DE MAR,15,15,30
2023/2024,08072607,EOI DE CORNELLÀ DE LLOBREGAT,08073,080734,CORNELLÀ DE LLOBREGAT,9,2,11
2023/2024,08072590,EOI DE RUBÍ,08184,081846,RUBÍ,5,1,6
2023/2024,08072589,EOI BARCELONA-GUINARDÓ,08019,080193,BARCELONA,4,7,11
2023/2024,08072401,INSTITUT TORRENT DELS ALOUS,08184,081846,RUBÍ,52,13,65
2023/2024,08072383,INSTITUT DOMUS D'OLIVET,08041,080410,CANOVELLES,20,7,27
2023/2024,08072310,INSTITUT ESCOLA REC COMTAL,08019,080193,BARCELONA,44,16,60
2023/2024,08072292,INSTITUT ESCOLA TURÓ DE ROQUETES,08019,080193,BARCELONA,44,17,61
2023/2024,08072255,INSTITUT PREMIÀ DE MAR,08172,081727,PREMIÀ DE MAR,62,67,129
2023/2024,08072188,INSTITUT ESCOLA SANT JORDI,08141,081419,NAVÀS,43,11,54
2023/2024,08072176,INSTITUT DEL TER,08112,081120,MANLLEU,33,5,38
2023/2024,08071691,INSTITUT ESCOLA DEL PRAT,08169,081691,EL PRAT DE LLOBREGAT,24,7,31
2023/2024,08071573,ESC.SUP.DISSENY ESDAP - CATALUNYA,08019,080193,BARCELONA,3,1,4
2023/2024,08071421,ZER EL MOIANÈS LLEVANT,08079,080790,L'ESTANY,2,2,4
2023/2024,08071238,INSTITUT ESCOLA JACINT VERDAGUER,08240,082401,SANT SADURNÍ D'ANOIA,47,18,65
2023/2024,08071226,INSTITUT ESCOLA COSTA I LLOBERA,08019,080193,BARCELONA,53,22,75
2023/2024,08071214,INSTITUT ESCOLA CASTELLTERÇOL,08064,080641,CASTELLTERÇOL,34,8,42
2023/2024,08071196,INSTITUT CAN ROCA,08279,082798,TERRASSA,33,29,62
2023/2024,08071147,ESCOLA ROSER CAPDEVILA,08217,082172,SANT JOAN DESPÍ,19,2,21
2023/2024,08071020,ESCOLA ENXANETA,08301,083015,VILADECANS,15,2,17
2023/2024,08070908,INSTITUT ESCOLA LA TORDERA,08259,082592,SANTA MARIA DE PALAUTORDERA,43,10,53
2023/2024,08070799,ESCOLA TIZIANA,08282,082824,TIANA,15,1,16
2023/2024,08070234,ESCOLA CAN FABRA,08019,080193,BARCELONA,29,1,30
2023/2024,08070143,ESCOLA RIERA ALTA,08245,082457,SANTA COLOMA DE GRAMENET,24,5,29
2023/2024,08069751,ESCOLA SANTA COLOMA,08245,082457,SANTA COLOMA DE GRAMENET,12,5,17
2023/2024,08069748,ESCOLA MONTIGALÀ,08015,080155,BADALONA,12,4,16
2023/2024,08069736,ESCOLA PACO CANDEL,08101,081017,L'HOSPITALET DE LLOBREGAT,26,4,30
2023/2024,08069581,CFA CARME KARR,08218,082188,SANT JOAN DE VILATORRADA,13,3,16
2023/2024,08069499,ESCOLA VIC-CENTRE,08298,082981,VIC,22,5,27
2023/2024,08068616,INSTITUT BAGES SUD,08053,080538,CASTELLBELL I EL VILAR,18,10,28
2023/2024,08068537,INSTITUT LES AIMERIGUES,08279,082798,TERRASSA,42,22,64
2023/2024,08068495,INSTITUT JOSEFINA CASTELLVÍ I PIULACHS,08301,083015,VILADECANS,26,22,48
2023/2024,08068410,ESCOLA PALAU D'AMETLLA,08136,081363,MONTORNÈS DEL VALLÈS,10,6,16
2023/2024,08068380,INSTITUT GURB,08100,081000,GURB,25,18,43
2023/2024,08068379,ESCOLA MAR NOVA,08172,081727,PREMIÀ DE MAR,13,1,14
2023/2024,08068343,ESCOLA LES CIÈNCIES,08015,080155,BADALONA,12,4,16
2023/2024,08068331,ESCOLA BADALONA PORT,08015,080155,BADALONA,15,1,16
2023/2024,08068197,ZER EL CARDENER,08229,082299,SANT MATEU DE BAGES,2,1,3
2023/2024,08068136,CFA VÍCTOR CATALÀ,08208,082080,SANT ESTEVE SESROVIRES,18,6,24
2023/2024,08067818,ESCOLA LA SÍNIA,08298,082981,VIC,33,6,39
2023/2024,08067764,ESCOLA LA MAQUINISTA,08019,080193,BARCELONA,28,3,31
2023/2024,08067752,INSTITUT SAGRERA SANT ANDREU,08019,080193,BARCELONA,23,19,42
2023/2024,08067740,INSTITUT VALLCARCA,08019,080193,BARCELONA,2,5,7
2023/2024,08067661,ESCOLA JOAN COROMINES,08121,081213,MATARÓ,26,3,29
2023/2024,08067648,INSTITUT LES VINYES,08074,080749,CUBELLES,13,10,23
2023/2024,08067636,INSTITUT MANRESA SIS,08113,081136,MANRESA,24,10,34
2023/2024,08067600,ESCOLA VALLDAURA,08113,081136,MANRESA,17,2,19
2023/2024,08067594,INSTITUT ESCOLA LES VINYES,08054,080543,CASTELLBISBAL,32,11,43
2023/2024,08067582,ESCOLA MARTA MATA,08252,082520,BARBERÀ DEL VALLÈS,13,4,17
2023/2024,08067430,ESCOLA MONTSERRAT SOLÀ,08121,081213,MATARÓ,25,5,30
2023/2024,08067247,ESCOLA EL VAPOR,08279,082798,TERRASSA,32,3,35
2023/2024,08067235,ESCOLA ROC ALABERN,08279,082798,TERRASSA,26,5,31
2023/2024,08067211,INSTITUT SALAS I XANDRI,08238,082384,SANT QUIRZE DEL VALLÈS,19,4,23
2023/2024,08067201,ESCOLA LOLA ANGLADA,08238,082384,SANT QUIRZE DEL VALLÈS,22,3,25
2023/2024,08067193,ESCOLA DEL BOSC,08184,081846,RUBÍ,14,5,19
2023/2024,08067181,ESCOLA DE RELLINARS,08179,081799,RELLINARS,9,3,12
2023/2024,08067144,INSTITUT DE CERVELLÓ,08068,080689,CERVELLÓ,24,13,37
2023/2024,08067132,ESCOLA JOSEFINA IBÁÑEZ,08001,080018,ABRERA,15,2,17
2023/2024,08067120,ESCOLA SANTA AGNÈS DE MALANYANES,08181,081810,LA ROCA DEL VALLÈS,13,1,14
2023/2024,08067090,ESCOLA CAN MANENT,08046,080462,CARDEDEU,24,4,28
2023/2024,08067041,ESCOLA XORIGUER,08067,080673,CENTELLES,13,1,14
2023/2024,08067016,ESCOLA ERNEST LLUCH,08101,081017,L'HOSPITALET DE LLOBREGAT,24,4,28
2023/2024,08066905,INSTITUT VILADOMAT,08019,080193,BARCELONA,26,21,47
2023/2024,08066887,EOI DE VILADECANS,08301,083015,VILADECANS,8,4,12
2023/2024,08066851,EOI DE MOLLET DEL VALLÈS,08124,081249,MOLLET DEL VALLÈS,5,3,8
2023/2024,08066565,INSTITUT JONCAR,08019,080193,BARCELONA,28,17,45
2023/2024,08066541,INSTITUT MARIA ESPINALT,08019,080193,BARCELONA,41,19,60
2023/2024,08066531,ESCOLA FLUVIÀ,08019,080193,BARCELONA,26,6,32
2023/2024,08066528,INSTITUT MARTÍ POUS,08019,080193,BARCELONA,31,25,56
2023/2024,08066516,ESCOLA CONGRÉS-INDIANS,08019,080193,BARCELONA,28,2,30
2023/2024,08066504,ESCOLA L'UNIVERS,08019,080193,BARCELONA,29,2,31
2023/2024,08066462,ESCOLA DELS ENCANTS,08019,080193,BARCELONA,25,6,31
2023/2024,08066437,INSTITUT MONT PERDUT,08279,082798,TERRASSA,37,26,63
2023/2024,08066413,ESCOLA COLORS,08086,080863,LES FRANQUESES DEL VALLÈS,15,1,16
2023/2024,08066334,ESCOLA LA SERRETA,08192,081923,SANTPEDOR,15,1,16
2023/2024,08066322,INSTITUT CARDENER,08218,082188,SANT JOAN DE VILATORRADA,15,9,24
2023/2024,08066048,ESCOLA ROSER CAPDEVILA,08279,082798,TERRASSA,33,4,37
2023/2024,08065664,EOI DEL BERGUEDÀ,08022,080229,BERGA,4,1,5
2023/2024,08065652,EOI DE L'ALT PENEDÈS,08305,083054,VILAFRANCA DEL PENEDÈS,3,4,7
2023/2024,08065512,ESCOLA SERRA DE L'OBAC,08279,082798,TERRASSA,25,5,30
2023/2024,08065482,ESCOLA ELS VENTETS - ZER EL MOIANÈS LLEVANT,08070,080706,COLLSUSPINA,3,2,5
2023/2024,08065469,INSTITUT CAN RECORD,08207,082074,SANT ESTEVE DE PALAUTORDERA,19,7,26
2023/2024,08065433,INSTITUT LA SÍNIA,08159,081593,PARETS DEL VALLÈS,16,6,22
2023/2024,08065421,INSTITUT MARTA MATA,08136,081363,MONTORNÈS DEL VALLÈS,30,23,53
2023/2024,08065411,INSTITUT AIGUAVIVA,08124,081249,MOLLET DEL VALLÈS,30,19,49
2023/2024,08065391,INSTITUT EL TIL·LER,08086,080863,LES FRANQUESES DEL VALLÈS,36,18,54
2023/2024,08065366,INSTITUT DE PINEDA DE MAR,08163,081635,PINEDA DE MAR,35,12,47
2023/2024,08065354,INSTITUT BAIX A MAR,08307,083073,VILANOVA I LA GELTRÚ,31,21,52
2023/2024,08065342,INSTITUT XALOC,08231,082310,SANT PERE DE RIBES,16,8,24
2023/2024,08065330,INSTITUT CAL GRAVAT,08113,081136,MANRESA,42,19,61
2023/2024,08065329,INSTITUT DE L'ALT FOIX,08227,082270,SANT MARTÍ SARROCA,28,15,43
2023/2024,08065305,ESCOLA SOLER DE VILARDELL,08202,082021,SANT CELONI,19,0,19
2023/2024,08065299,ESCOLA EL CALDERÍ,08033,080333,CALDES DE MONTBUI,14,2,16
2023/2024,08065287,ESCOLA MARTA MATA,08121,081213,MATARÓ,29,1,30
2023/2024,08065275,ESCOLA VOLERANY,08307,083073,VILANOVA I LA GELTRÚ,23,6,29
2023/2024,08065263,ESCOLA PUIGSOLER,08262,082628,SANT VICENÇ DE CASTELLET,20,1,21
2023/2024,08065251,ESCOLA PLA DEL PUIG,08213,082135,SANT FRUITÓS DE BAGES,15,2,17
2023/2024,08065238,ESCOLA LA SAGRERA,08248,082482,SANTA EULÀLIA DE RONÇANA,26,4,30
2023/2024,08065019,INSTITUT DE VALLBONA D'ANOIA,08292,082922,VALLBONA D'ANOIA,16,5,21
2023/2024,08065007,ESCOLA POBLENOU,08163,081635,PINEDA DE MAR,13,3,16
2023/2024,08064994,ESCOLA MARIA-MERCÈ MARÇAL,08121,081213,MATARÓ,26,3,29
2023/2024,08064982,ESCOLA DE SANT QUIRZE SAFAJA - ZER EL MOIANÈS LLEVANT,08239,082397,SANT QUIRZE SAFAJA,5,1,6
2023/2024,08064970,INSTITUT NOU DE VILAFRANCA DEL PENEDÈS,08305,083054,VILAFRANCA DEL PENEDÈS,32,21,53
2023/2024,08064945,ESCOLA MANSUET,08069,080692,COLLBATÓ,18,0,18
2023/2024,08064921,INSTITUT DE SANT ANDREU,08196,081960,SANT ANDREU DE LA BARCA,23,13,36
2023/2024,08064911,INSTITUT VALÈRIA HALINÉ,08056,080569,CASTELLDEFELS,23,20,43
2023/2024,08064908,INSTITUT BEGUES,08020,080207,BEGUES,19,5,24
2023/2024,08064881,ESCOLA CAMPDERRÓS,08295,082956,VALLIRANA,19,2,21
2023/2024,08064866,ESCOLA DOLORS MARTÍ I BADIA,08102,081022,IGUALADA,27,3,30
2023/2024,08064854,ESCOLA MARTINET,08073,080734,CORNELLÀ DE LLOBREGAT,22,7,29
2023/2024,08064830,INSTITUT SERRA DE NOET,08022,080229,BERGA,27,5,32
2023/2024,08064829,ESCOLA VALLDENEU,08224,082248,SANT MARTÍ DE CENTELLES,7,1,8
2023/2024,08064817,ESCOLA CAMINS,08086,080863,LES FRANQUESES DEL VALLÈS,29,2,31
2023/2024,08064805,ESCOLA ELS QUATRE VENTS,08041,080410,CANOVELLES,31,6,37
2023/2024,08064787,ESCOLA EMILI TEIXIDOR,08183,081831,RODA DE TER,19,0,19
2023/2024,08064741,ESCOLA ÍTACA,08113,081136,MANRESA,28,4,32
2023/2024,08064738,ESCOLA DOLORS PIERA,08305,083054,VILAFRANCA DEL PENEDÈS,29,5,34
2023/2024,08064659,CFA SALVADOR DALÍ,08181,081810,LA ROCA DEL VALLÈS,17,7,24
2023/2024,08064647,CFA ARTUR MARTORELL,08208,082080,SANT ESTEVE SESROVIRES,15,8,23
2023/2024,08064635,CFA SANTIAGO RUSIÑOL,08181,081810,LA ROCA DEL VALLÈS,11,5,16
2023/2024,08064623,CFA CONCEPCIÓ ARENAL,08019,080193,BARCELONA,3,1,4
2023/2024,08064222,ESCOLA LA ROUREDA,08284,082845,TORDERA,28,2,30
2023/2024,08064192,INSTITUT ANGELETA FERRER,08019,080193,BARCELONA,16,10,26
2023/2024,08064179,ESCOLA LA LLACUNA DEL POBLENOU,08019,080193,BARCELONA,29,1,30
2023/2024,08064167,ESCOLA SANT MARTÍ,08019,080193,BARCELONA,26,3,29
2023/2024,08064155,INSTITUT QUATRE CANTONS,08019,080193,BARCELONA,27,20,47
2023/2024,08064143,ESCOLA LA NOVA ELECTRA,08279,082798,TERRASSA,30,8,38
2023/2024,08064118,ESCOLA CIUTAT D'ALBA,08205,082055,SANT CUGAT DEL VALLÈS,28,2,30
2023/2024,08064088,ESCOLA MAS BOADELLA,08187,081878,SABADELL,25,5,30
2023/2024,08064076,ESCOLA RIVO RUBEO,08184,081846,RUBÍ,25,5,30
2023/2024,08064027,ESCOLA EL SOL I LA LLUNA,08051,080517,CASTELLAR DEL VALLÈS,17,4,21
2023/2024,08064003,INSTITUT CAN MARGARIT,08072,080728,CORBERA DE LLOBREGAT,23,19,42
2023/2024,08063965,ESCOLA CAU DE LA GUINEU,08072,080728,CORBERA DE LLOBREGAT,15,1,16
2023/2024,08063931,ESCOLA LES FALGUERES,08082,080826,FOGARS DE LA SELVA,12,3,15
2023/2024,08063928,ESCOLA MUNTANYOLA,08129,081290,MUNTANYOLA,7,1,8
2023/2024,08063916,ESCOLA VILA PARIETES,08159,081593,PARETS DEL VALLÈS,14,3,17
2023/2024,08063904,INSTITUT MONTGRÒS,08231,082310,SANT PERE DE RIBES,26,19,45
2023/2024,08063898,ESCOLA LA SÈQUIA,08113,081136,MANRESA,29,4,33
2023/2024,08063886,ESCOLA ARRELS,08251,082515,SANTA MARGARIDA I ELS MONJOS,16,0,16
2023/2024,08063874,ESCOLA ANTONIO MACHADO,08121,081213,MATARÓ,26,4,30
2023/2024,08063862,ESCOLA L'OLIVAR,08062,080620,CASTELLNOU DE BAGES,14,3,17
2023/2024,08063837,INSTITUT LES MARGUES,08037,080370,CALLDETENES,16,15,31
2023/2024,08063813,INSTITUT CREU DE SABA,08147,081477,OLESA DE MONTSERRAT,30,20,50
2023/2024,08063801,INSTITUT DE COLLBATÓ,08069,080692,COLLBATÓ,20,13,33
2023/2024,08063795,ESCOLA MARTA MATA,08302,083020,VILANOVA DEL CAMÍ,13,3,16
2023/2024,08063783,ESCOLA MEDITERRÀNIA,08301,083015,VILADECANS,15,2,17
2023/2024,08063771,ESCOLA PLA DE LES VINYES,08244,082444,SANTA COLOMA DE CERVELLÓ,21,2,23
2023/2024,08063761,ESCOLA VICENTE FERRER,08200,082009,SANT BOI DE LLOBREGAT,15,3,18
2023/2024,08063758,ESCOLA CAN SALVI,08196,081960,SANT ANDREU DE LA BARCA,28,2,30
2023/2024,08063734,ESCOLA PUIGVENTÓS,08147,081477,OLESA DE MONTSERRAT,24,6,30
2023/2024,08063710,ESCOLA ESCOLA NOVA,08068,080689,CERVELLÓ,17,1,18
2023/2024,08063643,CFA LA COOPERATIVA,08285,082858,TORELLÓ,1,2,3
2023/2024,08063621,CFA MARTÍ I POL,08112,081120,MANLLEU,2,2,4
2023/2024,08063618,CFA ESPARREGUERA,08076,080765,ESPARREGUERA,2,3,5
2023/2024,08063394,ESCOLA MIQUEL MARTÍ I POL,08211,082114,SANT FELIU DE LLOBREGAT,29,3,32
2023/2024,08063229,INSTITUT MONTPEDRÓS,08244,082444,SANTA COLOMA DE CERVELLÓ,41,22,63
2023/2024,08063072,ESCOLA FRUCTUÓS GELABERT,08019,080193,BARCELONA,29,1,30
2023/2024,08062948,ESCOLA MIQUEL MARTÍ I POL,08301,083015,VILADECANS,32,4,36
2023/2024,08062924,ESCOLA JOSEP GUINOVART,08056,080569,CASTELLDEFELS,15,2,17
2023/2024,08062870,INSTITUT LA PLANA,08298,082981,VIC,39,23,62
2023/2024,08062869,ESCOLA SERRA DE MIRALLES,08284,082845,TORDERA,16,4,20
2023/2024,08062857,INSTITUT TIANA,08282,082824,TIANA,30,17,47
2023/2024,08062833,ESCOLA AGNÈS DE SITGES,08270,082704,SITGES,18,4,22
2023/2024,08062811,ESCOLA MATAGALLS,08259,082592,SANTA MARIA DE PALAUTORDERA,15,1,16
2023/2024,08062808,INSTITUT ESTEVE ALBERT,08264,082649,SANT VICENÇ DE MONTALT,28,18,46
2023/2024,08062791,INSTITUT VILAMAJOR,08234,082346,SANT PERE DE VILAMAJOR,35,16,51
2023/2024,08062781,ESCOLA MEDITERRÀNIA,08231,082310,SANT PERE DE RIBES,27,4,31
2023/2024,08062778,ESCOLA AMETLLERS,08218,082188,SANT JOAN DE VILATORRADA,23,3,26
2023/2024,08062754,ESCOLA LES FONTS,08091,080919,GELIDA,23,5,28
2023/2024,08062742,ESCOLA BENVIURE,08054,080543,CASTELLBISBAL,16,2,18
2023/2024,08062730,INSTITUT ELS ROURES,08075,080752,DOSRIUS,17,7,24
2023/2024,08062729,INSTITUT PLA MARCELL,08046,080462,CARDEDEU,54,23,77
2023/2024,08062717,INSTITUT CABRILS,08030,080305,CABRILS,20,15,35
2023/2024,08062705,ESCOLA LA CABANA,08027,080272,LES CABANYES,13,2,15
2023/2024,08062687,ESCOLA PONENT,08279,082798,TERRASSA,26,4,30
2023/2024,08062675,ESCOLA PERE IV,08019,080193,BARCELONA,28,3,31
2023/2024,08062641,ESCOLA L'OLIVERA,08205,082055,SANT CUGAT DEL VALLÈS,26,4,30
2023/2024,08062638,ESCOLA LA TRAMA,08187,081878,SABADELL,23,3,26
2023/2024,08062626,ESCOLA COLLSEROLA,08266,082665,CERDANYOLA DEL VALLÈS,15,1,16
2023/2024,08062614,ESCOLA JOAN BLANQUER,08051,080517,CASTELLAR DEL VALLÈS,16,1,17
2023/2024,08062523,CFA MARINADA,08136,081363,MONTORNÈS DEL VALLÈS,2,2,4
2023/2024,08062511,CFA ALARONA,08121,081213,MATARÓ,4,2,6
2023/2024,08062493,CFA SANT RAMON,08101,081017,L'HOSPITALET DE LLOBREGAT,4,4,8
2023/2024,08062481,CFA SANT JOSEP,08101,081017,L'HOSPITALET DE LLOBREGAT,5,2,7
2023/2024,08062471,CFA GAVÀ,08089,080898,GAVÀ,4,3,7
2023/2024,08062468,CFA BELLAVISTA,08086,080863,LES FRANQUESES DEL VALLÈS,2,2,4
2023/2024,08062331,CFA PERE CALDERS,08019,080193,BARCELONA,6,4,10
2023/2024,08062262,CFA MONTSERRAT ROIG,08019,080193,BARCELONA,7,1,8
2023/2024,08062250,CFA GUINARDÓ,08019,080193,BARCELONA,4,1,5
2023/2024,08062249,CFA EL CARMEL,08019,080193,BARCELONA,6,3,9
2023/2024,08062225,EOI GARRAF,08307,083073,VILANOVA I LA GELTRÚ,6,3,9
2023/2024,08062213,EOI VALLÈS ORIENTAL,08096,080961,GRANOLLERS,4,4,8
2023/2024,08062201,EOI BARCELONA V,08019,080193,BARCELONA,7,1,8
2023/2024,08062195,EOI BARCELONA IV,08019,080193,BARCELONA,11,2,13
2023/2024,08062183,EOI OSONA,08298,082981,VIC,5,3,8
2023/2024,08062171,EOI D'IGUALADA,08102,081022,IGUALADA,7,1,8
2023/2024,08062161,EOI DE SANT CUGAT DEL VALLÈS,08205,082055,SANT CUGAT DEL VALLÈS,7,2,9
2023/2024,08062158,EOI DE MARTORELL,08114,081141,MARTORELL,7,2,9
2023/2024,08062146,CFA LA VERNEDA,08019,080193,BARCELONA,3,4,7
2023/2024,08062122,CFA MARTORELL,08114,081141,MARTORELL,4,5,9
2023/2024,08062110,CFA SANFELIU,08101,081017,L'HOSPITALET DE LLOBREGAT,3,3,6
2023/2024,08062109,AFA CIUTAT MERIDIANA,08019,080193,BARCELONA,5,2,7
2023/2024,08062092,CFA VILAFRANCA DEL PENEDÈS,08305,083054,VILAFRANCA DEL PENEDÈS,4,6,10
2023/2024,08062080,CFA EGARA,08279,082798,TERRASSA,8,3,11
2023/2024,08062079,CFA RAMON LLULL,08279,082798,TERRASSA,5,1,6
2023/2024,08062055,CFA SANT JUST DESVERN,08221,082212,SANT JUST DESVERN,3,1,4
2023/2024,08062043,CFA PARETS DEL VALLÈS,08159,081593,PARETS DEL VALLÈS,1,3,4
2023/2024,08062031,CFA MARE DE DÉU DE MONTSERRAT,08147,081477,OLESA DE MONTSERRAT,5,1,6
2023/2024,08062021,CFA MONTCADA I REIXAC,08125,081252,MONTCADA I REIXAC,6,3,9
2023/2024,08062018,CFA ANOIA,08102,081022,IGUALADA,1,5,6
2023/2024,08061993,CFA EUGENI D'ORS,08077,080771,ESPLUGUES DE LLOBREGAT,8,3,11
2023/2024,08061971,CFA BERGUEDÀ,08022,080229,BERGA,4,2,6
2023/2024,08061968,CFA LES CORTS,08019,080193,BARCELONA,6,2,8
2023/2024,08061956,CFA PROSPERITAT,08019,080193,BARCELONA,3,3,6
2023/2024,08061944,CFA MADRID,08019,080193,BARCELONA,3,1,4
2023/2024,08061932,CFA BON PASTOR,08019,080193,BARCELONA,7,2,9
2023/2024,08061919,CFA RIUS I TAULET,08019,080193,BARCELONA,7,3,10
2023/2024,08061907,CFA BARCELONETA,08019,080193,BARCELONA,4,3,7
2023/2024,08061774,ESCOLA LES ARENES,08279,082798,TERRASSA,27,4,31
2023/2024,08061762,ESCOLA MAS MARIA,08030,080305,CABRILS,21,3,24
2023/2024,08061725,EOI BARCELONA III,08019,080193,BARCELONA,7,4,11
2023/2024,08061701,CFA MARIA RUBIES,08019,080193,BARCELONA,6,5,11
2023/2024,08061683,CFA PALAU DE MAR,08019,080193,BARCELONA,7,2,9
2023/2024,08061610,ESCOLA LA SÍNIA,08123,081234,MOLINS DE REI,29,7,36
2023/2024,08061609,ESCOLA MERCÈ RODOREDA,08114,081141,MARTORELL,30,2,32
2023/2024,08061580,CFA LLOREDA-LA PAU,08015,080155,BADALONA,6,1,7
2023/2024,08061555,CFA CAN FOLGUERA,08260,082606,SANTA PERPÈTUA DE MOGODA,6,2,8
2023/2024,08061543,ESCOLA ROSER CAPDEVILA,08167,081672,POLINYÀ,24,4,28
2023/2024,08061521,ESCOLA VALL DE NÉSPOLA - ZER EL MOIANÈS PONENT,08139,081398,MURA,2,1,3
2023/2024,08061348,ESCOLA BUFALÀ,08015,080155,BADALONA,30,3,33
2023/2024,08061221,CFA VALLÈS,08096,080961,GRANOLLERS,7,5,12
2023/2024,08061208,INSTITUT VACARISSES,08291,082917,VACARISSES,29,19,48
2023/2024,08061191,ESCOLA FONT DE L'ORPINA,08291,082917,VACARISSES,17,3,20
2023/2024,08061178,ESCOLA TURÓ DE CAN MATES,08205,082055,SANT CUGAT DEL VALLÈS,29,2,31
2023/2024,08061166,ESCOLA DE CAN LLONG,08187,081878,SABADELL,23,6,29
2023/2024,08061154,ESCOLA CA N'ALZAMORA,08184,081846,RUBÍ,26,6,32
2023/2024,08061142,ESCOLA MIQUEL MARTÍ I POL,08252,082520,BARBERÀ DEL VALLÈS,28,3,31
2023/2024,08061129,INSTITUT MONTSERRAT COLOMER,08208,082080,SANT ESTEVE SESROVIRES,41,14,55
2023/2024,08061117,INSTITUT TURÓ D'EN BALDIRI,08281,082819,TEIÀ,18,8,26
2023/2024,08061105,ESCOLA SOT DEL CAMP,08264,082649,SANT VICENÇ DE MONTALT,25,0,25
2023/2024,08061099,INSTITUT FONT DEL FERRO,08155,081555,PALAFOLLS,39,20,59
2023/2024,08061087,ESCOLA MARINA,08126,081265,MONTGAT,26,4,30
2023/2024,08061063,ESCOLA LA SERRETA,08003,080039,ALELLA,18,3,21
2023/2024,08061051,ESCOLA ÍTACA,08307,083073,VILANOVA I LA GELTRÚ,28,2,30
2023/2024,08061041,ESCOLA SANT JORDI,08307,083073,VILANOVA I LA GELTRÚ,30,4,34
2023/2024,08061038,INSTITUT DE VILANOVA DEL VALLÈS,08902,089024,VILANOVA DEL VALLÈS,26,19,45
2023/2024,08061026,ESCOLA LA FALGUERA,08902,089024,VILANOVA DEL VALLÈS,15,2,17
2023/2024,08061014,INSTITUT VINYET,08270,082704,SITGES,35,19,54
2023/2024,08061002,ESCOLA LES PARELLADES,08231,082310,SANT PERE DE RIBES,13,4,17
2023/2024,08060991,ESCOLA MOGENT,08181,081810,LA ROCA DEL VALLÈS,24,3,27
2023/2024,08060988,ESCOLA CAL MÚSIC,08124,081249,MOLLET DEL VALLÈS,18,5,23
2023/2024,08060976,INSTITUT DEL VOLTREGANÈS,08117,081173,LES MASIES DE VOLTREGÀ,26,10,36
2023/2024,08060964,ESCOLA QUATRE VENTS,08112,081120,MANLLEU,41,4,45
2023/2024,08060952,ESCOLA ELS VINYALS,08108,081081,LLIÇÀ DE VALL,17,1,18
2023/2024,08060940,ESCOLA ROSA ORIOL ANGUERA,08107,081075,LLIÇÀ D'AMUNT,25,4,29
2023/2024,08060939,ESCOLA GUERAU DE LIOST,08086,080863,LES FRANQUESES DEL VALLÈS,24,5,29
2023/2024,08060927,ESCOLA VORA DEL MAR,08074,080749,CUBELLES,30,3,33
2023/2024,08060915,INSTITUT MARIA DE BELL-LLOC,08023,080235,BIGUES I RIELLS DEL FAI,31,17,48
2023/2024,08060903,ESCOLA EL COLOMER,08023,080235,BIGUES I RIELLS DEL FAI,28,3,31
2023/2024,08060873,ESCOLA EULÀLIA BOTA,08019,080193,BARCELONA,27,3,30
2023/2024,08060851,ESCOLA L'OLIVERA,08295,082956,VALLIRANA,24,6,30
2023/2024,08060848,ESCOLA DE SANT ANDREU DE LA BARCA,08196,081960,SANT ANDREU DE LA BARCA,27,4,31
2023/2024,08060836,ESCOLA TURÓ DEL DRAC,08040,080403,CANET DE MAR,26,4,30
2023/2024,08060757,ESCOLA JOAN TORREDEMER CANELA,08120,081206,MATADEPERA,28,2,30
2023/2024,08060629,ESCOLA EL CORB,08072,080728,CORBERA DE LLOBREGAT,18,1,19
2023/2024,08060605,ESCOLA FONT DEL ROURE,08119,081192,MASQUEFA,25,4,29
2023/2024,08060599,ESCOLA GARIGOT,08056,080569,CASTELLDEFELS,26,6,32
2023/2024,08060538,EOI DEL PRAT DE LLOBREGAT,08169,081691,EL PRAT DE LLOBREGAT,9,2,11
2023/2024,08060526,ESCOLA CREIXÀ,08161,081614,PIERA,11,2,13
2023/2024,08060514,INSTITUT DE MASQUEFA,08119,081192,MASQUEFA,34,21,55
2023/2024,08060484,ESCOLA TAULA RODONA,08238,082384,SANT QUIRZE DEL VALLÈS,26,4,30
2023/2024,08060423,ESCOLA MAS PRATS,08155,081555,PALAFOLLS,28,2,30
2023/2024,08060411,CFA SANTS-SANT RAIMON DE PENYAFORT,08019,080193,BARCELONA,4,3,7
2023/2024,08060319,ESCOLA LES FONTS,08009,080095,ARGENTONA,18,5,23
2023/2024,08060290,CFA SINGUERLÍN,08245,082457,SANTA COLOMA DE GRAMENET,5,6,11
2023/2024,08060289,CFA FONDO,08245,082457,SANTA COLOMA DE GRAMENET,9,5,14
2023/2024,08060277,CFA PAU CASALS,08184,081846,RUBÍ,7,5,12
2023/2024,08060265,CFA PREMIÀ DE MAR,08172,081727,PREMIÀ DE MAR,4,4,8
2023/2024,08060253,CFA CAN MARFÀ,08121,081213,MATARÓ,10,3,13
2023/2024,08060231,CFA PEGASO,08019,080193,BARCELONA,7,4,11
2023/2024,08060228,CFA EL CLOT,08019,080193,BARCELONA,6,6,12
2023/2024,08060216,CFA MORERA POMAR,08015,080155,BADALONA,9,3,12
2023/2024,08060204,CFA GRAN SOL,08015,080155,BADALONA,9,4,13
2023/2024,08060137,CFA EDÈLIA HERNÁNDEZ,08301,083015,VILADECANS,8,3,11
2023/2024,08060113,CFA JACINT CARRIÓ I VILASECA,08113,081136,MANRESA,8,5,13
2023/2024,08060095,CFA MONTSENY,08298,082981,VIC,10,1,11
2023/2024,08060009,INSTITUT MANUEL CARRASCO I FORMIGUERA,08210,082107,SANT FELIU DE CODINES,14,8,22
2023/2024,08059998,ESCOLA LA PAU,08240,082401,SANT SADURNÍ D'ANOIA,25,5,30
2023/2024,08059871,ESCOLA GERBERT D'ORLHAC,08205,082055,SANT CUGAT DEL VALLÈS,30,3,33
2023/2024,08059822,ESCOLA ERNEST LLUCH,08001,080018,ABRERA,27,4,31
2023/2024,08059810,ESCOLA VINYA DEL SASTRET,08208,082080,SANT ESTEVE SESROVIRES,15,4,19
2023/2024,08059809,ESCOLA EL ROURE,08209,082093,SANT FOST DE CAMPSENTELLES,14,2,16
2023/2024,08059792,ESCOLA MOGENT,08136,081363,MONTORNÈS DEL VALLÈS,27,3,30
2023/2024,08059780,ESCOLA BELLAVISTA-JOAN CAMPS I GIRÓ,08086,080863,LES FRANQUESES DEL VALLÈS,25,3,28
2023/2024,08059767,ESCOLA TANIT,08245,082457,SANTA COLOMA DE GRAMENET,18,3,21
2023/2024,08059755,ESCOLA LA FONT,08113,081136,MANRESA,32,3,35
2023/2024,08059731,CFA ARQUITECTE JUJOL,08217,082172,SANT JOAN DESPÍ,7,6,13
2023/2024,08059721,ESCOLA MARTA MATA,08301,083015,VILADECANS,30,2,32
2023/2024,08059706,CFA SALVADOR ESPRIU,08279,082798,TERRASSA,5,1,6
2023/2024,08059691,CFA ANNA MURIÀ,08279,082798,TERRASSA,9,4,13
2023/2024,08059688,INSTITUT MARIA AURÈLIA CAPMANY,08073,080734,CORNELLÀ DE LLOBREGAT,43,19,62
2023/2024,08059639,ESCOLA PROGRÉS,08015,080155,BADALONA,26,5,31
2023/2024,08059551,EOI DE MANRESA,08113,081136,MANRESA,11,3,14
2023/2024,08059524,INSTITUT DE NAVARCLES,08140,081402,NAVARCLES,13,10,23
2023/2024,08059354,ESCOLA LES ROQUES BLAVES,08076,080765,ESPARREGUERA,16,1,17
2023/2024,08059329,INSTITUT CAN PEIXAUET,08245,082457,SANTA COLOMA DE GRAMENET,37,29,66
2023/2024,08059093,ESCOLA D'HORTSAVINYÀ,08284,082845,TORDERA,4,2,6
2023/2024,08059044,CFA LA LLAGOSTA,08105,081056,LA LLAGOSTA,9,2,11
2023/2024,08058969,INSTITUT EL VERN,08108,081081,LLIÇÀ DE VALL,25,9,34
2023/2024,08058957,ESCOLA ELS COSTERETS,08231,082310,SANT PERE DE RIBES,30,2,32
2023/2024,08058817,ZER TRES BRANQUES,08063,080636,CASTELLOLÍ,2,2,4
2023/2024,08058775,INSTITUT FRONT MARÍTIM,08019,080193,BARCELONA,27,19,46
2023/2024,08058520,INSTITUT PUIG DE LA CREU,08051,080517,CASTELLAR DEL VALLÈS,36,14,50
2023/2024,08058519,ESCOLA SINERA,08006,080060,ARENYS DE MAR,25,5,30
2023/2024,08058465,ESCOLA ENXANETA,08279,082798,TERRASSA,41,4,45
2023/2024,08058441,ESCOLA GIROI,08088,080885,LA GARRIGA,17,3,20
2023/2024,08058428,INSTITUT BISAURA,08237,082378,SANT QUIRZE DE BESORA,15,4,19
2023/2024,08058416,ESCOLA L'ARENAL DE LLEVANT,08019,080193,BARCELONA,26,4,30
2023/2024,08058404,INSTITUT CIRVIÀNUM DE TORELLÓ,08285,082858,TORELLÓ,53,28,81
2023/2024,08058374,ESCOLA ELS ALOCS,08219,082191,VILASSAR DE MAR,17,2,19
2023/2024,08058362,ESCOLA RIERA DE RIBES,08231,082310,SANT PERE DE RIBES,25,5,30
2023/2024,08058210,CFA BADIA DEL VALLÈS,08904,089045,BADIA DEL VALLÈS,3,0,3
2023/2024,08058209,CFA SANT BOI,08200,082009,SANT BOI DE LLOBREGAT,7,4,11
2023/2024,08058091,ZER BAIX BERGUEDÀ,08144,081445,OLVAN,4,0,4
2023/2024,08058088,ZER BERGUEDÀ CENTRE,08299,082994,VILADA,3,0,3
2023/2024,08058076,ZER ELS CASTELLS,08253,082536,SANTA MARIA DE BESORA,3,1,4
2023/2024,08057965,CFA CAN SERRA,08101,081017,L'HOSPITALET DE LLOBREGAT,9,3,12
2023/2024,08057874,CFA CATALÒNIA,08101,081017,L'HOSPITALET DE LLOBREGAT,8,2,10
2023/2024,08057734,ESCOLA ANTONI GAUDÍ,08250,082508,SANTA MARGARIDA DE MONTBUI,28,6,34
2023/2024,08057679,CFA BELLVITGE-GORNAL,08101,081017,L'HOSPITALET DE LLOBREGAT,10,2,12
2023/2024,08057667,CFA TRINITAT VELLA,08019,080193,BARCELONA,3,3,6
2023/2024,08057540,INSTITUT JOAN BROSSA,08019,080193,BARCELONA,52,37,89
2023/2024,08057281,ZER CEP DE SIS,08249,082495,SANTA FE DEL PENEDÈS,4,1,5
2023/2024,08057266,ESCOLA ELS CINGLES,08005,080057,L'AMETLLA DEL VALLÈS,23,0,23
2023/2024,08057254,INSTITUT PERE RIBOT,08219,082191,VILASSAR DE MAR,32,15,47
2023/2024,08057242,ESCOLA SERENA VALL,08197,081976,SANT ANDREU DE LLAVANERES,25,5,30
2023/2024,08057230,INSTITUT CUBELLES,08074,080749,CUBELLES,42,20,62
2023/2024,08057229,ESCOLA ELS ARENYS,08054,080543,CASTELLBISBAL,15,2,17
2023/2024,08057163,CFA TERESA MAÑÉ,08307,083073,VILANOVA I LA GELTRÚ,8,7,15
2023/2024,08057102,ESCOLA ANDERSEN,08298,082981,VIC,33,3,36
2023/2024,08057096,ESCOLA GUILLEM DE MONT-RODON,08298,082981,VIC,27,8,35
2023/2024,08057011,CFA CAN RULL,08187,081878,SABADELL,6,3,9
2023/2024,08057001,CFA LA CREU DE BARBERÀ,08187,081878,SABADELL,7,2,9
2023/2024,08056997,CFA LA CONCÒRDIA,08187,081878,SABADELL,9,8,17
2023/2024,08056985,INSTITUT RAMON BERENGUER IV,08245,082457,SANTA COLOMA DE GRAMENET,45,26,71
2023/2024,08056857,ZER GAVARRESA,08212,082129,SANT FELIU SASSERRA,4,0,4
2023/2024,08056833,ZER BAIX MONTSENY,08259,082592,SANTA MARIA DE PALAUTORDERA,4,1,5
2023/2024,08056811,ZER ALT BERGUEDÀ,08293,082938,VALLCEBRE,2,1,3
2023/2024,08056791,ZER VENT D'AVALL,08170,081705,ELS PRATS DE REI,3,1,4
2023/2024,08056781,ZER SERRA D'ANCOSA,08104,081043,LA LLACUNA,1,3,4
2023/2024,08056766,ZER SUBIRATS,08273,082732,SUBIRATS,4,0,4
2023/2024,08056742,ZER ALT LLUÇANÈS,08201,082016,SANT BOI DE LLUÇANÈS,3,1,4
2023/2024,08056729,ZER EL MOIANÈS PONENT,08034,080348,CALDERS,5,0,5
2023/2024,08056614,ESCOLA CIRERA,08121,081213,MATARÓ,19,1,20
2023/2024,08056584,CFA L'ALZINA DE CERDANYOLA,08266,082665,CERDANYOLA DEL VALLÈS,7,3,10
2023/2024,08056572,CFA TERRA BAIXA,08169,081691,EL PRAT DE LLOBREGAT,6,7,13
2023/2024,08056560,CFA BARBERÀ,08252,082520,BARBERÀ DEL VALLÈS,5,5,10
2023/2024,08056109,INSTITUT CAN VILUMARA,08101,081017,L'HOSPITALET DE LLOBREGAT,70,32,102
2023/2024,08055944,INSTITUT RUBIÓ I ORS,08101,081017,L'HOSPITALET DE LLOBREGAT,28,19,47
2023/2024,08055932,ESCOLA TORRENT DE CAN CARABASSA,08019,080193,BARCELONA,24,5,29
2023/2024,08055890,ESCOLA SOBIRANS,08007,080076,ARENYS DE MUNT,27,1,28
2023/2024,08055889,ESCOLA MIQUEL MARTÍ I POL,08187,081878,SABADELL,29,2,31
2023/2024,08055713,CFA SANT CUGAT DEL VALLÈS,08205,082055,SANT CUGAT DEL VALLÈS,5,3,8
2023/2024,08055695,CFA RAFAEL FARRÉ,08123,081234,MOLINS DE REI,3,4,7
2023/2024,08055683,CFA MANUEL SACRISTÁN,08019,080193,BARCELONA,6,6,12
2023/2024,08055440,CFA GARROSA,08263,082634,SANT VICENÇ DELS HORTS,8,3,11
2023/2024,08055439,CFA MESTRE ESTEVE,08211,082114,SANT FELIU DE LLOBREGAT,6,3,9
2023/2024,08055403,CFA SANT ROC,08015,080155,BADALONA,7,2,9
2023/2024,08055397,CFA JAUME TUSET,08180,081803,RIPOLLET,7,5,12
2023/2024,08055385,CFA MOLLET DEL VALLÈS,08124,081249,MOLLET DEL VALLÈS,7,3,10
2023/2024,08055105,ESCOLA ARRAONA,08187,081878,SABADELL,20,4,24
2023/2024,08055075,CFA TORRE ROMEU,08187,081878,SABADELL,5,1,6
2023/2024,08055063,CFA CANYELLES,08019,080193,BARCELONA,4,3,7
2023/2024,08055051,CFA CASTELLDEFELS,08056,080569,CASTELLDEFELS,7,2,9
2023/2024,08055041,CFA CANOVELLES,08041,080410,CANOVELLES,7,2,9
2023/2024,08055002,CFA BARRI GÒTIC,08019,080193,BARCELONA,8,0,8
2023/2024,08054903,ESCOLA MEDITERRÀNIA,08019,080193,BARCELONA,15,5,20
2023/2024,08054873,INSTITUT JOAQUIMA PLA I FARRERAS,08205,082055,SANT CUGAT DEL VALLÈS,45,16,61
2023/2024,08054824,ESCOLA MESTRE PLA,08051,080517,CASTELLAR DEL VALLÈS,13,2,15
2023/2024,08054411,ESCOLA VALLGORGUINA,08294,082943,VALLGORGUINA,14,1,15
2023/2024,08054401,INSTITUT EL SUI,08046,080462,CARDEDEU,44,16,60
2023/2024,08054368,CEE CA N'ORIOL,08184,081846,RUBÍ,24,4,28
2023/2024,08054344,EOI ESPLUGUES,08077,080771,ESPLUGUES DE LLOBREGAT,12,3,15
2023/2024,08054277,INSTITUT DE TONA,08283,082830,TONA,46,23,69
2023/2024,08054241,INSTITUT EUGENI XAMMAR,08005,080057,L'AMETLLA DEL VALLÈS,27,17,44
2023/2024,08054228,INSTITUT DOLORS ALEU,08019,080193,BARCELONA,26,18,44
2023/2024,08054198,INSTITUT ESTANY DE LA RICARDA,08169,081691,EL PRAT DE LLOBREGAT,27,20,47
2023/2024,08054186,INSTITUT CAN MAS,08180,081803,RIPOLLET,33,22,55
2023/2024,08054174,INSTITUT LA RIBERA,08125,081252,MONTCADA I REIXAC,27,15,42
2023/2024,08054113,ESCOLA ANXANETA,08121,081213,MATARÓ,29,4,33
2023/2024,08054061,ESCOLA MONTBAIG,08200,082009,SANT BOI DE LLOBREGAT,16,4,20
2023/2024,08054058,ESCOLA TORRE DE LA MIRANDA,08073,080734,CORNELLÀ DE LLOBREGAT,34,6,40
2023/2024,08054034,INSTITUT GALLECS,08124,081249,MOLLET DEL VALLÈS,81,49,130
2023/2024,08054022,ESCOLA MARINADA,08019,080193,BARCELONA,16,2,18
2023/2024,08053650,ESCOLA TURÓ DE GUIERA,08266,082665,CERDANYOLA DEL VALLÈS,24,7,31
2023/2024,08053601,ESCOLA LOLA ANGLADA,08114,081141,MARTORELL,30,2,32
2023/2024,08053583,ESCOLA MARIA OSSÓ,08270,082704,SITGES,30,3,33
2023/2024,08053571,INST-ESC ART. ORIOL MARTORELL,08019,080193,BARCELONA,98,52,150
2023/2024,08053522,ESCOLA LA GINESTA,08295,082956,VALLIRANA,16,1,17
2023/2024,08053510,ESCOLA PUIG D'AGULLES,08072,080728,CORBERA DE LLOBREGAT,18,3,21
2023/2024,08053492,ESCOLA TERESA CLARAMUNT,08187,081878,SABADELL,29,1,30
2023/2024,08053467,ESCOLA PALAU,08156,081568,PALAU-SOLITÀ I PLEGAMANS,27,4,31
2023/2024,08053455,ESCOLA LES AIGÜES,08046,080462,CARDEDEU,27,4,31
2023/2024,08053443,EOI SANTA COLOMA,08245,082457,SANTA COLOMA DE GRAMENET,8,5,13
2023/2024,08053431,ESCOLA EL ROURE,08168,081688,PONTONS,5,1,6
2023/2024,08053421,ESCOLA ALOC,08163,081635,PINEDA DE MAR,22,8,30
2023/2024,08053406,ESCOLA CAN BESORA,08124,081249,MOLLET DEL VALLÈS,25,3,28
2023/2024,08053391,ESCOLA LLEDONER,08096,080961,GRANOLLERS,19,11,30
2023/2024,08053364,INSTITUT JOSEP MESTRES I BUSQUETS,08301,083015,VILADECANS,39,19,58
2023/2024,08053352,INSTITUT MONTBUI,08250,082508,SANTA MARGARIDA DE MONTBUI,44,26,70
2023/2024,08053340,INSTITUT GABRIELA MISTRAL,08263,082634,SANT VICENÇ DELS HORTS,61,45,106
2023/2024,08053315,INSTITUT MONTSERRAT ROIG,08196,081960,SANT ANDREU DE LA BARCA,37,27,64
2023/2024,08053297,INSTITUT DE PALLEJÀ,08157,081574,PALLEJÀ,39,20,59
2023/2024,08053285,INSTITUT EL CASTELL,08076,080765,ESPARREGUERA,41,33,74
2023/2024,08053261,INSTITUT DE VILADECAVALLS,08300,083008,VILADECAVALLS,43,25,68
2023/2024,08053251,INSTITUT CAVALL BERNAT,08279,082798,TERRASSA,53,36,89
2023/2024,08053248,INSTITUT DE SENTMENAT,08267,082671,SENTMENAT,29,17,46
2023/2024,08053236,INSTITUT ROVIRA-FORNS,08260,082606,SANTA PERPÈTUA DE MOGODA,34,24,58
2023/2024,08053224,INSTITUT LES TERMES,08187,081878,SABADELL,28,21,49
2023/2024,08053212,INSTITUT JONQUERES,08187,081878,SABADELL,36,19,55
2023/2024,08053200,INSTITUT MIQUEL CRUSAFONT I PAIRÓ,08187,081878,SABADELL,29,16,45
2023/2024,08053194,EOI DE TERRASSA,08279,082798,TERRASSA,16,9,25
2023/2024,08053182,INSTITUT LA SERRETA,08184,081846,RUBÍ,75,25,100
2023/2024,08053170,INSTITUT POLINYÀ,08167,081672,POLINYÀ,33,27,60
2023/2024,08053169,INSTITUT MATADEPERA,08120,081206,MATADEPERA,45,22,67
2023/2024,08053157,INSTITUT GORGS,08266,082665,CERDANYOLA DEL VALLÈS,31,17,48
2023/2024,08053145,INSTITUT CASTELLBISBAL,08054,080543,CASTELLBISBAL,48,27,75
2023/2024,08053121,INSTITUT TARADELL,08278,082785,TARADELL,40,20,60
2023/2024,08053111,INSTITUT D'AURO,08192,081923,SANTPEDOR,36,14,50
2023/2024,08053108,INSTITUT REGUISSOL,08259,082592,SANTA MARIA DE PALAUTORDERA,26,18,44
2023/2024,08053091,INSTITUT EL FOIX,08251,082515,SANTA MARGARIDA I ELS MONJOS,48,22,70
2023/2024,08053078,INSTITUT NUMÀNCIA,08245,082457,SANTA COLOMA DE GRAMENET,43,17,60
2023/2024,08053054,INSTITUT GERBERT D'AURILLAC,08213,082135,SANT FRUITÓS DE BAGES,38,11,49
2023/2024,08053042,INSTITUT MIQUEL MARTÍ I POL,08183,081831,RODA DE TER,42,10,52
2023/2024,08053030,INSTITUT DE LA ROCA DEL VALLÈS,08181,081810,LA ROCA DEL VALLÈS,29,22,51
2023/2024,08053029,EOI BADALONA,08015,080155,BADALONA,8,3,11
2023/2024,08053017,INSTITUT VALERIÀ PUJOL I BOSCH,08230,082303,PREMIÀ DE DALT,22,17,39
2023/2024,08053005,INSTITUT CASTELL DE QUER,08171,081712,PRATS DE LLUÇANÈS,25,11,36
2023/2024,08052992,INSTITUT EUCLIDES,08163,081635,PINEDA DE MAR,34,21,55
2023/2024,08052980,INSTITUT MONTMELÓ,08135,081350,MONTMELÓ,37,21,58
2023/2024,08052979,INSTITUT JOSEP PUIG I CADAFALCH,08121,081213,MATARÓ,56,29,85
2023/2024,08052955,INSTITUT DE LLIÇÀ,08107,081075,LLIÇÀ D'AMUNT,53,37,90
2023/2024,08052931,EOI DEL MARESME,08121,081213,MATARÓ,11,3,14
2023/2024,08052921,INSTITUT EUGENI D'ORS,08101,081017,L'HOSPITALET DE LLOBREGAT,37,10,47
2023/2024,08052918,INSTITUT BISBE BERENGUER,08101,081017,L'HOSPITALET DE LLOBREGAT,32,20,52
2023/2024,08052906,INSTITUT LAURO,08086,080863,LES FRANQUESES DEL VALLÈS,57,22,79
2023/2024,08052891,INSTITUT L'ALT BERGUEDÀ,08016,080168,BAGÀ,24,15,39
2023/2024,08052888,INSTITUT JÚLIA MINGUELL,08015,080155,BADALONA,38,21,59
2023/2024,08052876,INSTITUT D'ARGENTONA,08009,080095,ARGENTONA,45,26,71
2023/2024,08052839,INSTITUT CONSELL DE CENT,08019,080193,BARCELONA,23,16,39
2023/2024,08052827,INSTITUT LLUÍS DOMÈNECH I MONTANER,08019,080193,BARCELONA,26,22,48
2023/2024,08052797,INSTITUT SALVADOR ESPRIU,08019,080193,BARCELONA,37,20,57
2023/2024,08052785,ESCOLA VILA OLÍMPICA,08019,080193,BARCELONA,29,3,32
2023/2024,08052724,INSTITUT FRANCISCO DE GOYA,08019,080193,BARCELONA,31,16,47
2023/2024,08052700,INSTITUT VALL D'HEBRON,08019,080193,BARCELONA,92,49,141
2023/2024,08052670,ESCOLA AURÓ,08019,080193,BARCELONA,30,3,33
2023/2024,08052669,ESCOLA FERRAN SUNYER,08019,080193,BARCELONA,28,6,34
2023/2024,08052657,ESCOLA FORT PIENC,08019,080193,BARCELONA,27,2,29
2023/2024,08052621,ESCOLA PAU ROMEVA,08019,080193,BARCELONA,29,2,31
2023/2024,08052608,INSTITUT PAU CLARIS,08019,080193,BARCELONA,22,13,35
2023/2024,08052581,INSTITUT MIQUEL TARRADELL,08019,080193,BARCELONA,56,11,67
2023/2024,08052207,INSTITUT DE PUIG-REIG,08175,081751,PUIG-REIG,22,14,36
2023/2024,08052165,ESCOLA OCTAVIO PAZ,08019,080193,BARCELONA,16,1,17
2023/2024,08051471,ESCOLA JOSEP MARIA FOLCH I TORRES,08101,081017,L'HOSPITALET DE LLOBREGAT,22,13,35
2023/2024,08051318,ESCOLA SANT LLORENÇ DEL MUNT,08279,082798,TERRASSA,29,3,32
2023/2024,08051306,ESCOLA ABAT MARCET,08279,082798,TERRASSA,27,3,30
2023/2024,08051264,INSTITUT EDUARD FONTSERÈ,08101,081017,L'HOSPITALET DE LLOBREGAT,27,20,47
2023/2024,08051240,ESCOLA MEDITERRÀNIA,08073,080734,CORNELLÀ DE LLOBREGAT,32,1,33
2023/2024,08047832,INSTITUT JOAN COROMINES,08163,081635,PINEDA DE MAR,72,32,104
2023/2024,08047820,INSTITUT GUINOVARDA,08161,081614,PIERA,48,25,73
2023/2024,08047583,INSTITUT SANT QUIRZE DEL VALLÈS,08238,082384,SANT QUIRZE DEL VALLÈS,49,20,69
2023/2024,08047509,INSTITUT ÍTACA,08200,082009,SANT BOI DE LLOBREGAT,32,21,53
2023/2024,08047492,INSTITUT RIBERA BAIXA,08169,081691,EL PRAT DE LLOBREGAT,37,22,59
2023/2024,08047480,INSTITUT MEDITERRÀNIA,08056,080569,CASTELLDEFELS,65,39,104
2023/2024,08047479,INSTITUT ALBA DEL VALLÈS,08209,082093,SANT FOST DE CAMPSENTELLES,44,25,69
2023/2024,08047467,INSTITUT ALEXANDRE GALÍ,08231,082310,SANT PERE DE RIBES,51,21,72
2023/2024,08047431,INSTITUT XXV OLIMPÍADA,08019,080193,BARCELONA,34,24,58
2023/2024,08047421,INSTITUT MONTSERRAT ROIG,08019,080193,BARCELONA,34,12,46
2023/2024,08047376,INSTITUT LLOBREGAT,08191,081918,SALLENT,30,17,47
2023/2024,08047364,INSTITUT JOAN MERCADER,08102,081022,IGUALADA,46,27,73
2023/2024,08046876,INSTITUT MIQUEL BOSCH I JOVER,08010,080109,ARTÉS,29,10,39
2023/2024,08046864,INSTITUT BELLULLA,08041,080410,CANOVELLES,43,20,63
2023/2024,08046852,INSTITUT LLAVANERES,08197,081976,SANT ANDREU DE LLAVANERES,38,20,58
2023/2024,08046840,INSTITUT CASTELLET,08262,082628,SANT VICENÇ DE CASTELLET,52,44,96
2023/2024,08046803,INSTITUT VILATZARA,08219,082191,VILASSAR DE MAR,38,31,69
2023/2024,08046797,INSTITUT LAIA L'ARQUERA,08121,081213,MATARÓ,38,26,64
2023/2024,08046785,INSTITUT D'ALELLA,08003,080039,ALELLA,37,18,55
2023/2024,08046761,INSTITUT GUILLEM CATÀ,08113,081136,MANRESA,98,46,144
2023/2024,08046751,INSTITUT VENTURA GASSOL,08015,080155,BADALONA,34,14,48
2023/2024,08046748,INSTITUT THOS I CODINA,08121,081213,MATARÓ,68,52,120
2023/2024,08046736,INSTITUT MILÀ I FONTANALS,08305,083054,VILAFRANCA DEL PENEDÈS,46,28,74
2023/2024,08046724,INSTITUT MONTSERRAT ROIG,08279,082798,TERRASSA,76,39,115
2023/2024,08046694,INSTITUT CENTRE D'ALT RENDIMENT ESPORTIU,08205,082055,SANT CUGAT DEL VALLÈS,24,33,57
2023/2024,08046682,INSTITUT DE CASTELLAR,08051,080517,CASTELLAR DEL VALLÈS,41,28,69
2023/2024,08046670,INSTITUT ANGELETA FERRER I SENSAT,08205,082055,SANT CUGAT DEL VALLÈS,48,24,72
2023/2024,08046669,INSTITUT RIBOT I SERRA,08187,081878,SABADELL,50,13,63
2023/2024,08046657,INSTITUT JOAQUIM BLUME,08077,080771,ESPLUGUES DE LLOBREGAT,15,14,29
2023/2024,08046645,INSTITUT MOLÍ DE LA VILA,08044,080446,CAPELLADES,33,18,51
2023/2024,08046608,INSTITUT PRÍNCEP DE VIANA,08019,080193,BARCELONA,31,18,49
2023/2024,08046581,INSTITUT LLUÍS VIVES,08019,080193,BARCELONA,31,11,42
2023/2024,08046293,ESCOLA CAVALL BERNAT,08019,080193,BARCELONA,14,4,18
2023/2024,08046281,ESCOLA ESTEL-GUINARDÓ,08019,080193,BARCELONA,15,3,18
2023/2024,08045860,INSTITUT MIRAMAR,08301,083015,VILADECANS,36,23,59
2023/2024,08045859,INSTITUT DE CORBERA DE LLOBREGAT,08072,080728,CORBERA DE LLOBREGAT,36,24,60
2023/2024,08045689,INSTITUT VOLTRERA,08001,080018,ABRERA,43,29,72
2023/2024,08045677,INSTITUT THALASSA,08126,081265,MONTGAT,31,18,49
2023/2024,08045665,INSTITUT RAMON TURRÓ I DARDER,08110,081108,MALGRAT DE MAR,42,27,69
2023/2024,08045653,INSTITUT DOLORS MALLAFRÈ I ROS,08307,083073,VILANOVA I LA GELTRÚ,37,22,59
2023/2024,08045641,INSTITUT LLUÍS DOMÈNECH I MONTANER,08040,080403,CANET DE MAR,54,23,77
2023/2024,08045628,INSTITUT CELESTÍ BELLERA,08096,080961,GRANOLLERS,44,17,61
2023/2024,08045604,INSTITUT ENRIC BORRÀS,08015,080155,BADALONA,56,30,86
2023/2024,08045598,ESCOLA MIL·LENARI,08046,080462,CARDEDEU,29,1,30
2023/2024,08045586,ESCOLA LES PRUNERES,08115,081154,MARTORELLES,15,0,15
2023/2024,08045574,ESCOLA SERRA DE MARINA,08245,082457,SANTA COLOMA DE GRAMENET,21,11,32
2023/2024,08045562,INSTITUT CAN PLANAS,08252,082520,BARBERÀ DEL VALLÈS,32,33,65
2023/2024,08045549,INSTITUT BANÚS,08266,082665,CERDANYOLA DEL VALLÈS,41,18,59
2023/2024,08045537,INSTITUT JOSEP LLUÍS SERT,08056,080569,CASTELLDEFELS,42,25,67
2023/2024,08045525,INSTITUT MANUEL CARRASCO I FORMIGUERA,08019,080193,BARCELONA,22,14,36
2023/2024,08045513,INSTITUT FLOS I CALCAT,08019,080193,BARCELONA,33,19,52
2023/2024,08045483,INSTITUT VILA DE GRÀCIA,08019,080193,BARCELONA,26,12,38
2023/2024,08045471,INSTITUT POMPEU FABRA,08015,080155,BADALONA,48,60,108
2023/2024,08045306,INSTITUT RAMON CASAS I CARBÓ,08156,081568,PALAU-SOLITÀ I PLEGAMANS,46,26,72
2023/2024,08045227,CEE LES AIGÜES,08121,081213,MATARÓ,44,3,47
2023/2024,08045203,INSTITUT OBERT DE CATALUNYA,08019,080193,BARCELONA,78,69,147
2023/2024,08045070,INSTITUT EUROPA,08101,081017,L'HOSPITALET DE LLOBREGAT,24,11,35
2023/2024,08045057,ESCOLA EL SAGRER,08019,080193,BARCELONA,29,4,33
2023/2024,08045045,ESCOLA MEDITERRÀNIA,08163,081635,PINEDA DE MAR,15,5,20
2023/2024,08045033,ESCOLA MONTPALAU,08163,081635,PINEDA DE MAR,14,6,20
2023/2024,08045021,INSTITUT ESTELA IBÈRICA,08260,082606,SANTA PERPÈTUA DE MOGODA,47,30,77
2023/2024,08045011,INSTITUT TORRE DEL PALAU,08279,082798,TERRASSA,51,21,72
2023/2024,08044995,INSTITUT BARRES I ONES,08015,080155,BADALONA,39,22,61
2023/2024,08044983,INSTITUT LLUÍS COMPANYS,08284,082845,TORDERA,32,29,61
2023/2024,08044971,INSTITUT PERE FONTDEVILA,08092,080924,GIRONELLA,32,12,44
2023/2024,08044961,ESCRBC DE CATALUNYA,08019,080193,BARCELONA,17,8,25
2023/2024,08044958,INSTITUT JOSEP PLA,08019,080193,BARCELONA,33,13,46
2023/2024,08044934,INSTITUT ESCOLA D'HOTELERIA I TURISME DE BARCELONA,08019,080193,BARCELONA,49,37,86
2023/2024,08044922,INSTITUT DR. PUIGVERT,08019,080193,BARCELONA,42,22,64
2023/2024,08044910,ESCOLA EL TURONET,08238,082384,SANT QUIRZE DEL VALLÈS,17,0,17
2023/2024,08044715,INSTITUT JAUME MIMÓ,08266,082665,CERDANYOLA DEL VALLÈS,52,45,97
2023/2024,08044648,ESCOLA LA RODA,08279,082798,TERRASSA,28,3,31
2023/2024,08044636,EOI DE SABADELL,08187,081878,SABADELL,18,6,24
2023/2024,08044624,INSTITUT SABADELL,08187,081878,SABADELL,51,52,103
2023/2024,08044612,INSTITUT TORRE DE MALLA,08159,081593,PARETS DEL VALLÈS,43,40,83
2023/2024,08044600,INSTITUT MOIANÈS,08138,081385,MOIÀ,26,23,49
2023/2024,08044594,INSTITUT GIOLA,08106,081069,LLINARS DEL VALLÈS,38,23,61
2023/2024,08044582,EOI DE L'HOSPITALET DE LLOBREGAT,08101,081017,L'HOSPITALET DE LLOBREGAT,20,8,28
2023/2024,08044570,INSTITUT VALL D'ARÚS,08295,082956,VALLIRANA,45,29,74
2023/2024,08044569,INSTITUT PERE BARNILS,08067,080673,CENTELLES,40,24,64
2023/2024,08044545,ESCOLA COLLBAIX,08218,082188,SANT JOAN DE VILATORRADA,12,4,16
2023/2024,08044533,INSTITUT LA FERRERIA,08125,081252,MONTCADA I REIXAC,74,53,127
2023/2024,08044521,ESCOLA ELS PINETONS,08088,080885,LA GARRIGA,27,3,30
2023/2024,08044511,EOI BARCELONA-VALL D'HEBRON,08019,080193,BARCELONA,37,3,40
2023/2024,08044508,ESCOLA ÍTACA,08015,080155,BADALONA,20,2,22
2023/2024,08044454,ESCOLA PILARÍN BAYÉS,08238,082384,SANT QUIRZE DEL VALLÈS,26,3,29
2023/2024,08044430,ESCOLA LA GARALDA,08157,081574,PALLEJÀ,31,3,34
2023/2024,08044314,ESCOLA ANDREU CASTELLS,08187,081878,SABADELL,27,5,32
2023/2024,08044302,ESCOLA JOAN ABELLÓ,08124,081249,MOLLET DEL VALLÈS,28,4,32
2023/2024,08044296,ESCOLA SALVADOR ESPRIU,08015,080155,BADALONA,25,4,29
2023/2024,08044247,ESCOLA ESTEL,08123,081234,MOLINS DE REI,15,1,16
2023/2024,08044223,CEE L'ESTEL- CAN BORI,08101,081017,L'HOSPITALET DE LLOBREGAT,31,5,36
2023/2024,08044201,ESCOLA DOVELLA,08019,080193,BARCELONA,16,0,16
2023/2024,08044168,INSTITUT PLA DE LES MORERES,08302,083020,VILANOVA DEL CAMÍ,50,25,75
2023/2024,08044156,EA DEIÀ,08019,080193,BARCELONA,31,21,52
2023/2024,08044120,CFA FREIRE,08019,080193,BARCELONA,6,4,10
2023/2024,08044077,EA JOSEP SERRA I ABELLA,08101,081017,L'HOSPITALET DE LLOBREGAT,29,22,51
2023/2024,08044053,INSTITUT SALVADOR SEGUÍ,08019,080193,BARCELONA,109,29,138
2023/2024,08044028,CEE HORITZÓ,08163,081635,PINEDA DE MAR,26,4,30
2023/2024,08044016,ESCOLA FLAMA,08213,082135,SANT FRUITÓS DE BAGES,27,3,30
2023/2024,08043981,INSTITUT JOAN RAMON BENAPRÈS,08270,082704,SITGES,53,36,89
2023/2024,08043978,INSTITUT DANIEL BLANXART I PEDRALS,08147,081477,OLESA DE MONTSERRAT,67,49,116
2023/2024,08043966,ESCOLA HEURA,08019,080193,BARCELONA,15,1,16
2023/2024,08043954,ESCOLA RIBATALLADA,08187,081878,SABADELL,17,4,21
2023/2024,08043942,ESCOLA MONTBUI,08033,080333,CALDES DE MONTBUI,24,3,27
2023/2024,08043930,ESCOLA MARINADA,08118,081189,EL MASNOU,13,3,16
2023/2024,08043929,ESCOLA LLEBETX,08307,083073,VILANOVA I LA GELTRÚ,18,5,23
2023/2024,08043917,ESCOLA COSSETÀNIA,08307,083073,VILANOVA I LA GELTRÚ,14,2,16
2023/2024,08043905,ESCOLA EL DOFÍ,08172,081727,PREMIÀ DE MAR,15,1,16
2023/2024,08043899,ESCOLA TÀBER,08019,080193,BARCELONA,30,2,32
2023/2024,08043887,ESCOLA SAGRADA FAMÍLIA,08019,080193,BARCELONA,33,4,37
2023/2024,08043875,ESCOLA PIT-ROIG,08019,080193,BARCELONA,13,3,16
2023/2024,08043863,ESCOLA ORLANDAI,08019,080193,BARCELONA,15,1,16
2023/2024,08043851,ESCOLA NABÍ,08019,080193,BARCELONA,13,3,16
2023/2024,08043841,ESCOLA LAVÍNIA,08019,080193,BARCELONA,14,2,16
2023/2024,08043838,ESCOLA TURÓ DEL CARGOL,08019,080193,BARCELONA,15,3,18
2023/2024,08043814,ESCOLA CARLIT,08019,080193,BARCELONA,15,2,17
2023/2024,08043796,ESCOLA BARRUFET,08019,080193,BARCELONA,27,4,31
2023/2024,08043784,ESCOLA ÀNGELS GARRIGA,08019,080193,BARCELONA,12,4,16
2023/2024,08043760,ESCOLA COLÒNIA GÜELL,08244,082444,SANTA COLOMA DE CERVELLÓ,26,3,29
2023/2024,08043747,ESCOLA BALOO,08019,080193,BARCELONA,13,4,17
2023/2024,08043693,INSTITUT JOAQUIM MIR,08307,083073,VILANOVA I LA GELTRÚ,68,48,116
2023/2024,08043681,INSTITUT MARIANAO,08200,082009,SANT BOI DE LLOBREGAT,53,46,99
2023/2024,08043671,INSTITUT EL PALAU,08196,081960,SANT ANDREU DE LA BARCA,60,51,111
2023/2024,08043668,INSTITUT L'ESTATUT,08184,081846,RUBÍ,41,46,87
2023/2024,08043656,INSTITUT MARINA,08105,081056,LA LLAGOSTA,48,47,95
2023/2024,08043644,INSTITUT CARLES VALLBONA,08096,080961,GRANOLLERS,67,61,128
2023/2024,08043589,INSTITUT SALVADOR DALÍ,08169,081691,EL PRAT DE LLOBREGAT,43,22,65
2023/2024,08043516,INSTITUT SANTA EULÀLIA,08279,082798,TERRASSA,54,74,128
2023/2024,08043504,INSTITUT PERE CALDERS,08266,082665,CERDANYOLA DEL VALLÈS,23,17,40
2023/2024,08043486,INSTITUT MANOLO HUGUÉ,08033,080333,CALDES DE MONTBUI,50,30,80
2023/2024,08043474,ESCOLA L'ESTEL,08019,080193,BARCELONA,17,3,20
2023/2024,08043462,INSTITUT ERNEST LLUCH,08019,080193,BARCELONA,43,26,69
2023/2024,08043437,ESCOLA FONT DE L'ALBA,08279,082798,TERRASSA,16,5,21
2023/2024,08043401,ESCOLA BARRUFET,08200,082009,SANT BOI DE LLOBREGAT,14,7,21
2023/2024,08043395,INSTITUT ALEXANDRE DE RIQUER,08031,080312,CALAF,21,11,32
2023/2024,08043383,ESCOLA NOSTRA LLAR,08187,081878,SABADELL,26,5,31
2023/2024,08043371,ESCOLA LA LIÓ,08172,081727,PREMIÀ DE MAR,13,3,16
2023/2024,08043361,ESCOLA EL TURÓ,08125,081252,MONTCADA I REIXAC,15,2,17
2023/2024,08043346,ESCOLA MONTSERRAT,08076,080765,ESPARREGUERA,16,1,17
2023/2024,08043334,ESCOLA ALEXANDRE GALÍ,08073,080734,CORNELLÀ DE LLOBREGAT,17,1,18
2023/2024,08043310,ESCOLA EDUMAR,08056,080569,CASTELLDEFELS,28,3,31
2023/2024,08043292,ESCOLA TABOR,08019,080193,BARCELONA,27,4,31
2023/2024,08043279,ESCOLA POMPEU FABRA,08019,080193,BARCELONA,12,4,16
2023/2024,08043267,ESCOLA PAU CASALS-GRÀCIA,08019,080193,BARCELONA,26,3,29
2023/2024,08043255,ESCOLA ÍTACA,08019,080193,BARCELONA,25,5,30
2023/2024,08043115,ESCOLA PROVENÇALS,08019,080193,BARCELONA,26,5,31
2023/2024,08043103,ESCOLA ANTONI BALMANYA,08019,080193,BARCELONA,27,3,30
2023/2024,08042895,ESCOLA SCHOLA,08184,081846,RUBÍ,16,0,16
2023/2024,08042883,ESCOLA SANT JOSEP - EL PI,08101,081017,L'HOSPITALET DE LLOBREGAT,14,3,17
2023/2024,08042871,ESCOLA PATUFET SANT JORDI-FRANCESC BATALLÉ I ARA,08101,081017,L'HOSPITALET DE LLOBREGAT,30,3,33
2023/2024,08042861,ESCOLA LOLA ANGLADA,08077,080771,ESPLUGUES DE LLOBREGAT,15,1,16
2023/2024,08042858,CFA ELS TARONGERS,08121,081213,MATARÓ,9,2,11
2023/2024,08042846,CFA CORNELLÀ DE LLOBREGAT,08073,080734,CORNELLÀ DE LLOBREGAT,10,5,15
2023/2024,08042834,ESCOLA CAN PALMER,08301,083015,VILADECANS,21,2,23
2023/2024,08042810,ESCOLA CHARLES DARWIN,08169,081691,EL PRAT DE LLOBREGAT,29,3,32
2023/2024,08042809,ESCOLA GALILEO GALILEI,08169,081691,EL PRAT DE LLOBREGAT,27,2,29
2023/2024,08042792,ESCOLA DAMIÀ MATEU,08106,081069,LLINARS DEL VALLÈS,17,1,18
2023/2024,08042780,ESCOLA JOSEP MARIA JUJOL,08019,080193,BARCELONA,25,6,31
2023/2024,08042342,INSTITUT DE BADIA DEL VALLÈS,08904,089045,BADIA DEL VALLÈS,31,44,75
2023/2024,08042330,INSTITUT SANT RAMON,08047,080478,CARDONA,11,10,21
2023/2024,08042329,ESCOLA ELS XIPRERS,08019,080193,BARCELONA,11,5,16
2023/2024,08042305,ESCOLA JOAN MIRÓ,08019,080193,BARCELONA,28,2,30
2023/2024,08042299,ESCOLA SANT MIQUEL,08073,080734,CORNELLÀ DE LLOBREGAT,28,3,31
2023/2024,08042287,ESCOLA SALVADOR ESPRIU,08096,080961,GRANOLLERS,28,4,32
2023/2024,08042101,INSTITUT MANUEL VÁZQUEZ MONTALBÁN,08194,081944,SANT ADRIÀ DE BESÒS,40,23,63
2023/2024,08042093,INSTITUT VINYES VELLES,08136,081363,MONTORNÈS DEL VALLÈS,38,21,59
2023/2024,08042056,INSTITUT CAN PUIG,08231,082310,SANT PERE DE RIBES,37,31,68
2023/2024,08042044,INSTITUT MIG-MÓN,08274,082747,SÚRIA,33,16,49
2023/2024,08042020,INSTITUT VALLÈS,08187,081878,SABADELL,47,20,67
2023/2024,08042019,INSTITUT BADALONA VII,08015,080155,BADALONA,42,36,78
2023/2024,43009114,ZER EL FRANCOLÍ,43161,431613,VALLS,4,0,4
2023/2024,08041866,INSTITUT EL CALAMOT,08089,080898,GAVÀ,73,50,123
2023/2024,08041751,ESCOLA LA CAIXA,08019,080193,BARCELONA,18,1,19
2023/2024,08041726,ESCOLA ROC BLANC,08300,083008,VILADECAVALLS,19,1,20
2023/2024,08041714,ESCOLA LES BASSEROLES,08269,082690,SEVA,14,1,15
2023/2024,08041696,ESCOLA VAIXELL BURRIAC,08219,082191,VILASSAR DE MAR,24,6,30
2023/2024,08041684,ESCOLA ESPAI 3,08217,082172,SANT JOAN DESPÍ,29,1,30
2023/2024,08041672,ESCOLA CREU ALTA,08187,081878,SABADELL,15,3,18
2023/2024,08041660,ESCOLA PONT DE LA CADENA,08123,081234,MOLINS DE REI,17,0,17
2023/2024,08041659,ESCOLA MESTRES MONTAÑA,08096,080961,GRANOLLERS,28,3,31
2023/2024,08041647,ESCOLA PONENT,08096,080961,GRANOLLERS,30,8,38
2023/2024,08041611,ESCOLA JOANOT ALISANDA,08187,081878,SABADELL,30,2,32
2023/2024,08041601,ESCOLA TORRE DE LA LLEBRE,08184,081846,RUBÍ,14,5,19
2023/2024,08041581,ESCOLA GITANJALI,08015,080155,BADALONA,15,1,16
2023/2024,08041571,ESCOLA ARTUR MARTORELL,08015,080155,BADALONA,18,1,19
2023/2024,08041568,ESCOLA JUNGFRAU,08015,080155,BADALONA,26,6,32
2023/2024,08041556,ESCOLA MONTSENY,08221,082212,SANT JUST DESVERN,20,2,22
2023/2024,08041519,INSTITUT MARTÍ DOT,08211,082114,SANT FELIU DE LLOBREGAT,50,49,99
2023/2024,08041374,INSTITUT LA MALLOLA,08077,080771,ESPLUGUES DE LLOBREGAT,38,18,56
2023/2024,08041246,ESCOLA FRANCESC ALDEA I PÉREZ,08279,082798,TERRASSA,14,3,17
2023/2024,08041234,ESCOLA COLLSEROLA,08205,082055,SANT CUGAT DEL VALLÈS,26,4,30
2023/2024,08041222,ESCOLA CAN CLADELLAS,08156,081568,PALAU-SOLITÀ I PLEGAMANS,29,1,30
2023/2024,08041210,ESCOLA DEL BOSC,08252,082520,BARBERÀ DEL VALLÈS,24,4,28
2023/2024,08041180,ESCOLA ROSSELLÓ PÒRCEL,08245,082457,SANTA COLOMA DE GRAMENET,14,4,18
2023/2024,08041179,ESCOLA MESTRE ENRIC GIBERT I CAMINS,08019,080193,BARCELONA,26,7,33
2023/2024,08041167,ESCOLA JOSEP CARNER,08015,080155,BADALONA,36,5,41
2023/2024,08041131,ESCOLA SANT ANTONI,08263,082634,SANT VICENÇ DELS HORTS,13,4,17
2023/2024,08040849,INSTITUT FORT PIUS,08019,080193,BARCELONA,27,15,42
2023/2024,08040618,ESCOLA CAN VIDALET,08077,080771,ESPLUGUES DE LLOBREGAT,13,4,17
2023/2024,08040564,INSTITUT JAUME ALMERA,08214,082140,VILASSAR DE DALT,29,18,47
2023/2024,08040552,INSTITUT ANTONI POUS I ARGILA,08112,081120,MANLLEU,70,29,99
2023/2024,08040540,INSTITUT EL CAIRAT,08076,080765,ESPARREGUERA,48,15,63
2023/2024,08040539,INSTITUT LES MARINES,08056,080569,CASTELLDEFELS,45,14,59
2023/2024,08040527,INSTITUT LA LLAUNA,08015,080155,BADALONA,38,26,64
2023/2024,08040412,ESCOLA EL MARGALLÓ,08307,083073,VILANOVA I LA GELTRÚ,24,2,26
2023/2024,08040400,ESCOLA AMADEU VIVES,08187,081878,SABADELL,24,8,32
2023/2024,08040382,ESCOLA MERCÈ RODOREDA,08245,082457,SANTA COLOMA DE GRAMENET,35,3,38
2023/2024,08040357,CEE FOLCH I CAMARASA,08019,080193,BARCELONA,11,0,11
2023/2024,08040345,ESCOLA MERCÈ RODOREDA,08015,080155,BADALONA,15,1,16
2023/2024,08040333,ESCOLA BERNAT METGE,08169,081691,EL PRAT DE LLOBREGAT,15,2,17
2023/2024,08040141,INSTITUT ICÀRIA,08019,080193,BARCELONA,38,26,64
2023/2024,08040138,INSTITUT LA SEDETA,08019,080193,BARCELONA,23,12,35
2023/2024,08040060,ESCOLA DEL MAR,08219,082191,VILASSAR DE MAR,26,3,29
2023/2024,08040059,ESCOLA JOAN SALVAT I PAPASSEIT,08245,082457,SANTA COLOMA DE GRAMENET,30,3,33
2023/2024,08040047,CEE JOSEP SOL I RODRÍGUEZ,08245,082457,SANTA COLOMA DE GRAMENET,34,6,40
2023/2024,08039896,ESCOLA BELLATERRA,08266,082665,CERDANYOLA DEL VALLÈS,29,4,33
2023/2024,08039835,ESCOLA DE LES AIGÜES,08019,080193,BARCELONA,29,4,33
2023/2024,08039744,ESCOLA DEL PONT TRENCAT - ZER BAIX MONTSENY,08259,082592,SANTA MARIA DE PALAUTORDERA,5,0,5
2023/2024,08039719,ESCOLA LES PLANES,08105,081056,LA LLAGOSTA,22,4,26
2023/2024,08039707,ESCOLA TAGAMANENT,08088,080885,LA GARRIGA,12,4,16
2023/2024,08039690,ESCOLA GERMANS CORBELLA,08046,080462,CARDEDEU,24,5,29
2023/2024,08039677,ESCOLA CONGOST,08041,080410,CANOVELLES,32,5,37
2023/2024,08039665,ESCOLA LANASPA-GIRALT,08279,082798,TERRASSA,16,1,17
2023/2024,08039653,ESCOLA AGUSTÍ BARTRA,08279,082798,TERRASSA,31,3,34
2023/2024,08039641,ESCOLA PABLO PICASSO,08252,082520,BARBERÀ DEL VALLÈS,19,2,21
2023/2024,08039631,ESCOLA L'AGULLOLA,08901,089019,RUPIT I PRUIT,3,0,3
2023/2024,08039628,ESCOLA POMPEU FABRA,08112,081120,MANLLEU,32,5,37
2023/2024,08039616,ESCOLA CAMÍ DEL CROS,08121,081213,MATARÓ,28,3,31
2023/2024,08039604,ESCOLA FRANCESC FERRER I GUÀRDIA,08118,081189,EL MASNOU,14,3,17
2023/2024,08039598,ESCOLA SANT MIQUEL DEL CROS,08009,080095,ARGENTONA,9,1,10
2023/2024,08039586,ESCOLA L'ARJAU,08307,083073,VILANOVA I LA GELTRÚ,24,5,29
2023/2024,08039574,ESCOLA PAU SANS,08101,081017,L'HOSPITALET DE LLOBREGAT,15,1,16
2023/2024,08039562,ESCOLA PRAT DE LA MANTA,08101,081017,L'HOSPITALET DE LLOBREGAT,15,3,18
2023/2024,08039537,ESCOLA TORRENT D'EN MELIS,08019,080193,BARCELONA,22,6,28
2023/2024,08039525,ESCOLA LA SEDETA,08019,080193,BARCELONA,14,2,16
2023/2024,08039495,ESCOLA LA PALMERA,08019,080193,BARCELONA,26,6,32
2023/2024,08039483,ESCOLA ELS HORTS,08019,080193,BARCELONA,17,0,17
2023/2024,08039471,ESCOLA MERCÈ RODOREDA,08019,080193,BARCELONA,27,4,31
2023/2024,08039434,ESCOLA DOCTOR FERRAN I CLUA,08019,080193,BARCELONA,28,4,32
2023/2024,08039380,ESCOLA GERMANS AMAT I TARGA,08301,083015,VILADECANS,25,3,28
2023/2024,08039379,ESCOLA RAFAEL CASANOVA,08200,082009,SANT BOI DE LLOBREGAT,21,4,25
2023/2024,08039367,ESCOLA JOSEP PLA,08196,081960,SANT ANDREU DE LA BARCA,27,4,31
2023/2024,08039355,ESCOLA RAMON LLULL,08169,081691,EL PRAT DE LLOBREGAT,27,3,30
2023/2024,08039343,ESCOLA JOSEP FERRÀ I ESTEVA,08147,081477,OLESA DE MONTSERRAT,27,5,32
2023/2024,08039318,ESCOLA PUIGBERENGUER,08113,081136,MANRESA,31,2,33
2023/2024,08039306,ESCOLA ELS PINS - ZER EL MOIANÈS PONENT,08191,081918,SALLENT,4,1,5
2023/2024,08039291,ESCOLA CRISTÒFOR MESTRE,08305,083054,VILAFRANCA DEL PENEDÈS,29,5,34
2023/2024,08039288,ESCOLA RENAIXENÇA,08122,081228,MEDIONA,9,1,10
2023/2024,08039264,ESCOLA MESTRES MUNGUET-CORTÉS,08902,089024,VILANOVA DEL VALLÈS,24,1,25
2023/2024,08039203,INSTITUT AGUSTÍ SERRA I FONTANET,08187,081878,SABADELL,79,74,153
2023/2024,08039069,INSTITUT MARGARIDA XIRGU,08101,081017,L'HOSPITALET DE LLOBREGAT,37,22,59
2023/2024,08039057,INSTITUT L'ALZINA,08019,080193,BARCELONA,36,16,52
2023/2024,08038582,ESCOLA CATALUNYA,08187,081878,SABADELL,35,1,36
2023/2024,08038570,EOI DE BARCELONA,08019,080193,BARCELONA,76,25,101
2023/2024,08038351,ESCOLA XARAU,08266,082665,CERDANYOLA DEL VALLÈS,16,2,18
2023/2024,08038326,ESCOLA EL VALLÈS,08279,082798,TERRASSA,18,2,20
2023/2024,08038314,ESCOLA MARE DE DÉU DE MONTSERRAT,08279,082798,TERRASSA,17,3,20
2023/2024,08038284,ESCOLA LA GUÀRDIA,08263,082634,SANT VICENÇ DELS HORTS,14,4,18
2023/2024,08038272,ESCOLA GARCÍA LORCA,08250,082508,SANTA MARGARIDA DE MONTBUI,27,6,33
2023/2024,08038260,ESCOLA JOAN MARAGALL,08205,082055,SANT CUGAT DEL VALLÈS,29,4,33
2023/2024,08038259,ESCOLA ANTONI TÀPIES,08200,082009,SANT BOI DE LLOBREGAT,26,3,29
2023/2024,08038247,ESCOLA POMPEU FABRA,08302,083020,VILANOVA DEL CAMÍ,24,5,29
2023/2024,08038223,ESCOLA BENVIURE,08200,082009,SANT BOI DE LLOBREGAT,22,8,30
2023/2024,08038211,ESCOLA JOSÉ JUAN ORTIZ,08196,081960,SANT ANDREU DE LA BARCA,23,3,26
2023/2024,08038201,ESCOLA LA BAUMETA - ZER ELS CASTELLS,08253,082536,SANTA MARIA DE BESORA,2,0,2
2023/2024,08038181,ESCOLA SERRA I HÚNTER,08113,081136,MANRESA,29,6,35
2023/2024,08038171,ESCOLA MONTESSORI,08184,081846,RUBÍ,27,4,31
2023/2024,08038168,ESCOLA LA TORRETA,08181,081810,LA ROCA DEL VALLÈS,16,2,18
2023/2024,08038156,ESCOLA ESCURSELL I BARTALOT,08180,081803,RIPOLLET,27,2,29
2023/2024,08038090,ESCOLA SANT JAUME,08169,081691,EL PRAT DE LLOBREGAT,26,8,34
2023/2024,08038089,ESCOLA SANT ESTEVE - ZER EL CARDENER,08229,082299,SANT MATEU DE BAGES,5,1,6
2023/2024,08038077,ESCOLA CAN PARERA,08136,081363,MONTORNÈS DEL VALLÈS,20,3,23
2023/2024,08038065,ESCOLA MONTSENY,08124,081249,MOLLET DEL VALLÈS,27,2,29
2023/2024,08038041,ESCOLA FEDERICO GARCÍA LORCA,08124,081249,MOLLET DEL VALLÈS,7,3,10
2023/2024,08038031,ESCOLA ROSA SENSAT,08118,081189,EL MASNOU,15,2,17
2023/2024,08038004,ESCOLA JOSEP JANÉS,08101,081017,L'HOSPITALET DE LLOBREGAT,24,8,32
2023/2024,08037991,ESCOLA MARCEL·LÍ MORAGAS,08089,080898,GAVÀ,25,3,28
2023/2024,08037981,ESCOLA DE L'ESTANY - ZER EL MOIANÈS LLEVANT,08079,080790,L'ESTANY,3,2,5
2023/2024,08037978,ESCOLA SURIS,08073,080734,CORNELLÀ DE LLOBREGAT,24,4,28
2023/2024,08037966,ESCOLA IGNASI IGLÉSIAS,08073,080734,CORNELLÀ DE LLOBREGAT,28,4,32
2023/2024,08037930,ESCOLA MARGALLÓ,08056,080569,CASTELLDEFELS,20,3,23
2023/2024,08037929,ESCOLA TORRE BARONA,08056,080569,CASTELLDEFELS,21,6,27
2023/2024,08037917,ESCOLA JOAN MIRÓ,08041,080410,CANOVELLES,18,6,24
2023/2024,08037899,ESCOLA FOLCH I TORRES,08015,080155,BADALONA,17,4,21
2023/2024,08037887,ESCOLA BALDIRI REIXAC,08015,080155,BADALONA,24,6,30
2023/2024,08037875,ESCOLA RAFAEL CASANOVA,08015,080155,BADALONA,30,4,34
2023/2024,08037863,ESCOLA SEAT,08019,080193,BARCELONA,29,3,32
2023/2024,08037841,ESCOLA SPLAI,08019,080193,BARCELONA,15,2,17
2023/2024,08037814,ESCOLA ALEXANDRE GALÍ,08019,080193,BARCELONA,36,4,40
2023/2024,08037528,ESCOLA SANT DOMÈNEC,08251,082515,SANTA MARGARIDA I ELS MONJOS,14,2,16
2023/2024,08037504,ESCOLA MONTNEGRE,08202,082021,SANT CELONI,14,1,15
2023/2024,08037292,CEE CENTRE DE FORMACIÓ I TREBALL FLOR DE MAIG,08266,082665,CERDANYOLA DEL VALLÈS,17,10,27
2023/2024,08037206,INSTITUT LLUÍS COMPANYS,08180,081803,RIPOLLET,35,33,68
2023/2024,08037176,INSTITUT LA BASTIDA,08245,082457,SANTA COLOMA DE GRAMENET,67,30,97
2023/2024,08037152,INSTITUT JOAN ORÓ,08114,081141,MARTORELL,89,51,140
2023/2024,08036411,ESCOLA SALTELLS,08266,082665,CERDANYOLA DEL VALLÈS,20,2,22
2023/2024,08036391,INSTITUT ARQUITECTE MANUEL RASPALL,08046,080462,CARDEDEU,40,18,58
2023/2024,08036378,ESCOLA CHARLIE RIVEL,08101,081017,L'HOSPITALET DE LLOBREGAT,17,4,21
2023/2024,08036366,ESCOLA LOLA ANGLADA,08101,081017,L'HOSPITALET DE LLOBREGAT,18,3,21
2023/2024,08036342,ESCOLA JOAN LLONGUERAS,08015,080155,BADALONA,15,4,19
2023/2024,08036330,INSTITUT J.V. FOIX,08184,081846,RUBÍ,37,36,73
2023/2024,08036147,ESCOLA PAU PICASSO,08015,080155,BADALONA,19,7,26
2023/2024,08036135,ESCOLA JOAN CORET,08015,080155,BADALONA,24,5,29
2023/2024,08036111,ESCOLA MAS I PERERA,08305,083054,VILAFRANCA DEL PENEDÈS,30,4,34
2023/2024,08036101,ESCOLA SAGRADA FAMÍLIA,08245,082457,SANTA COLOMA DE GRAMENET,28,3,31
2023/2024,08036056,ESCOLA FOLCH I TORRES,08077,080771,ESPLUGUES DE LLOBREGAT,29,1,30
2023/2024,08036044,ESCOLA PAU VILA,08076,080765,ESPARREGUERA,27,4,31
2023/2024,08036007,ESCOLA PAU VILA,08211,082114,SANT FELIU DE LLOBREGAT,16,2,18
2023/2024,08035994,ESCOLA SALVADOR ESPRIU,08211,082114,SANT FELIU DE LLOBREGAT,24,5,29
2023/2024,08035969,ESCOLA JOAQUIM BLUME,08187,081878,SABADELL,23,6,29
2023/2024,08035957,ESCOLA CAN DEU,08187,081878,SABADELL,14,4,18
2023/2024,08035945,ESCOLA LA CARPA,08101,081017,L'HOSPITALET DE LLOBREGAT,42,10,52
2023/2024,08035881,ESCOLA L'ARENY,08073,080734,CORNELLÀ DE LLOBREGAT,30,3,33
2023/2024,08035878,ESCOLA PERE DE TERA,08015,080155,BADALONA,25,6,31
2023/2024,08035854,ESCOLA LLORENS I ARTIGAS,08015,080155,BADALONA,27,2,29
2023/2024,08035696,ESCOLA SANT JULIÀ,08187,081878,SABADELL,18,2,20
2023/2024,08035684,ESCOLA MARIÀ MANENT,08230,082303,PREMIÀ DE DALT,27,4,31
2023/2024,08035623,CEE JERONI DE MORAGAS,08266,082665,CERDANYOLA DEL VALLÈS,16,2,18
2023/2024,08035544,CEE JOSEP PLA,08019,080193,BARCELONA,11,4,15
2023/2024,08035519,ESCOLA ANTONI GAUDÍ,08245,082457,SANTA COLOMA DE GRAMENET,32,5,37
2023/2024,08035477,ESCOLA SANTIAGO RUSIÑOL,08019,080193,BARCELONA,27,4,31
2023/2024,08035465,ESCOLA MARE NOSTRUM,08019,080193,BARCELONA,27,3,30
2023/2024,08035453,ESCOLA TOMÀS MORO,08019,080193,BARCELONA,17,0,17
2023/2024,08035441,ESCOLA CATALÒNIA,08019,080193,BARCELONA,25,6,31
2023/2024,08035431,ESCOLA BOGATELL,08019,080193,BARCELONA,26,4,30
2023/2024,08035428,ESCOLA LA FARIGOLA DEL CLOT,08019,080193,BARCELONA,25,7,32
2023/2024,08035416,ESCOLA JOSEP BOADA,08015,080155,BADALONA,30,4,34
2023/2024,08035404,ESCOLA JOAN MIRÓ,08015,080155,BADALONA,14,4,18
2023/2024,08035398,ESCOLA MIGUEL HERNÁNDEZ,08015,080155,BADALONA,14,6,20
2023/2024,08035362,INSTITUT ALT PENEDÈS,08305,083054,VILAFRANCA DEL PENEDÈS,50,45,95
2023/2024,08035350,ESCOLA SANT JOSEP,08263,082634,SANT VICENÇ DELS HORTS,25,4,29
2023/2024,08035349,INSTITUT LA ROMÀNICA,08252,082520,BARBERÀ DEL VALLÈS,63,32,95
2023/2024,08035325,INSTITUT TORRENT DE LES BRUIXES,08245,082457,SANTA COLOMA DE GRAMENET,38,23,61
2023/2024,08035313,INSTITUT QUERCUS,08218,082188,SANT JOAN DE VILATORRADA,42,31,73
2023/2024,08035301,INSTITUT DUC DE MONTBLANC,08184,081846,RUBÍ,50,30,80
2023/2024,08035295,INSTITUT PALAU AUSIT,08180,081803,RIPOLLET,33,58,91
2023/2024,08035283,ESCOLA REIXAC,08125,081252,MONTCADA I REIXAC,30,3,33
2023/2024,08035258,INSTITUT APEL·LES MESTRES,08101,081017,L'HOSPITALET DE LLOBREGAT,38,30,68
2023/2024,08035246,INSTITUT GELIDA,08091,080919,GELIDA,27,18,45
2023/2024,08035234,INSTITUT VIL·LA ROMANA,08088,080885,LA GARRIGA,47,16,63
2023/2024,08035222,INSTITUT MANUEL BLANCAFORT,08088,080885,LA GARRIGA,37,14,51
2023/2024,08035209,INSTITUT PABLO R. PICASSO,08019,080193,BARCELONA,30,20,50
2023/2024,08035167,INSTITUT BARCELONA-CONGRÉS,08019,080193,BARCELONA,34,17,51
2023/2024,08035155,INSTITUT ELS TRES TURONS,08006,080060,ARENYS DE MAR,38,25,63
2023/2024,08035143,INSTITUT MIQUEL MARTÍ I POL,08073,080734,CORNELLÀ DE LLOBREGAT,77,37,114
2023/2024,08035003,EA DE VIC,08298,082981,VIC,33,22,55
2023/2024,08034990,ESCOLA PARELLADA,08200,082009,SANT BOI DE LLOBREGAT,25,6,31
2023/2024,08034989,ESCOLA CATALUNYA,08194,081944,SANT ADRIÀ DE BESÒS,30,3,33
2023/2024,08034965,ESCOLA MARGARIDA XIRGU,08015,080155,BADALONA,33,6,39
2023/2024,08034904,ESCOLA EMILI CARLES I TOLRÀ,08051,080517,CASTELLAR DEL VALLÈS,15,1,16
2023/2024,08034862,ESCOLA AUSIÀS MARCH,08101,081017,L'HOSPITALET DE LLOBREGAT,17,2,19
2023/2024,08034850,ESCOLA PAU CASALS,08101,081017,L'HOSPITALET DE LLOBREGAT,33,11,44
2023/2024,08034837,ESCOLA BERNAT DESCLOT,08101,081017,L'HOSPITALET DE LLOBREGAT,15,4,19
2023/2024,08034795,ESCOLA HEUROM - ZER ALT LLUÇANÈS,08160,081607,PERAFITA,6,0,6
2023/2024,08034783,ESCOLA ELVIRA CUYÀS,08125,081252,MONTCADA I REIXAC,27,3,30
2023/2024,08034746,ESCOLA ROCAFONDA,08121,081213,MATARÓ,36,0,36
2023/2024,08034734,ESCOLA CAMÍ DEL MIG,08121,081213,MATARÓ,27,5,32
2023/2024,08034667,ESCOLA ESTEVE BARRACHINA,08270,082704,SITGES,30,6,36
2023/2024,08034643,INSTITUT LES VINYES,08245,082457,SANTA COLOMA DE GRAMENET,64,40,104
2023/2024,08034621,INSTITUT DE SALES,08301,083015,VILADECANS,64,33,97
2023/2024,08034606,INSTITUT BAIX MONTSENY,08202,082021,SANT CELONI,57,30,87
2023/2024,08034591,INSTITUT JOAN OLIVER,08187,081878,SABADELL,34,17,51
2023/2024,08034576,INSTITUT JOAN SALVAT I PAPASSEIT,08019,080193,BARCELONA,22,23,45
2023/2024,08034564,INSTITUT LES CORTS,08019,080193,BARCELONA,40,21,61
2023/2024,08034527,ESCOLA RAMON MUNTANER,08101,081017,L'HOSPITALET DE LLOBREGAT,16,1,17
2023/2024,08034497,ESCOLA L'ARAGAI,08307,083073,VILANOVA I LA GELTRÚ,18,3,21
2023/2024,08034461,ESCOLA BERNAT DE MOGODA,08260,082606,SANTA PERPÈTUA DE MOGODA,18,4,22
2023/2024,08034448,ESCOLA SANTA EULÀLIA,08231,082310,SANT PERE DE RIBES,25,5,30
2023/2024,08034412,ESCOLA CAN MASSALLERA,08200,082009,SANT BOI DE LLOBREGAT,13,4,17
2023/2024,08034400,ESCOLA ANTONI GAUDÍ,08200,082009,SANT BOI DE LLOBREGAT,16,0,16
2023/2024,08034382,ESCOLA RAMON LLULL,08184,081846,RUBÍ,24,6,30
2023/2024,08034357,ESCOLA VISTA ALEGRE,08121,081213,MATARÓ,14,2,16
2023/2024,08034333,ESCOLA LA LLÀNTIA,08121,081213,MATARÓ,25,5,30
2023/2024,08034321,ESCOLA TORRE LLAUDER,08121,081213,MATARÓ,18,2,20
2023/2024,08034278,ESCOLA VICENTE ALEIXANDRE,08114,081141,MARTORELL,25,1,26
2023/2024,08034266,ESCOLA JOAN MARAGALL,08101,081017,L'HOSPITALET DE LLOBREGAT,15,2,17
2023/2024,08034242,ESCOLA PABLO NERUDA,08101,081017,L'HOSPITALET DE LLOBREGAT,13,5,18
2023/2024,08034229,ESCOLA BONAVISTA,08051,080517,CASTELLAR DEL VALLÈS,14,2,16
2023/2024,08034217,INSTITUT BERNAT EL FERRER,08123,081234,MOLINS DE REI,67,68,135
2023/2024,08034205,INSTITUT LA GUINEUETA,08019,080193,BARCELONA,74,73,147
2023/2024,08034187,INSTITUT DOMÈNEC PERRAMON,08007,080076,ARENYS DE MUNT,41,12,53
2023/2024,08034138,INSTITUT POBLENOU,08019,080193,BARCELONA,50,35,85
2023/2024,08034126,ESCOLA PAU BOADA,08305,083054,VILAFRANCA DEL PENEDÈS,14,6,20
2023/2024,08034102,ESCOLA JOSEP MARIA MADORELL,08123,081234,MOLINS DE REI,16,2,18
2023/2024,08034096,ESCOLA ANTONI GAUDÍ,08056,080569,CASTELLDEFELS,24,7,31
2023/2024,08034084,ESCOLA CAN ROCA,08056,080569,CASTELLDEFELS,28,3,31
2023/2024,08034060,ESCOLA MOSSÈN CINTO VERDAGUER,08184,081846,RUBÍ,28,6,34
2023/2024,08034059,INSTITUT NICOLAU COPÈRNIC,08279,082798,TERRASSA,37,48,85
2023/2024,08034035,INSTITUT FEDERICA MONTSENY,08904,089045,BADIA DEL VALLÈS,30,22,52
2023/2024,08034011,INSTITUT FREDERIC MOMPOU,08263,082634,SANT VICENÇ DELS HORTS,43,18,61
2023/2024,17008134,EOI DE FIGUERES,17066,170669,FIGUERES,8,2,10
2023/2024,08034001,INSTITUT TERRA ROJA,08245,082457,SANTA COLOMA DE GRAMENET,47,17,64
2023/2024,08033997,ESCOLA PRIMAVERA,08245,082457,SANTA COLOMA DE GRAMENET,15,2,17
2023/2024,08033985,INSTITUT DE SANT JUST DESVERN,08221,082212,SANT JUST DESVERN,39,24,63
2023/2024,08033973,INSTITUT JAUME SALVADOR I PEDROL,08217,082172,SANT JOAN DESPÍ,34,28,62
2023/2024,08033961,INSTITUT RAFAEL CASANOVA,08200,082009,SANT BOI DE LLOBREGAT,46,26,72
2023/2024,08033948,ESCOLA ENRIC TATCHÉ I POL,08180,081803,RIPOLLET,25,6,31
2023/2024,08033924,INSTITUT PIUS FONT I QUER,08113,081136,MANRESA,36,30,66
2023/2024,08033912,INSTITUT MERCÈ RODOREDA,08101,081017,L'HOSPITALET DE LLOBREGAT,42,35,77
2023/2024,08033900,INSTITUT JOAN MIRÓ,08073,080734,CORNELLÀ DE LLOBREGAT,40,22,62
2023/2024,08033894,INSTITUT TERESA PÀMIES,08019,080193,BARCELONA,30,21,51
2023/2024,08033869,INSTITUT PAU CASALS,08015,080155,BADALONA,32,27,59
2023/2024,08033602,ESCOLA CAN SERRA,08252,082520,BARBERÀ DEL VALLÈS,24,4,28
2023/2024,08033560,ESCOLA MÀRIUS TORRES,08101,081017,L'HOSPITALET DE LLOBREGAT,33,8,41
2023/2024,08033535,ESCOLA JOAN MARAGALL,08077,080771,ESPLUGUES DE LLOBREGAT,29,3,32
2023/2024,08033523,ESCOLA LA MUNTANYETA,08019,080193,BARCELONA,13,5,18
2023/2024,08033501,ESCOLA ANTONI BRUSI,08019,080193,BARCELONA,23,8,31
2023/2024,08033468,ESCOLA LA SALUT,08069,080692,COLLBATÓ,17,3,20
2023/2024,08033407,ESCOLA PURIFICACIÓ SALAS I XANDRI,08238,082384,SANT QUIRZE DEL VALLÈS,15,2,17
2023/2024,08033341,ESCOLA BANÚS,08245,082457,SANTA COLOMA DE GRAMENET,12,5,17
2023/2024,08032762,ESCOLA DOCTOR TRUETA,08301,083015,VILADECANS,29,1,30
2023/2024,08032750,ESCOLA PAU CASALS,08301,083015,VILADECANS,28,2,30
2023/2024,08032737,ESCOLA CAN RULL,08187,081878,SABADELL,24,7,31
2023/2024,08032725,ESCOLA HONORABLE JOSEP TARRADELLAS,08169,081691,EL PRAT DE LLOBREGAT,28,7,35
2023/2024,08032713,ESCOLA SANT JORDI,08124,081249,MOLLET DEL VALLÈS,22,4,26
2023/2024,08032658,ESCOLA L'ERAMPRUNYÀ,08089,080898,GAVÀ,29,2,31
2023/2024,08032634,ESCOLA FERRER I GUÀRDIA,08019,080193,BARCELONA,32,7,39
2023/2024,08032592,ESCOLA SANT JORDI,08264,082649,SANT VICENÇ DE MONTALT,15,2,17
2023/2024,08032580,ESCOLA CANIGÓ,08221,082212,SANT JUST DESVERN,27,5,32
2023/2024,08032521,ESCOLA VALL DE PALAU,08196,081960,SANT ANDREU DE LA BARCA,28,2,30
2023/2024,08032491,ESCOLA SANT VICENÇ,08124,081249,MOLLET DEL VALLÈS,25,3,28
2023/2024,08032476,ESCOLA PRAT DE LA RIBA,08077,080771,ESPLUGUES DE LLOBREGAT,17,4,21
2023/2024,08032351,ESCOLA PAU CASALS,08184,081846,RUBÍ,29,5,34
2023/2024,08032348,ESCOLA 25 DE SETEMBRE,08184,081846,RUBÍ,36,8,44
2023/2024,08032312,ESCOLA MIGUEL DE UNAMUNO,08245,082457,SANTA COLOMA DE GRAMENET,31,4,35
2023/2024,08032300,ESCOLA FRAY LUIS DE LEÓN,08245,082457,SANTA COLOMA DE GRAMENET,27,5,32
2023/2024,08031873,INSTITUT ARNAU CADELL,08205,082055,SANT CUGAT DEL VALLÈS,46,22,68
2023/2024,08031861,INSTITUT LEONARDO DA VINCI,08205,082055,SANT CUGAT DEL VALLÈS,49,21,70
2023/2024,08031836,INSTITUT ILLA DELS BANYOLS,08169,081691,EL PRAT DE LLOBREGAT,16,64,80
2023/2024,08031812,INSTITUT VALLDEMOSSA,08019,080193,BARCELONA,29,18,47
2023/2024,08031800,ESCOLA PAU CASALS,08019,080193,BARCELONA,14,4,18
2023/2024,08031794,ESCOLA PALMA DE MALLORCA,08019,080193,BARCELONA,19,2,21
2023/2024,08031770,INSTITUT CAN JOFRESA,08279,082798,TERRASSA,40,26,66
2023/2024,08031757,INSTITUT FORAT DEL VENT,08266,082665,CERDANYOLA DEL VALLÈS,42,23,65
2023/2024,08031711,INSTITUT MANUEL DE CABANYES,08307,083073,VILANOVA I LA GELTRÚ,56,34,90
2023/2024,08031681,INSTITUT FRANCESC XAVIER LLUCH I RAFECAS,08307,083073,VILANOVA I LA GELTRÚ,55,49,104
2023/2024,08031666,ESCOLA CANIGÓ,08307,083073,VILANOVA I LA GELTRÚ,27,6,33
2023/2024,08031484,ESCOLA GINESTA,08307,083073,VILANOVA I LA GELTRÚ,24,5,29
2023/2024,08031472,ESCOLA POMPEU FABRA,08307,083073,VILANOVA I LA GELTRÚ,24,5,29
2023/2024,08031460,ESCOLA TRENTAPASSES,08306,083067,VILALBA SASSERRA,15,1,16
2023/2024,08031459,INSTITUT EUGENI D'ORS,08305,083054,VILAFRANCA DEL PENEDÈS,59,45,104
2023/2024,08031332,ESCOLA JOSEP BALTÀ I ELIAS,08305,083054,VILAFRANCA DEL PENEDÈS,25,8,33
2023/2024,08031320,ESCOLA ESTALELLA I GRAELLS,08305,083054,VILAFRANCA DEL PENEDÈS,27,5,32
2023/2024,08031319,ESCOLA LLEBEIG,08304,083041,VILOBÍ DEL PENEDÈS,17,1,18
2023/2024,08031290,ESCOLA LES ROQUES,08303,083036,VILANOVA DE SAU,5,1,6
2023/2024,08031277,ESCOLA JOAN MARAGALL,08302,083020,VILANOVA DEL CAMÍ,27,5,32
2023/2024,08031228,INSTITUT TORRE ROJA,08301,083015,VILADECANS,71,47,118
2023/2024,08031204,ESCOLA EL GARROFER,08301,083015,VILADECANS,28,4,32
2023/2024,08031101,ESCOLA MONTSERRATINA,08301,083015,VILADECANS,27,3,30
2023/2024,08031083,ESCOLA ÀNGELA ROCA,08301,083015,VILADECANS,20,1,21
2023/2024,08031061,ESCOLA ROSELLA,08300,083008,VILADECAVALLS,29,3,32
2023/2024,08031046,ESCOLA SERRA DE PICAMILL - ZER BERGUEDÀ CENTRE,08299,082994,VILADA,5,1,6
2023/2024,08031034,INSTITUT JAUME CALLÍS,08298,082981,VIC,41,24,65
2023/2024,08031022,INSTITUT DE VIC,08298,082981,VIC,115,80,195
2023/2024,08031009,ESCOLA DOCTOR JOAQUIM SALARICH,08298,082981,VIC,34,5,39
2023/2024,08030819,ESCOLA SENTFORES,08298,082981,VIC,17,3,20
2023/2024,08030789,ESCOLA POMPEU FABRA,08295,082956,VALLIRANA,17,0,17
2023/2024,08030728,ESCOLA SERRAT VOLTOR - ZER ALT BERGUEDÀ,08293,082938,VALLCEBRE,3,0,3
2023/2024,08030698,ESCOLA JOSEP MASCLANS,08292,082922,VALLBONA D'ANOIA,10,5,15
2023/2024,08030686,ESCOLA PAU CASALS,08291,082917,VACARISSES,22,5,27
2023/2024,08030662,ESCOLA SERRALAVELLA,08290,082900,ULLASTRELL,22,3,25
2023/2024,08030637,ESCOLA GUERAU DE PEGUERA,08288,082883,TORRELLES DE FOIX,15,2,17
2023/2024,08030613,ESCOLA J.J. RÀFOLS,08287,082877,TORRELAVIT,10,4,14
2023/2024,08030595,ESCOLA TORRESCASANA,08286,082861,LA TORRE DE CLARAMUNT,11,6,17
2023/2024,08030583,ESCOLA LA TORRE,08286,082861,LA TORRE DE CLARAMUNT,15,1,16
2023/2024,08030522,ESCOLA VALL DEL GES,08285,082858,TORELLÓ,16,0,16
2023/2024,08030510,ESCOLA DOCTOR FORTIÀ I SOLÀ,08285,082858,TORELLÓ,28,2,30
2023/2024,08030467,ESCOLA IGNASI IGLESIAS,08284,082845,TORDERA,30,5,35
2023/2024,08030421,ESCOLA L'ERA DE DALT,08283,082830,TONA,24,5,29
2023/2024,08030388,ESCOLA LOLA ANGLADA,08282,082824,TIANA,26,4,30
2023/2024,08030364,ESCOLA EL CIM,08281,082819,TEIÀ,30,4,34
2023/2024,08030340,INSTITUT INVESTIGADOR BLANXART,08279,082798,TERRASSA,56,27,83
2023/2024,08030339,INSTITUT DE TERRASSA,08279,082798,TERRASSA,95,62,157
2023/2024,08030315,ESCOLA JOAN XXIII,08279,082798,TERRASSA,26,5,31
2023/2024,08030297,ESCOLA SALVADOR VINYALS I GALÍ,08279,082798,TERRASSA,18,2,20
2023/2024,08030285,ESCOLA AURÓ,08279,082798,TERRASSA,17,3,20
2023/2024,08030248,ESCOLA PAU VILA I DINARÈS,08279,082798,TERRASSA,34,3,37
2023/2024,08030212,ESCOLA JOSEP VENTALLÓ I VINTRÓ,08279,082798,TERRASSA,17,2,19
2023/2024,08030200,ESCOLA MARIÀ GALÍ GUIX,08279,082798,TERRASSA,15,2,17
2023/2024,08029507,ESCOLA ISAAC PERAL,08279,082798,TERRASSA,16,1,17
2023/2024,08029386,ESCOLA RAMÓN Y CAJAL,08279,082798,TERRASSA,29,4,33
2023/2024,08029374,ESCOLA BISBAT D'EGARA,08279,082798,TERRASSA,44,3,47
2023/2024,08029350,ESCOLA FRANÇA,08279,082798,TERRASSA,28,3,31
2023/2024,08029301,ESCOLA LES PINEDIQUES,08278,082785,TARADELL,26,5,31
2023/2024,08029283,ESCOLA EL GURRI - ZER GUILLERIES,08278,082785,TARADELL,4,0,4
2023/2024,08029222,ESCOLA FRANCESC MACIÀ,08274,082747,SÚRIA,14,2,16
2023/2024,08029209,ESCOLA SALIPOTA,08274,082747,SÚRIA,13,2,15
2023/2024,08029192,ESCOLA SANT JORDI,08273,082732,SUBIRATS,13,2,15
2023/2024,08029155,ESCOLA EL MONTCAU - ZER SUBIRATS,08273,082732,SUBIRATS,7,2,9
2023/2024,08029143,ESCOLA EL SERRAL - ZER SUBIRATS,08273,082732,SUBIRATS,7,0,7
2023/2024,08029088,ESCOLA MIQUEL UTRILLO,08270,082704,SITGES,26,6,32
2023/2024,08029027,ESCOLA FARIGOLA,08269,082690,SEVA,15,1,16
2023/2024,08029015,ESCOLA SANT SALVADOR,08268,082687,CERCS,8,3,11
2023/2024,08028990,ESCOLA CAN SORTS,08267,082671,SENTMENAT,33,5,38
2023/2024,08028904,ESCOLA CARLES BUÏGAS,08266,082665,CERDANYOLA DEL VALLÈS,18,0,18
2023/2024,08028783,ESCOLA SERRAPARERA,08266,082665,CERDANYOLA DEL VALLÈS,27,3,30
2023/2024,08028758,ESCOLA LES FONTETES,08266,082665,CERDANYOLA DEL VALLÈS,12,4,16
2023/2024,08028746,ESCOLA SANT MARTÍ,08266,082665,CERDANYOLA DEL VALLÈS,15,3,18
2023/2024,08028709,ESCOLA LLORIANA,08265,082652,SANT VICENÇ DE TORELLÓ,14,1,15
2023/2024,08028667,ESCOLA JOAN JUNCADELLA,08263,082634,SANT VICENÇ DELS HORTS,26,1,27
2023/2024,17008122,EOI DE BLANES,17023,170237,BLANES,7,2,9
2023/2024,08028591,ESCOLA LA VINYALA,08263,082634,SANT VICENÇ DELS HORTS,18,2,20
2023/2024,08028588,ESCOLA SANT JORDI,08263,082634,SANT VICENÇ DELS HORTS,16,4,20
2023/2024,08028576,ESCOLA SANT VICENÇ,08262,082628,SANT VICENÇ DE CASTELLET,30,5,35
2023/2024,08028515,ESCOLA SANTA SUSANNA,08261,082613,SANTA SUSANNA,12,5,17
2023/2024,08028497,ESCOLA SANTA PERPÈTUA,08260,082606,SANTA PERPÈTUA DE MOGODA,21,4,25
2023/2024,08028436,ESCOLA LA FLORIDA,08260,082606,SANTA PERPÈTUA DE MOGODA,26,3,29
2023/2024,08028424,ESCOLA FONTMARTINA,08259,082592,SANTA MARIA DE PALAUTORDERA,23,2,25
2023/2024,08028382,ESCOLA SESMON D'OLÓ,08258,082589,SANTA MARIA D'OLÓ,11,0,11
2023/2024,08028345,ESCOLA LES MIMOSES,08256,082567,SANTA MARIA DE MARTORELLES,10,4,14
2023/2024,08028229,ESCOLA ELISA BADIA,08252,082520,BARBERÀ DEL VALLÈS,26,4,30
2023/2024,08028217,ESCOLA DOCTOR SAMARANCH I FINA,08251,082515,SANTA MARGARIDA I ELS MONJOS,26,4,30
2023/2024,08028163,ESCOLA MONTBOU,08250,082508,SANTA MARGARIDA DE MONTBUI,13,4,17
2023/2024,08028151,ESCOLA LES MORERES - ZER CEP DE SIS,08249,082495,SANTA FE DEL PENEDÈS,5,0,5
2023/2024,08028102,ESCOLA RONÇANA,08248,082482,SANTA EULÀLIA DE RONÇANA,17,1,18
2023/2024,08028072,ESCOLA EL ROURE GROS,08247,082476,SANTA EULÀLIA DE RIUPRIMER,14,2,16
2023/2024,08028059,ESCOLA JACINT VERDAGUER,08246,082460,SANTA EUGÈNIA DE BERGA,12,4,16
2023/2024,08028047,INSTITUT PUIG CASTELLAR,08245,082457,SANTA COLOMA DE GRAMENET,51,46,97
2023/2024,08028035,ESCOLA AUSIÀS MARCH,08245,082457,SANTA COLOMA DE GRAMENET,18,2,20
2023/2024,08027985,ESCOLA JAUME SALVATELLA,08245,082457,SANTA COLOMA DE GRAMENET,27,6,33
2023/2024,08027973,ESCOLA BEETHOVEN,08245,082457,SANTA COLOMA DE GRAMENET,17,3,20
2023/2024,08027870,ESCOLA LES PALMERES,08245,082457,SANTA COLOMA DE GRAMENET,27,5,32
2023/2024,08027511,ESCOLA TORRE BALLDOVINA,08245,082457,SANTA COLOMA DE GRAMENET,30,2,32
2023/2024,08027471,ESCOLA SANT JUST,08245,082457,SANTA COLOMA DE GRAMENET,26,5,31
2023/2024,08027456,ESCOLA FERRAN DE SAGARRA,08245,082457,SANTA COLOMA DE GRAMENET,33,4,37
2023/2024,08027432,ESCOLA WAGNER,08245,082457,SANTA COLOMA DE GRAMENET,18,3,21
2023/2024,08027249,ESCOLA SEGIMON COMAS,08237,082378,SANT QUIRZE DE BESORA,16,1,17
2023/2024,08027225,ESCOLA SANT PAU,08235,082359,SANT POL DE MAR,30,3,33
2023/2024,08027183,ESCOLA TORRE ROJA,08234,082346,SANT PERE DE VILAMAJOR,26,4,30
2023/2024,08027146,ESCOLA SANT JERONI,08232,082325,SANT PERE DE RIUDEBITLLES,15,1,16
2023/2024,08027134,ESCOLA LES ROQUETES,08231,082310,SANT PERE DE RIBES,23,4,27
2023/2024,08027110,ESCOLA EL PI,08231,082310,SANT PERE DE RIBES,15,2,17
2023/2024,08027021,ESCOLA FONT DE L'ANOIA - ZER VENT D'AVALL,08228,082286,SANT MARTÍ SESGUEIOLES,2,1,3
2023/2024,08027018,ESCOLA JAUME BALMES,08227,082270,SANT MARTÍ SARROCA,16,4,20
2023/2024,08026956,ESCOLA CÉRVOLA BLANCA,08226,082264,SANT MARTÍ DE TOUS,11,4,15
2023/2024,08026919,ESCOLA JOSEP GRAS,08223,082233,SANT LLORENÇ SAVALL,13,2,15
2023/2024,08026907,ESCOLA PAU CASALS,08222,082227,SANT LLORENÇ D'HORTONS,15,1,16
2023/2024,08026889,ESCOLA VINYES VERDES,08119,081192,MASQUEFA,14,2,16
2023/2024,08026816,ESCOLA MONTSERRAT,08221,082212,SANT JUST DESVERN,28,5,33
2023/2024,08026786,ESCOLA BELLPUIG,08220,082205,SANT JULIÀ DE VILATORTA,16,1,17
2023/2024,08026749,ESCOLA PÉREZ SALA,08219,082191,VILASSAR DE MAR,22,4,26
2023/2024,08026725,ESCOLA JONCADELLA,08218,082188,SANT JOAN DE VILATORRADA,26,4,30
2023/2024,08026683,INSTITUT FRANCESC FERRER I GUÀRDIA,08217,082172,SANT JOAN DESPÍ,73,36,109
2023/2024,08026671,ESCOLA JOAN PERICH I VALLS,08217,082172,SANT JOAN DESPÍ,16,1,17
2023/2024,08026661,ESCOLA PAU CASALS,08217,082172,SANT JOAN DESPÍ,34,2,36
2023/2024,08026567,ESCOLA SANT FRANCESC D'ASSÍS,08217,082172,SANT JOAN DESPÍ,29,2,31
2023/2024,08026476,ESCOLA FRANCESC MACIÀ,08214,082140,VILASSAR DE DALT,27,5,32
2023/2024,08026464,ESCOLA MONSENYOR GIBERT,08213,082135,SANT FRUITÓS DE BAGES,24,4,28
2023/2024,08026415,ESCOLA ELS ROURES - ZER GAVARRESA,08212,082129,SANT FELIU SASSERRA,6,1,7
2023/2024,08026397,INSTITUT OLORDA,08211,082114,SANT FELIU DE LLOBREGAT,49,19,68
2023/2024,08026385,ESCOLA ARQUITECTE GAUDÍ,08211,082114,SANT FELIU DE LLOBREGAT,19,2,21
2023/2024,08026373,ESCOLA JOSEP MONMANY AMAT,08211,082114,SANT FELIU DE LLOBREGAT,18,3,21
2023/2024,08026221,ESCOLA FALGUERA,08211,082114,SANT FELIU DE LLOBREGAT,14,5,19
2023/2024,08026211,ESCOLA NADAL,08211,082114,SANT FELIU DE LLOBREGAT,25,4,29
2023/2024,08026208,ESCOLA JAUME BALMES,08210,082107,SANT FELIU DE CODINES,17,6,23
2023/2024,08026154,ESCOLA JOAQUIM ABRIL,08209,082093,SANT FOST DE CAMPSENTELLES,23,4,27
2023/2024,08026130,ESCOLA LA ROUREDA,08208,082080,SANT ESTEVE SESROVIRES,22,2,24
2023/2024,08026117,ESCOLA VALLMANYA,08207,082074,SANT ESTEVE DE PALAUTORDERA,27,0,27
2023/2024,08026099,ESCOLA LES VINYES,08206,082068,SANT CUGAT SESGARRIGUES,11,1,12
2023/2024,08026087,ESCOLA JAUME FERRAN I CLUA,08205,082055,SANT CUGAT DEL VALLÈS,29,2,31
2023/2024,08026026,ESCOLA PINS DEL VALLÈS,08205,082055,SANT CUGAT DEL VALLÈS,26,5,31
2023/2024,08025927,ESCOLA PI D'EN XANDRI,08205,082055,SANT CUGAT DEL VALLÈS,26,5,31
2023/2024,08025824,ESCOLA LA FLORESTA,08205,082055,SANT CUGAT DEL VALLÈS,19,2,21
2023/2024,08025812,ESCOLA SANT CLIMENT,08204,082042,SANT CLIMENT DE LLOBREGAT,25,5,30
2023/2024,08025666,ESCOLA AURORA - ZER ALT LLUÇANÈS,08201,082016,SANT BOI DE LLUÇANÈS,3,2,5
2023/2024,08025654,INSTITUT JOAQUIM RUBIÓ I ORS,08200,082009,SANT BOI DE LLOBREGAT,34,37,71
2023/2024,08025642,ESCOLA JOSEP MARIA CIURANA,08200,082009,SANT BOI DE LLOBREGAT,25,2,27
2023/2024,08025605,INSTITUT CAMPS BLANCS,08200,082009,SANT BOI DE LLOBREGAT,87,63,150
2023/2024,08025599,ESCOLA MARIANAO,08200,082009,SANT BOI DE LLOBREGAT,18,2,20
2023/2024,08025587,ESCOLA CASABLANCA,08200,082009,SANT BOI DE LLOBREGAT,27,6,33
2023/2024,08025526,ESCOLA CIUTAT COOPERATIVA,08200,082009,SANT BOI DE LLOBREGAT,16,3,19
2023/2024,08025344,ESCOLA AMAT VERDÚ,08200,082009,SANT BOI DE LLOBREGAT,15,5,20
2023/2024,08025320,ESCOLA LA MONJOIA,08199,081995,SANT BARTOMEU DEL GRAU,13,0,13
2023/2024,08025319,ESCOLA JOAN CASAS,08198,081982,SANT ANTONI DE VILAMAJOR,24,5,29
2023/2024,08025265,ESCOLA ÀNGEL GUIMERÀ,08196,081960,SANT ANDREU DE LA BARCA,26,3,29
2023/2024,08025241,ESCOLA JOAN MARAGALL,08196,081960,SANT ANDREU DE LA BARCA,14,3,17
2023/2024,08025083,ESCOLA POMPEU FABRA,08194,081944,SANT ADRIÀ DE BESÒS,24,9,33
2023/2024,08025071,ESCOLA DONES D'AIGUA,08193,081939,SANT ISCLE DE VALLALTA,9,4,13
2023/2024,08025058,ESCOLA RIU D'OR,08192,081923,SANTPEDOR,24,4,28
2023/2024,08024972,ESCOLA TORRES AMAT,08191,081918,SALLENT,27,3,30
2023/2024,08024893,INSTITUT CASTELLARNAU,08187,081878,SABADELL,64,57,121
2023/2024,08024881,INSTITUT FERRAN CASABLANCAS,08187,081878,SABADELL,55,43,98
2023/2024,08024871,INSTITUT PAU VILA,08187,081878,SABADELL,51,31,82
2023/2024,08024856,ESCOLA FONT ROSELLA,08187,081878,SABADELL,28,2,30
2023/2024,08024844,ESCOLA TORREGUITART,08187,081878,SABADELL,16,3,19
2023/2024,08024832,ESCOLA FLORESTA,08187,081878,SABADELL,12,4,16
2023/2024,08024820,ESCOLA PAU CASALS,08187,081878,SABADELL,28,4,32
2023/2024,08024819,ESCOLA CALVET D'ESTRELLA,08187,081878,SABADELL,15,2,17
2023/2024,08024807,ESCOLA AGNÈS ARMENGOL,08187,081878,SABADELL,16,2,18
2023/2024,08024790,ESCOLA ROUREDA,08187,081878,SABADELL,30,2,32
2023/2024,08024789,CEE FRANCESC BELLAPART,08187,081878,SABADELL,39,6,45
2023/2024,08024777,INSTITUT EGARA,08279,082798,TERRASSA,40,17,57
2023/2024,08024765,INSTITUT ARRAONA,08187,081878,SABADELL,36,26,62
2023/2024,08024741,INSTITUT ESCOLA INDUSTRIAL,08187,081878,SABADELL,65,71,136
2023/2024,08024066,ESCOLA TARLATANA,08187,081878,SABADELL,17,5,22
2023/2024,08024042,ESCOLA LA ROMÀNICA,08187,081878,SABADELL,28,5,33
2023/2024,08024030,ESCOLA SAMUNTADA,08187,081878,SABADELL,17,3,20
2023/2024,08024017,ESCOLA MIQUEL CARRERAS,08187,081878,SABADELL,16,4,20
2023/2024,08024005,ESCOLA JOAN MARAGALL,08187,081878,SABADELL,24,1,25
2023/2024,08023980,ESCOLA JUAN RAMÓN JIMÉNEZ,08187,081878,SABADELL,14,4,18
2023/2024,08023979,ESCOLA JOAN MONTLLOR,08187,081878,SABADELL,16,2,18
2023/2024,08023955,ESCOLA CIFUENTES,08187,081878,SABADELL,26,6,32
2023/2024,08023943,ESCOLA GAUDÍ,08187,081878,SABADELL,17,1,18
2023/2024,08023931,ESCOLA ENRIC CASASSAS,08187,081878,SABADELL,14,3,17
2023/2024,08023921,ESCOLA ESPRONCEDA,08187,081878,SABADELL,29,6,35
2023/2024,08023918,ESCOLA CONCÒRDIA,08187,081878,SABADELL,28,2,30
2023/2024,08023852,ESCOLA JOAN MARAGALL,08184,081846,RUBÍ,26,0,26
2023/2024,08023669,ESCOLA MARE DE DÉU DEL SÒL DEL PONT,08183,081831,RODA DE TER,27,4,31
2023/2024,08023591,ESCOLA PILAR MESTRES-JAUME TORRENS,08181,081810,LA ROCA DEL VALLÈS,15,3,18
2023/2024,08023566,ESCOLA ANSELM CLAVÉ,08180,081803,RIPOLLET,27,2,29
2023/2024,08023554,ESCOLA JOSEP MARIA GINESTA,08180,081803,RIPOLLET,29,1,30
2023/2024,08023542,ESCOLA TIANA DE LA RIBA,08180,081803,RIPOLLET,15,2,17
2023/2024,08023426,ESCOLA GASSÓ I VIDAL,08180,081803,RIPOLLET,15,2,17
2023/2024,08023372,ESCOLA ALFRED MATA,08175,081751,PUIG-REIG,16,1,17
2023/2024,08023359,ESCOLA VIROLAI - ZER CEP DE SIS,08174,081748,PUIGDÀLBER,4,0,4
2023/2024,08023335,ESCOLA MONTSERRAT,08172,081727,PREMIÀ DE MAR,20,7,27
2023/2024,08023232,ESCOLA SANT CRISTÒFOL,08172,081727,PREMIÀ DE MAR,20,3,23
2023/2024,08023207,ESCOLA LLUÇANÈS,08171,081712,PRATS DE LLUÇANÈS,14,3,17
2023/2024,08023141,ESCOLA MARE DE DÉU DEL PORTAL - ZER VENT D'AVALL,08170,081705,ELS PRATS DE REI,6,1,7
2023/2024,08023131,INSTITUT BALDIRI GUILERA,08169,081691,EL PRAT DE LLOBREGAT,45,19,64
2023/2024,08022938,ESCOLA JACINT VERDAGUER,08169,081691,EL PRAT DE LLOBREGAT,28,3,31
2023/2024,08022926,CEE CAN RIGOL,08169,081691,EL PRAT DE LLOBREGAT,31,6,37
2023/2024,08022914,ESCOLA JAUME BALMES,08169,081691,EL PRAT DE LLOBREGAT,27,3,30
2023/2024,08022902,ESCOLA DEL PARC,08169,081691,EL PRAT DE LLOBREGAT,27,4,31
2023/2024,08022884,ESCOLA JOAN MARAGALL,08169,081691,EL PRAT DE LLOBREGAT,16,1,17
2023/2024,08022860,ESCOLA LILLET A GÜELL,08166,081666,LA POBLA DE LILLET,9,2,11
2023/2024,08022859,ESCOLA MARIA BORÉS,08165,081653,LA POBLA DE CLARAMUNT,11,5,16
2023/2024,08022847,ESCOLA SANTS ABDÓ I SENÉN,08164,081640,EL PLA DEL PENEDÈS,11,4,15
2023/2024,08022835,ESCOLA JAUME I,08163,081635,PINEDA DE MAR,26,3,29
2023/2024,08022801,ESCOLA ANTONI DOLTRA,08163,081635,PINEDA DE MAR,17,3,20
2023/2024,08022768,ESCOLA HEROIS DEL BRUC,08161,081614,PIERA,29,3,32
2023/2024,08022707,ESCOLA POMPEU FABRA,08159,081593,PARETS DEL VALLÈS,15,2,17
2023/2024,08022690,ESCOLA LLUÍS PIQUER,08159,081593,PARETS DEL VALLÈS,28,2,30
2023/2024,08022689,ESCOLA PAU VILA,08158,081580,EL PAPIOL,27,2,29
2023/2024,08022677,ESCOLA JACINT VERDAGUER,08157,081574,PALLEJÀ,15,2,17
2023/2024,08022665,ESCOLA ÀNGEL GUIMERÀ,08157,081574,PALLEJÀ,14,3,17
2023/2024,08022616,ESCOLA JOSEP MARIA FOLCH I TORRES,08156,081568,PALAU-SOLITÀ I PLEGAMANS,16,2,18
2023/2024,08022598,ESCOLA LES FERRERIES DE PALAFOLLS,08155,081555,PALAFOLLS,25,4,29
2023/2024,08022586,ESCOLA EL DRAC,08154,081542,PACS DEL PENEDÈS,11,2,13
2023/2024,08022574,ESCOLA ÒRRIUS,08153,081537,ÒRRIUS,12,2,14
2023/2024,08022549,ESCOLA LLEVANT - ZER GAVARRESA,08151,081516,ORISTÀ,4,0,4
2023/2024,08022495,ESCOLA TERRA NOSTRA,08149,081496,OLOST,12,2,14
2023/2024,08022461,ESCOLA SANT BERNAT,08147,081477,OLESA DE MONTSERRAT,23,7,30
2023/2024,08022380,ESCOLA MARE DE DÉU DE MONTSERRAT,08147,081477,OLESA DE MONTSERRAT,16,3,19
2023/2024,08022379,ESCOLA PONT DE L'ARCADA,08146,081461,OLESA DE BONESVALLS,11,1,12
2023/2024,08022367,ESCOLA ROSSEND MONTANÉ,08145,081458,OLÈRDOLA,14,2,16
2023/2024,08022343,ESCOLA CIRCELL,08145,081458,OLÈRDOLA,12,4,16
2023/2024,08022331,ESCOLA D'OLVAN - ZER BAIX BERGUEDÀ,08144,081445,OLVAN,8,1,9
2023/2024,08022197,ESCOLA CATALUNYA,08140,081402,NAVARCLES,27,5,32
2023/2024,08022094,ESCOLA JOSEP ORRIOLS I ROCA,08138,081385,MOIÀ,23,6,29
2023/2024,08022082,ESCOLA PUIG DRAU - ZER BAIX MONTSENY,08137,081379,MONTSENY,6,0,6
2023/2024,08022070,ESCOLA MARINADA,08136,081363,MONTORNÈS DEL VALLÈS,26,2,28
2023/2024,08022057,ESCOLA SANT SADURNÍ,08136,081363,MONTORNÈS DEL VALLÈS,13,3,16
2023/2024,08022045,ESCOLA SANT JORDI,08135,081350,MONTMELÓ,28,2,30
2023/2024,08022011,ESCOLA PAU CASALS,08135,081350,MONTMELÓ,18,2,20
2023/2024,08022008,ESCOLA MONTMANY,08134,081347,FIGARÓ-MONTMANY,7,2,9
2023/2024,08021983,ESCOLA GIRA-SOL - ZER BAIX BERGUEDÀ,08132,081326,MONTMAJOR,6,0,6
2023/2024,08021961,ESCOLA EL ROCAL,08131,081311,MONTESQUIU,10,6,16
2023/2024,08021934,ESCOLA L'ESQUEIX - ZER EL MOIANÈS PONENT,08128,081287,MONISTROL DE CALDERS,4,1,5
2023/2024,08021892,ESCOLA SANT PERE,08127,081271,MONISTROL DE MONTSERRAT,14,3,17
2023/2024,08021880,ESCOLA SALVADOR ESPRIU,08126,081265,MONTGAT,23,2,25
2023/2024,08021788,INSTITUT MONTSERRAT MIRÓ I VILA,08125,081252,MONTCADA I REIXAC,32,16,48
2023/2024,17005522,ESCOLA VEÏNAT,17155,171557,SALT,23,1,24
2023/2024,08021764,ESCOLA MITJA COSTA,08125,081252,MONTCADA I REIXAC,14,2,16
2023/2024,08021685,ESCOLA FONT FREDA,08125,081252,MONTCADA I REIXAC,23,1,24
2023/2024,08021600,INSTITUT VICENÇ PLANTADA,08124,081249,MOLLET DEL VALLÈS,47,31,78
2023/2024,08021594,INSTITUT DE MOLLET DEL VALLÈS,08124,081249,MOLLET DEL VALLÈS,54,91,145
2023/2024,08021582,ESCOLA JOAN SALVAT PAPASSEIT,08124,081249,MOLLET DEL VALLÈS,16,2,18
2023/2024,08021570,ESCOLA DEL BOSC,08124,081249,MOLLET DEL VALLÈS,12,4,16
2023/2024,08021466,ESCOLA COL·LEGIS NOUS,08124,081249,MOLLET DEL VALLÈS,15,7,22
2023/2024,08021442,ESCOLA CASTELL CIURÓ,08123,081234,MOLINS DE REI,16,6,22
2023/2024,08021430,INSTITUT LLUÍS DE REQUESENS,08123,081234,MOLINS DE REI,46,29,75
2023/2024,08021363,ESCOLA L'ALZINA,08123,081234,MOLINS DE REI,12,5,17
2023/2024,08021351,ESCOLA EL PALAU,08123,081234,MOLINS DE REI,15,2,17
2023/2024,08021326,ESCOLA LA FASSINA,08122,081228,MEDIONA,7,3,10
2023/2024,08021302,INSTITUT DAMIÀ CAMPENY,08121,081213,MATARÓ,46,18,64
2023/2024,08021260,INSTITUT ALEXANDRE SATORRAS,08121,081213,MATARÓ,62,47,109
2023/2024,08021041,ESCOLA JOSEP MONTSERRAT,08121,081213,MATARÓ,14,4,18
2023/2024,08020929,ESCOLA GERMANES BERTOMEU,08121,081213,MATARÓ,34,2,36
2023/2024,08020917,ESCOLA JOSEP MANUEL PERAMÀS,08121,081213,MATARÓ,32,2,34
2023/2024,08020905,ESCOLA ANGELETA FERRER,08121,081213,MATARÓ,23,7,30
2023/2024,08020863,ESCOLA GINESTA,08120,081206,MATADEPERA,28,2,30
2023/2024,08020841,ESCOLA EL TURÓ,08119,081192,MASQUEFA,24,7,31
2023/2024,08020838,INSTITUT MEDITERRÀNIA,08118,081189,EL MASNOU,25,21,46
2023/2024,08020826,INSTITUT MAREMAR,08118,081189,EL MASNOU,48,21,69
2023/2024,08020723,ESCOLA OCATA,08118,081189,EL MASNOU,17,0,17
2023/2024,08020701,ESCOLA COMTES DE LACAMBRA,08117,081173,LES MASIES DE VOLTREGÀ,11,3,14
2023/2024,08020656,ESCOLA SIMEÓ RABASA,08115,081154,MARTORELLES,14,2,16
2023/2024,08020620,INSTITUT POMPEU FABRA,08114,081141,MARTORELL,48,40,88
2023/2024,08020619,ESCOLA JOSÉ ECHEGARAY,08114,081141,MARTORELL,31,4,35
2023/2024,08020607,ESCOLA JUAN RAMÓN JIMÉNEZ,08114,081141,MARTORELL,27,5,32
2023/2024,08020516,CEE EL PONTARRÓ,08114,081141,MARTORELL,31,4,35
2023/2024,08020498,ESCOLA ELS CONVENTS,08114,081141,MARTORELL,15,1,16
2023/2024,08020474,INSTITUT LLUÍS DE PEGUERA,08113,081136,MANRESA,58,34,92
2023/2024,08020462,INSTITUT LACETÀNIA,08113,081136,MANRESA,74,95,169
2023/2024,08020127,ESCOLA BAGES,08113,081136,MANRESA,28,6,34
2023/2024,08020097,ESCOLA PARE ALGUÉ,08113,081136,MANRESA,21,1,22
2023/2024,08020073,ESCOLA SANT IGNASI,08113,081136,MANRESA,32,5,37
2023/2024,08020061,ESCOLA LA RENAIXENÇA,08113,081136,MANRESA,18,3,21
2023/2024,08020012,ESCOLA MUNTANYA DEL DRAC,08113,081136,MANRESA,16,3,19
2023/2024,08019940,ESCOLA PUIG-AGUT,08112,081120,MANLLEU,35,5,40
2023/2024,08019927,ESCOLA MARIÀ CUBÍ I SOLER,08110,081108,MALGRAT DE MAR,26,6,32
2023/2024,08019873,ESCOLA MARE DE DÉU DE MONTSERRAT,08110,081108,MALGRAT DE MAR,15,2,17
2023/2024,08019861,ESCOLA GAFARRÓ - ZER ALT LLUÇANÈS,08109,081094,LLUÇÀ,5,0,5
2023/2024,08019824,ESCOLA LES LLISSES,08108,081081,LLIÇÀ DE VALL,19,4,23
2023/2024,08019782,ESCOLA SALVADOR SANROMÀ,08106,081069,LLINARS DEL VALLÈS,26,3,29
2023/2024,08019745,ESCOLA JOAN MARAGALL,08105,081056,LA LLAGOSTA,25,3,28
2023/2024,08019711,ESCOLA SAGRADA FAMÍLIA,08105,081056,LA LLAGOSTA,16,3,19
2023/2024,08019691,ESCOLA VILADEMÀGER - ZER SERRA D'ANCOSA,08104,081043,LA LLACUNA,5,0,5
2023/2024,08019678,ESCOLA GUERAU DE JORBA,08103,081038,JORBA,9,2,11
2023/2024,08019654,INSTITUT MILÀ I FONTANALS,08102,081022,IGUALADA,66,75,141
2023/2024,08019642,ESCOLA PARE RAMON CASTELLTORT I MIRALDA,08102,081022,IGUALADA,31,2,33
2023/2024,08019630,INSTITUT PERE VIVES I VICH,08102,081022,IGUALADA,47,27,74
2023/2024,08019460,ESCOLA EMILI VALLÈS,08102,081022,IGUALADA,17,1,18
2023/2024,08019459,ESCOLA GABRIEL CASTELLA I RAICH,08102,081022,IGUALADA,18,1,19
2023/2024,08019435,ESCOLA GARCÍA I FOSSAS,08102,081022,IGUALADA,28,2,30
2023/2024,08019411,INSTITUT BELLVITGE,08101,081017,L'HOSPITALET DE LLOBREGAT,28,16,44
2023/2024,08019401,INSTITUT PROVENÇANA,08101,081017,L'HOSPITALET DE LLOBREGAT,51,59,110
2023/2024,08059287,ZER GUILLERIES,17220,172207,VILADRAU,3,1,4
2023/2024,08019371,INSTITUT LLOBREGAT,08101,081017,L'HOSPITALET DE LLOBREGAT,11,32,43
2023/2024,08019320,INSTITUT TORRAS I BAGES,08101,081017,L'HOSPITALET DE LLOBREGAT,32,24,56
2023/2024,08019319,INSTITUT PEDRAFORCA,08101,081017,L'HOSPITALET DE LLOBREGAT,66,47,113
2023/2024,08019307,INSTITUT SANTA EULÀLIA,08101,081017,L'HOSPITALET DE LLOBREGAT,40,15,55
2023/2024,08019290,ESCOLA PROVENÇANA,08101,081017,L'HOSPITALET DE LLOBREGAT,12,7,19
2023/2024,08019277,ESCOLA LA MARINA,08101,081017,L'HOSPITALET DE LLOBREGAT,24,6,30
2023/2024,08019265,ESCOLA JOAQUIM RUYRA,08101,081017,L'HOSPITALET DE LLOBREGAT,32,8,40
2023/2024,08019241,ESCOLA FREDERIC MISTRAL,08101,081017,L'HOSPITALET DE LLOBREGAT,28,4,32
2023/2024,08019231,ESCOLA MILAGROS CONSARNAU,08101,081017,L'HOSPITALET DE LLOBREGAT,27,7,34
2023/2024,08019216,ESCOLA BUSQUETS I PUNSET,08101,081017,L'HOSPITALET DE LLOBREGAT,26,3,29
2023/2024,08019198,ESCOLA POMPEU FABRA,08101,081017,L'HOSPITALET DE LLOBREGAT,27,5,32
2023/2024,08019149,ESCOLA BERNAT METGE,08101,081017,L'HOSPITALET DE LLOBREGAT,18,2,20
2023/2024,08018157,ESCOLA SANTIAGO RAMON Y CAJAL,08101,081017,L'HOSPITALET DE LLOBREGAT,35,7,42
2023/2024,08018145,ESCOLA PAU VILA,08101,081017,L'HOSPITALET DE LLOBREGAT,21,6,27
2023/2024,08018091,ESCOLA PEP VENTURA,08101,081017,L'HOSPITALET DE LLOBREGAT,35,7,42
2023/2024,08018078,ESCOLA BELLVITGE,08101,081017,L'HOSPITALET DE LLOBREGAT,16,3,19
2023/2024,08018066,ESCOLA MENÉNDEZ PIDAL,08101,081017,L'HOSPITALET DE LLOBREGAT,49,9,58
2023/2024,08018029,ESCOLA LES ESCOLES,08100,081000,GURB,28,1,29
2023/2024,08018017,ESCOLA L'ALBIOL - ZER ALT BERGUEDÀ,08903,089030,SANT JULIÀ DE CERDANYOLA,3,0,3
2023/2024,08018005,ESCOLA SANT LLORENÇ,08099,080996,GUARDIOLA DE BERGUEDÀ,8,2,10
2023/2024,08017992,ESCOLA MONTSERRAT,08098,080983,SANT SALVADOR DE GUARDIOLA,20,3,23
2023/2024,08017979,ESCOLA AQUA ALBA,08097,080977,GUALBA,12,3,15
2023/2024,08017931,INSTITUT ANTONI CUMELLA,08096,080961,GRANOLLERS,44,23,67
2023/2024,08017918,ESCOLA GRANULLARIUS,08096,080961,GRANOLLERS,26,3,29
2023/2024,08017712,ESCOLA FERRER I GUÀRDIA,08096,080961,GRANOLLERS,16,2,18
2023/2024,08017700,ESCOLA JOAN SOLANS,08096,080961,GRANOLLERS,15,5,20
2023/2024,08017694,ESCOLA PEREANTON,08096,080961,GRANOLLERS,15,2,17
2023/2024,08017682,ESCOLA JACINT VERDAGUER,08094,080945,LA GRANADA,12,3,15
2023/2024,08017645,ESCOLA DE GIRONELLA,08092,080924,GIRONELLA,16,2,18
2023/2024,08017633,ESCOLA SANT MARC,08092,080924,GIRONELLA,14,2,16
2023/2024,08017611,ESCOLA MONTCAU,08091,080919,GELIDA,23,4,27
2023/2024,08017530,INSTITUT DE BRUGUERS,08089,080898,GAVÀ,33,20,53
2023/2024,08017505,ESCOLA JUAN SALAMERO,08089,080898,GAVÀ,13,3,16
2023/2024,08017360,ESCOLA JACME MARCH,08089,080898,GAVÀ,13,4,17
2023/2024,08017359,ESCOLA SALVADOR LLUCH,08089,080898,GAVÀ,29,1,30
2023/2024,08017311,ESCOLA PUIGGRACIÓS,08088,080885,LA GARRIGA,26,4,30
2023/2024,08017271,ESCOLA JOAN SANPERA I TORRAS,08086,080863,LES FRANQUESES DEL VALLÈS,29,3,32
2023/2024,08017244,ESCOLA FONT-RÚBIA,08085,080850,FONT-RUBÍ,11,1,12
2023/2024,08017232,ESCOLA AGRUPACIÓ SANT JORDI,08084,080847,FONOLLOSA,13,3,16
2023/2024,08017153,INSTITUT JOANOT MARTORELL,08077,080771,ESPLUGUES DE LLOBREGAT,38,24,62
2023/2024,08017131,INSTITUT SEVERO OCHOA,08077,080771,ESPLUGUES DE LLOBREGAT,76,34,110
2023/2024,08017116,ESCOLA MATILDE ORDUÑA,08077,080771,ESPLUGUES DE LLOBREGAT,18,2,20
2023/2024,08017104,ESCOLA GRAS I SOLER,08077,080771,ESPLUGUES DE LLOBREGAT,14,3,17
2023/2024,08016941,ESCOLA ISIDRE MARTÍ,08077,080771,ESPLUGUES DE LLOBREGAT,30,2,32
2023/2024,08016938,ESCOLA TAQUÍGRAF GARRIGA,08076,080765,ESPARREGUERA,22,5,27
2023/2024,08016872,ESCOLA MARE DE DÉU DE LA MUNTANYA,08076,080765,ESPARREGUERA,15,2,17
2023/2024,08016811,ESCOLA JOSEP ANDREU - CHARLIE RIVEL,08074,080749,CUBELLES,28,7,35
2023/2024,08016793,INSTITUT FRANCESC MACIÀ,08073,080734,CORNELLÀ DE LLOBREGAT,51,26,77
2023/2024,08016781,INSTITUT ESTEVE TERRADAS I ILLA,08073,080734,CORNELLÀ DE LLOBREGAT,72,100,172
2023/2024,08016771,ESCOLA ELS PINS,08073,080734,CORNELLÀ DE LLOBREGAT,26,3,29
2023/2024,08016744,ESCOLA ANTONI GAUDÍ,08073,080734,CORNELLÀ DE LLOBREGAT,19,6,25
2023/2024,08016422,ESCOLA ABAT OLIBA,08073,080734,CORNELLÀ DE LLOBREGAT,20,1,21
2023/2024,08016410,ESCOLA SANT ILDEFONS,08073,080734,CORNELLÀ DE LLOBREGAT,21,6,27
2023/2024,08016409,ESCOLA MONTSERRAT,08073,080734,CORNELLÀ DE LLOBREGAT,12,5,17
2023/2024,08016392,ESCOLA MOSSÈN JACINT VERDAGUER,08073,080734,CORNELLÀ DE LLOBREGAT,15,1,16
2023/2024,08016380,ESCOLA ANSELM CLAVÉ,08073,080734,CORNELLÀ DE LLOBREGAT,14,3,17
2023/2024,08016367,ESCOLA DOLORS ALMEDA,08073,080734,CORNELLÀ DE LLOBREGAT,26,3,29
2023/2024,08016331,ESCOLA JAUME BALMES,08072,080728,CORBERA DE LLOBREGAT,22,5,27
2023/2024,08016291,ESCOLA QUATRE VENTS - ZER VENT D'AVALL,08071,080713,COPONS,8,0,8
2023/2024,08016264,ESCOLA EL SOLELL,08905,089058,LA PALMA DE CERVELLÓ,16,4,20
2023/2024,08016240,ESCOLA SANTA MARIA DE CERVELLÓ,08068,080689,CERVELLÓ,28,1,29
2023/2024,08016185,ESCOLA ILDEFONS CERDÀ,08067,080673,CENTELLES,25,3,28
2023/2024,08016173,ESCOLA MARE DE DÉU DE MONTSERRAT,08066,080667,CASTELLVÍ DE ROSANES,15,0,15
2023/2024,08016161,ESCOLA EL CASTELLOT,08065,080654,CASTELLVÍ DE LA MARCA,13,2,15
2023/2024,08016136,ESCOLA LES PASSERES - ZER TRES BRANQUES,08063,080636,CASTELLOLÍ,7,0,7
2023/2024,08016094,ESCOLA SANT MIQUEL,08061,080615,CASTELLGALÍ,14,2,16
2023/2024,08016082,ESCOLA SANT ROC - ZER VENT D'AVALL,08060,080608,CASTELLFOLLIT DE RIUBREGÓS,3,0,3
2023/2024,08016033,ESCOLA MONTANYANS,08058,080581,CASTELLET I LA GORNAL,9,6,15
2023/2024,08015961,ESCOLA JACINT VERDAGUER,08056,080569,CASTELLDEFELS,14,3,17
2023/2024,08015855,ESCOLA ELS PINS,08056,080569,CASTELLDEFELS,26,4,30
2023/2024,08015843,ESCOLA LLUÍS VIVES,08056,080569,CASTELLDEFELS,30,1,31
2023/2024,08015831,ESCOLA LA POPA,08055,080556,CASTELLCIR,8,3,11
2023/2024,08015821,ESCOLA MARE DE DÉU DE MONTSERRAT,08054,080543,CASTELLBISBAL,27,1,28
2023/2024,08015806,ESCOLA JAUME BALMES,08053,080538,CASTELLBELL I EL VILAR,15,4,19
2023/2024,08015651,ESCOLA PRINCESA LÀSCARIS,08049,080497,CASSERRES,13,2,15
2023/2024,08015648,ESCOLA SERRA DE COLL-BAS,08048,080484,CARME,8,1,9
2023/2024,08015612,ESCOLA JOAN DE PALÀ - ZER EL CARDENER,08047,080478,CARDONA,2,1,3
2023/2024,08015582,ESCOLA PATROCINI,08047,080478,CARDONA,13,3,16
2023/2024,08015454,ESCOLA RAMON MACIP - DOLORS GRANÉS,08046,080462,CARDEDEU,21,3,24
2023/2024,08015430,ESCOLA MARQUÈS DE LA POBLA,08044,080446,CAPELLADES,21,6,27
2023/2024,08015399,ESCOLA SANT NICOLAU,08043,080431,CANYELLES,22,6,28
2023/2024,08015375,ESCOLA L'ESTELADA,08042,080425,CÀNOVES I SAMALÚS,15,2,17
2023/2024,08015351,ESCOLA JACINT VERDAGUER,08041,080410,CANOVELLES,20,5,25
2023/2024,08015302,ESCOLA MISERICÒRDIA,08040,080403,CANET DE MAR,22,5,27
2023/2024,08015259,ESCOLA L'ALZINAR - ZER BAIX MONTSENY,08039,080399,CAMPINS,5,0,5
2023/2024,08015247,ESCOLA JOVENTUT,08038,080386,CALLÚS,14,3,17
2023/2024,08015193,ESCOLA SANT MARC,08037,080370,CALLDETENES,20,3,23
2023/2024,08015171,INSTITUT BISBE SIVILLA,08035,080351,CALELLA,46,31,77
2023/2024,08015144,ESCOLA EL FAR,08035,080351,CALELLA,29,2,31
2023/2024,08015119,ESCOLA LA MINERVA,08035,080351,CALELLA,29,2,31
2023/2024,08015107,ESCOLA ANTON BUSQUETS I PUNSET - ZER EL MOIANÈS PONENT,08034,080348,CALDERS,8,1,9
2023/2024,08015077,ESCOLA EL FARELL,08033,080333,CALDES DE MONTBUI,29,3,32
2023/2024,08015004,ESCOLA SAGRADA FAMÍLIA,08032,080327,CALDES D'ESTRAC,16,2,18
2023/2024,08014929,ESCOLA ALTA SEGARRA,08031,080312,CALAF,33,4,37
2023/2024,08014905,ESCOLA L'OLIVERA,08030,080305,CABRILS,27,1,28
2023/2024,08014841,ESCOLA LES OLIVERES - ZER SERRA D'ANCOSA,08028,080288,CABRERA D'ANOIA,5,1,6
2023/2024,08014814,ESCOLA EL BRUC,08025,080253,EL BRUC,11,5,16
2023/2024,08014796,ESCOLA DE BORREDÀ - ZER BERGUEDÀ CENTRE,08024,080240,BORREDÀ,2,0,2
2023/2024,08014747,ESCOLA EL TURÓ,08023,080235,BIGUES I RIELLS DEL FAI,15,2,17
2023/2024,08014693,INSTITUT GUILLEM DE BERGUEDÀ,08022,080229,BERGA,50,21,71
2023/2024,08014681,ESCOLA SANTA EULÀLIA,08022,080229,BERGA,28,4,32
2023/2024,08014668,ESCOLA DE LA VALLDAN,08022,080229,BERGA,11,1,12
2023/2024,08014620,ESCOLA SANT JOAN,08022,080229,BERGA,18,6,24
2023/2024,08014589,ESCOLA SANT CRISTÒFOR,08020,080207,BEGUES,27,4,31
2023/2024,08014401,INSTITUT MARE DE DÉU DE LA MERCÈ,08019,080193,BARCELONA,75,87,162
2023/2024,08013470,INSTITUT BARRI BESÒS,08019,080193,BARCELONA,37,16,53
2023/2024,08013469,INSTITUT RAMBLA PRIM,08019,080193,BARCELONA,22,33,55
2023/2024,08013457,ESCOLA PEGASO,08019,080193,BARCELONA,29,3,32
2023/2024,08013411,ESCOLA POBLE-SEC,08019,080193,BARCELONA,30,2,32
2023/2024,08013408,ESCOLA BARCELONA,08019,080193,BARCELONA,27,5,32
2023/2024,08013366,INSTITUT NOU BARRIS,08019,080193,BARCELONA,33,20,53
2023/2024,08013329,EA LLOTJA,08019,080193,BARCELONA,75,62,137
2023/2024,08013275,INSTITUT ESCOLA DEL TREBALL,08019,080193,BARCELONA,100,159,259
2023/2024,08013238,INSTITUT VERDAGUER,08019,080193,BARCELONA,26,11,37
2023/2024,08013226,INSTITUT MENÉNDEZ Y PELAYO,08019,080193,BARCELONA,40,24,64
2023/2024,08013214,INSTITUT NARCÍS MONTURIOL,08019,080193,BARCELONA,24,11,35
2023/2024,08013202,INSTITUT MONTSERRAT,08019,080193,BARCELONA,44,28,72
2023/2024,08013196,INSTITUT MILÀ I FONTANALS,08019,080193,BARCELONA,35,23,58
2023/2024,08013184,INSTITUT BERNAT METGE,08019,080193,BARCELONA,21,18,39
2023/2024,08013160,INSTITUT POETA MARAGALL,08019,080193,BARCELONA,40,27,67
2023/2024,08013159,INSTITUT INFANTA ISABEL D'ARAGÓ,08019,080193,BARCELONA,39,26,65
2023/2024,08013147,INSTITUT SANTS,08019,080193,BARCELONA,44,18,62
2023/2024,08013135,INSTITUT MOISÈS BROGGI,08019,080193,BARCELONA,56,18,74
2023/2024,08013111,INSTITUT JAUME BALMES,08019,080193,BARCELONA,45,19,64
2023/2024,08013101,INSTITUT JOAN D'ÀUSTRIA,08019,080193,BARCELONA,32,23,55
2023/2024,08013093,INSTITUT MONTJUÏC,08019,080193,BARCELONA,23,14,37
2023/2024,08002991,ESCOLA CASCAVELL,08194,081944,SANT ADRIÀ DE BESÒS,13,5,18
2023/2024,08002988,ESCOLA PARE POVEDA,08019,080193,BARCELONA,24,0,24
2023/2024,08002976,ESCOLA RAMON CASAS,08019,080193,BARCELONA,27,4,31
2023/2024,08002952,ESCOLA ENRIC GRANADOS,08019,080193,BARCELONA,16,3,19
2023/2024,08002927,ESCOLA JOAQUIM RUYRA,08019,080193,BARCELONA,25,8,33
2023/2024,08002915,ESCOLA BRASIL,08019,080193,BARCELONA,19,2,21
2023/2024,08002903,CEE SANT JOAN DE LA CREU,08019,080193,BARCELONA,32,2,34
2023/2024,08002897,ESCOLA MESTRE MORERA,08019,080193,BARCELONA,20,2,22
2023/2024,08002873,ESCOLA BAC DE RODA,08019,080193,BARCELONA,26,5,31
2023/2024,08002800,ESCOLA MAS CASANOVAS,08019,080193,BARCELONA,15,4,19
2023/2024,08002770,ESCOLA ÀGORA,08019,080193,BARCELONA,12,6,18
2023/2024,08002745,ESCOLA EL CARMEL,08019,080193,BARCELONA,30,7,37
2023/2024,08002733,ESCOLA MIRALLETES,08019,080193,BARCELONA,17,0,17
2023/2024,08002721,ESCOLA FONT D'EN FARGAS,08019,080193,BARCELONA,31,1,32
2023/2024,08002681,ESCOLA DURAN I BAS,08019,080193,BARCELONA,27,3,30
2023/2024,08002666,CEE CONCHA ESPINA,08019,080193,BARCELONA,19,1,20
2023/2024,08002654,ESCOLA PRIM,08019,080193,BARCELONA,16,1,17
2023/2024,08002642,ESCOLA POBLENOU,08019,080193,BARCELONA,24,4,28
2023/2024,08002630,ESCOLA ELS PORXOS,08019,080193,BARCELONA,14,3,17
2023/2024,08002629,ESCOLA LES ACÀCIES,08019,080193,BARCELONA,28,5,33
2023/2024,08002617,ESCOLA RAMBLETA DEL CLOT,08019,080193,BARCELONA,26,5,31
2023/2024,08002599,ESCOLA EDUARD MARQUINA,08019,080193,BARCELONA,14,7,21
2023/2024,08002587,ESCOLA CONCEPCIÓN ARENAL,08019,080193,BARCELONA,17,5,22
2023/2024,08002575,ESCOLA LA PAU,08019,080193,BARCELONA,15,5,20
2023/2024,08002563,ESCOLA LA MAR BELLA,08019,080193,BARCELONA,23,6,29
2023/2024,08002551,ESCOLA MOLÍ DE FINESTRELLES,08019,080193,BARCELONA,29,2,31
2023/2024,08002538,ESCOLA VÍCTOR CATALÀ,08019,080193,BARCELONA,28,4,32
2023/2024,08002526,ESCOLA TIBIDABO,08019,080193,BARCELONA,15,3,18
2023/2024,08002484,ESCOLA MARTA MATA,08019,080193,BARCELONA,16,2,18
2023/2024,08002459,ESCOLA ELISENDA DE MONTCADA,08019,080193,BARCELONA,29,8,37
2023/2024,08002411,ESCOLA BARÓ DE VIVER,08019,080193,BARCELONA,14,3,17
2023/2024,08002393,ESCOLA L'ARC DE SANT MARTÍ,08019,080193,BARCELONA,18,2,20
2023/2024,08002368,ESCOLA TIMBALER DEL BRUC,08019,080193,BARCELONA,16,1,17
2023/2024,08002344,ESCOLA EL TURÓ,08019,080193,BARCELONA,21,2,23
2023/2024,08002320,ESCOLA CIUTAT COMTAL,08019,080193,BARCELONA,14,5,19
2023/2024,08002290,ESCOLA EMILI JUNCADELLA,08019,080193,BARCELONA,16,1,17
2023/2024,08002277,ESCOLA CALDERÓN DE LA BARCA,08019,080193,BARCELONA,29,4,33
2023/2024,08002216,ESCOLA JOSEP MARIA DE SAGARRA,08019,080193,BARCELONA,16,1,17
2023/2024,08002204,ESCOLA MONTSENY,08019,080193,BARCELONA,15,2,17
2023/2024,08002198,ESCOLA LA FARIGOLA DE VALLCARCA,08019,080193,BARCELONA,16,2,18
2023/2024,08002186,ESCOLA MARE DE DÉU DE MONTSERRAT,08019,080193,BARCELONA,14,3,17
2023/2024,08002174,ESCOLA BALDIRI REIXAC,08019,080193,BARCELONA,16,1,17
2023/2024,08002113,ESCOLA RIUS I TAULET,08019,080193,BARCELONA,34,5,39
2023/2024,08002071,ESCOLA GAYARRE,08019,080193,BARCELONA,21,2,23
2023/2024,08002061,ESCOLA JAUME I,08019,080193,BARCELONA,32,5,37
2023/2024,08002058,ESCOLA PRÀCTIQUES,08019,080193,BARCELONA,29,5,34
2023/2024,08002022,ESCOLA CAL MAIOL,08019,080193,BARCELONA,14,2,16
2023/2024,08002010,ESCOLA LLUÍS VIVES,08019,080193,BARCELONA,13,5,18
2023/2024,08002009,ESCOLA FRANCESC MACIÀ,08019,080193,BARCELONA,18,3,21
2023/2024,08001947,ESCOLA MALLORCA,08019,080193,BARCELONA,26,5,31
2023/2024,08001923,ESCOLA DIPUTACIÓ,08019,080193,BARCELONA,24,7,31
2023/2024,08001911,ESCOLA ELS LLORERS,08019,080193,BARCELONA,29,4,33
2023/2024,08001868,ESCOLA RUBÉN DARÍO,08019,080193,BARCELONA,17,3,20
2023/2024,08001856,ESCOLA DRASSANES,08019,080193,BARCELONA,22,10,32
2023/2024,08001832,ESCOLA CASTELLA,08019,080193,BARCELONA,17,4,21
2023/2024,08001820,ESCOLA MILÀ I FONTANALS,08019,080193,BARCELONA,33,5,38
2023/2024,08001819,ESCOLA COLLASO I GIL,08019,080193,BARCELONA,33,8,41
2023/2024,08001807,ESCOLA DE LA CONCEPCIÓ,08019,080193,BARCELONA,13,4,17
2023/2024,08001790,ESCOLA PERE VILA,08019,080193,BARCELONA,29,3,32
2023/2024,08001789,ESCOLA CERVANTES,08019,080193,BARCELONA,16,3,19
2023/2024,08001777,ESCOLA RAMON LLULL,08019,080193,BARCELONA,30,5,35
2023/2024,08001731,ESCOLA POETA FOIX,08019,080193,BARCELONA,17,2,19
2023/2024,08001716,ESCOLA DOLORS MONSERDÀ-SANTAPAU,08019,080193,BARCELONA,28,5,33
2023/2024,08001674,ESCOLA CAN CLOS,08019,080193,BARCELONA,14,0,14
2023/2024,08001650,ESCOLA EL POLVORÍ,08019,080193,BARCELONA,12,6,18
2023/2024,08001649,ESCOLA MOSSÈN JACINT VERDAGUER,08019,080193,BARCELONA,35,3,38
2023/2024,08001601,ESCOLA PARC DE LA CIUTADELLA,08019,080193,BARCELONA,18,1,19
2023/2024,08001595,ESCOLA BAIXERAS,08019,080193,BARCELONA,16,2,18
2023/2024,08001522,ESCOLA GALCERAN DE PINÓS,08016,080168,BAGÀ,12,3,15
2023/2024,08001509,ESCOLA ANTONI BOTEY,08015,080155,BADALONA,29,5,34
2023/2024,08001480,EA PAU GARGALLO,08015,080155,BADALONA,34,21,55
2023/2024,08001443,INSTITUT EUGENI D'ORS,08015,080155,BADALONA,75,36,111
2023/2024,08001431,INSTITUT ISAAC ALBÉNIZ,08015,080155,BADALONA,36,29,65
2023/2024,08001421,INSTITUT LA PINEDA,08015,080155,BADALONA,57,54,111
2023/2024,08001391,ESCOLA PLANAS I CASALS,08015,080155,BADALONA,28,3,31
2023/2024,08000402,ESCOLA FELIU I VEGUÉS,08015,080155,BADALONA,22,4,26
2023/2024,08000396,ESCOLA VENTÓS I MIR,08015,080155,BADALONA,25,3,28
2023/2024,08000384,ESCOLA LOLA ANGLADA,08015,080155,BADALONA,30,1,31
2023/2024,08000359,ESCOLA LA MUNTANYA,08014,080142,AIGUAFREDA,14,2,16
2023/2024,08000347,ESCOLA D'AVINYONET DEL PENEDÈS,08013,080137,AVINYONET DEL PENEDÈS,11,1,12
2023/2024,08000271,ESCOLA SANTA MARIA D'AVIÀ,08011,080116,AVIÀ,17,1,18
2023/2024,08000244,ESCOLA DOCTOR FERRER,08010,080109,ARTÉS,25,7,32
2023/2024,08000189,ESCOLA BERNAT DE RIUDEMEIA,08009,080095,ARGENTONA,15,2,17
2023/2024,08000165,ESCOLA SANT MARTÍ,08007,080076,ARENYS DE MUNT,23,4,27
2023/2024,08000153,ESCOLA JOAN MARAGALL,08006,080060,ARENYS DE MAR,36,4,40
2023/2024,08000098,ESCOLA BERTÍ,08005,080057,L'AMETLLA DEL VALLÈS,25,2,27
2023/2024,08000086,ESCOLA LA FORJA - ZER ALT LLUÇANÈS,08004,080044,ALPENS,5,0,5
2023/2024,08000049,ESCOLA FABRA,08003,080039,ALELLA,28,2,30
2023/2024,08000013,ESCOLA FRANCESC PLATÓN I SARTÍ,08001,080018,ABRERA,26,4,30
2023/2024,43013191,INSTITUT ESCOLA L'ARRABASSADA,43148,431482,TARRAGONA,38,11,49
2023/2024,43013142,INSTITUT ESCOLA EL TEMPLE,43155,431554,TORTOSA,47,17,64
2023/2024,43013130,INSTITUT ESCOLA JOAN ARDÈVOL,43038,430385,CAMBRILS,42,16,58
2023/2024,43013129,INSTITUT ESCOLA COMA-RUGA,43163,431634,EL VENDRELL,43,21,64
2023/2024,43013117,INSTITUT D'EST. PROFES. AQÜÍCOLES I AMBIENTALS DE CATALUNYA,43136,431362,LA RÀPITA,9,4,13
2023/2024,43013099,INSTITUT ESCOLA AGUSTÍ BARBERÀ,43014,430141,AMPOSTA,45,9,54
2022/2023,08000049,ESCOLA FABRA,08003,080039,ALELLA,28,2,30
2022/2023,08000013,ESCOLA FRANCESC PLATÓN I SARTÍ,08001,080018,ABRERA,26,4,30
2022/2023,08000384,ESCOLA LOLA ANGLADA,08015,080155,BADALONA,29,3,32
2022/2023,08000359,ESCOLA LA MUNTANYA,08014,080142,AIGUAFREDA,14,2,16
2022/2023,08000347,ESCOLA D'AVINYONET DEL PENEDÈS,08013,080137,AVINYONET DEL PENEDÈS,11,2,13
2022/2023,08000271,ESCOLA SANTA MARIA D'AVIÀ,08011,080116,AVIÀ,17,2,19
2022/2023,08000244,ESCOLA DOCTOR FERRER,08010,080109,ARTÉS,23,8,31
2022/2023,08000189,ESCOLA BERNAT DE RIUDEMEIA,08009,080095,ARGENTONA,15,2,17
2022/2023,08000165,ESCOLA SANT MARTÍ,08007,080076,ARENYS DE MUNT,19,7,26
2022/2023,43013191,INSTITUT ESCOLA L'ARRABASSADA,43148,431482,TARRAGONA,33,6,39
2022/2023,43013142,INSTITUT ESCOLA EL TEMPLE,43155,431554,TORTOSA,40,13,53
2022/2023,43013130,INSTITUT ESCOLA JOAN ARDÈVOL,43038,430385,CAMBRILS,35,15,50
2022/2023,43013129,INSTITUT ESCOLA COMA-RUGA,43163,431634,EL VENDRELL,46,12,58
2022/2023,43013117,INSTITUT D'EST. PROFES. AQÜÍCOLES I AMBIENTALS DE CATALUNYA,43136,431362,SANT CARLES DE LA RÀPITA,8,5,13
2022/2023,43013099,INSTITUT ESCOLA AGUSTÍ BARBERÀ,43014,430141,AMPOSTA,46,10,56
2022/2023,43013087,INSTITUT ESCOLA CORBATERA,43049,430496,CORNUDELLA DE MONTSANT,23,2,25
2022/2023,43013075,INSTITUT ESCOLA ÀNGEL DE TOBIES,43163,431634,EL VENDRELL,43,24,67
2022/2023,43012988,INSTITUT DE MIAMI,43092,430923,MONT-ROIG DEL CAMP,24,9,33
2022/2023,43012976,INSTITUT ESCOLA MEDITERRANI,43148,431482,TARRAGONA,23,9,32
2022/2023,43012903,ESCOLA EL BOSC - ZER EL FRANCOLÍ,43091,430918,MONT-RAL,2,0,2
2022/2023,43012812,INSTITUT ESCOLA L'AGULLA,43043,430430,EL CATLLAR,39,9,48
2022/2023,43012769,CEE FONT DEL LLEÓ,43123,431233,REUS,16,2,18
2022/2023,43012319,INSTITUT ESCOLA EL PERELLÓ,43104,431042,EL PERELLÓ,43,14,57
2022/2023,43012307,INSTITUT ESCOLA DANIEL MANGRANÉ,43155,431554,TORTOSA,39,18,57
2022/2023,43012289,INSTITUT ESCOLA 3 D'ABRIL,43094,430944,MÓRA LA NOVA,43,10,53
2022/2023,43012113,INSTITUT ESCOLA MARE DE DÉU DEL PORTAL,43022,430228,BATEA,26,5,31
2022/2023,43012095,ESCOLA JOAN MIRÓ,43092,430923,MONT-ROIG DEL CAMP,32,3,35
2022/2023,43012083,INSTITUT ESCOLA PI DEL BURGAR,43123,431233,REUS,49,12,61
2022/2023,43011492,ESCOLA LA CANALETA,43171,431711,VILA-SECA,27,5,32
2022/2023,43011479,INSTITUT TARRAGONA,43148,431482,TARRAGONA,46,18,64
2022/2023,43011418,INSTITUT RODA DE BERÀ,43131,431310,RODA DE BERÀ,20,18,38
2022/2023,43011303,ZER MONTSANT,43035,430350,CABACÉS,2,2,4
2022/2023,43011212,ESCOLA LA BÒBILA,43038,430385,CAMBRILS,27,5,32
2022/2023,43011200,EOI DE SALOU,43905,439057,SALOU,5,1,6
2022/2023,43011194,ESCOLA EL CUCURULL,43131,431310,RODA DE BERÀ,15,3,18
2022/2023,43011170,INSTITUT CRISTÒFOL DESPUIG,43155,431554,TORTOSA,37,17,54
2022/2023,43011145,ESCOLA ELS GANXETS,43123,431233,REUS,13,4,17
2022/2023,43011121,ESCOLA VILAMAR,43037,430379,CALAFELL,14,4,18
2022/2023,43011029,ZER EBRE,43125,431251,RIBA-ROJA D'EBRE,3,1,4
2022/2023,43010980,EOI RIBERA D'EBRE,43093,430939,MÓRA D'EBRE,4,0,4
2022/2023,43010888,INSTITUT DE TECNIFICACIÓ,43014,430141,AMPOSTA,31,28,59
2022/2023,43010864,ESCOLA ISABEL BESORA,43123,431233,REUS,23,5,28
2022/2023,43010852,INSTITUT ROSETA MAURI,43123,431233,REUS,50,18,68
2022/2023,43010839,ESCOLA SERRA MAJOR - ZER L'AGLÀ,43174,431747,LA VILELLA BAIXA,5,0,5
2022/2023,43010815,ESCOLA ELS COSSETANS,43051,430516,CUNIT,23,5,28
2022/2023,43010773,ESCOLA CONSOL FERRÉ,43014,430141,AMPOSTA,24,8,32
2022/2023,43010748,INSTITUT ELS PALLARESOS,43100,431009,ELS PALLARESOS,39,23,62
2022/2023,43010670,EOI DE VALLS,43161,431613,VALLS,5,0,5
2022/2023,43010669,EOI D'AMPOSTA,43014,430141,AMPOSTA,6,1,7
2022/2023,43010621,ESCOLA CINGLE ROIG - ZER BAIX CAMP NORD,43169,431690,VILAPLANA,3,1,4
2022/2023,43010608,INSTITUT SERRA DE MIRAMAR,43161,431613,VALLS,30,17,47
2022/2023,43010591,ESCOLA ARQUITECTE JUJOL,43100,431009,ELS PALLARESOS,13,3,16
2022/2023,43010581,ESCOLA MAS CLARIANA,43038,430385,CAMBRILS,23,4,27
2022/2023,43010578,INSTITUT FONTANELLES,43031,430311,LES BORGES DEL CAMP,41,16,57
2022/2023,43010554,ZER LES VINYES,43076,430764,MARÇÀ,3,2,5
2022/2023,43010530,ESCOLA MIRAMAR,43171,431711,VILA-SECA,25,6,31
2022/2023,43010529,ESCOLA CAVALLER ARNAU,43129,431299,RIUDOMS,15,3,18
2022/2023,43010505,ESCOLA LA VITXETA,43123,431233,REUS,25,4,29
2022/2023,43010499,CFA PAU CASALS,43043,430430,EL CATLLAR,16,3,19
2022/2023,43010487,ESCOLA MARCEL·LÍ ESQUIUS,43092,430923,MONT-ROIG DEL CAMP,15,3,18
2022/2023,43010414,INSTITUT COSTER DE LA TORRE,43028,430287,LA BISBAL DEL PENEDÈS,40,28,68
2022/2023,43010402,ESCOLA EL ROQUISSAR,43012,430120,ALTAFULLA,15,3,18
2022/2023,43010396,ESCOLA DE PONENT,43148,431482,TARRAGONA,20,1,21
2022/2023,43010372,INSTITUT LA TALAIA,43037,430379,CALAFELL,39,34,73
2022/2023,43010347,INSTITUT MARTA MATA,43905,439057,SALOU,46,20,66
2022/2023,43010335,INSTITUT LA MAR DE LA FRAU,43038,430385,CAMBRILS,35,14,49
2022/2023,43010323,CFA MONTBLANC,43086,430862,MONTBLANC,3,1,4
2022/2023,43010311,CFA RIBERA D'EBRE,43093,430939,MÓRA D'EBRE,5,2,7
2022/2023,43010220,ESCOLA DE MASPUJOLS,43081,430810,MASPUJOLS,14,1,15
2022/2023,43010189,INSTITUT MEDITERRÀNIA,43163,431634,EL VENDRELL,31,21,52
2022/2023,43010165,ESCOLA MARTA MATA,43163,431634,EL VENDRELL,23,5,28
2022/2023,43010153,ESCOLA VORA MAR,43905,439057,SALOU,34,4,38
2022/2023,43010141,ESCOLA GUILLEM FORTUNY,43038,430385,CAMBRILS,26,6,32
2022/2023,43010098,ESCOLA LA GINESTA,43037,430379,CALAFELL,24,10,34
2022/2023,43010086,CFA VILASECA,43171,431711,VILA-SECA,5,1,6
2022/2023,43010074,CFA VALLS,43161,431613,VALLS,5,3,8
2022/2023,43010062,CFA EL VENDRELL,43163,431634,EL VENDRELL,7,1,8
2022/2023,43010037,EOI DEL VENDRELL,43163,431634,EL VENDRELL,5,2,7
2022/2023,43009977,INSTITUT D'ALTAFULLA,43012,430120,ALTAFULLA,38,21,59
2022/2023,43009898,ESCOLA CASTELL DE CALAFELL,43037,430379,CALAFELL,24,7,31
2022/2023,43009886,ESCOLA JOSEP VECIANA,43103,431037,PERAFORT,16,1,17
2022/2023,43009862,EOI DE TORTOSA,43155,431554,TORTOSA,7,3,10
2022/2023,43009850,INSTITUT ERNEST LLUCH I MARTÍ,43051,430516,CUNIT,53,29,82
2022/2023,43009771,CFA TORTOSA,43155,431554,TORTOSA,4,6,10
2022/2023,43009722,INSTITUT CAL·LÍPOLIS,43148,431482,TARRAGONA,98,45,143
2022/2023,43009710,EOI DE REUS,43123,431233,REUS,9,3,12
2022/2023,43009618,ZER MESTRAL,43155,431554,TORTOSA,3,1,4
2022/2023,43009606,ZER BENISSANET-MIRAVET,43026,430265,BENISSANET,3,2,5
2022/2023,43009497,INSTITUT FONTS DEL GLORIETA,43005,430056,ALCOVER,25,15,40
2022/2023,43009461,ZER TERRA ALTA-CENTRE,43048,430483,CORBERA D'EBRE,3,2,5
2022/2023,43009451,ESCOLA SALOU,43905,439057,SALOU,32,4,36
2022/2023,43009394,ZER LA FONT DE L'AIGUADÍ,43067,430672,GINESTAR,3,1,4
2022/2023,43009370,ZER TERRA ALTA NORD,43175,431750,VILALBA DELS ARCS,3,2,5
2022/2023,43009369,ESCOLA SAAVEDRA,43148,431482,TARRAGONA,17,3,20
2022/2023,43009345,ZER RIBERA D'EBRE NORD,43152,431520,LA TORRE DE L'ESPANYOL,4,1,5
2022/2023,43009321,ZER RIU I SERRA,43025,430252,BENIFALLET,4,0,4
2022/2023,43009311,ZER MONT CARO,43008,430081,ALFARA DE CARLES,3,1,4
2022/2023,43009308,ZER MEDITERRÀNIA,43004,430043,ALCANAR,4,1,5
2022/2023,43009242,ESCOLA L'ANTINA,43153,431536,TORREDEMBARRA,32,4,36
2022/2023,43009230,ESCOLA TARRAGONA,43148,431482,TARRAGONA,24,4,28
2022/2023,43009229,ZER PORTS-ALGARS,43018,430189,ARNES,3,1,4
2022/2023,43009217,ESCOLA DEL POBLE NOU DEL DELTA - ZER MEDITERRÀNIA,43014,430141,AMPOSTA,3,0,3
2022/2023,43009187,INSTITUT MARTÍ L'HUMÀ,43086,430862,MONTBLANC,44,26,70
2022/2023,43009141,ZER POBLET,43176,431763,VIMBODÍ I POBLET,5,0,5
2022/2023,43009138,ZER LA PARELLADA,43059,430593,FIGUEROLA DEL CAMP,2,2,4
2022/2023,43009126,ZER BAIX CAMP SUD,43167,431671,VILANOVA D'ESCORNALBOU,3,1,4
2022/2023,43009114,ZER EL FRANCOLÍ,43161,431613,VALLS,6,0,6
2022/2023,43009096,ZER ELS CEPS,43079,430799,MASLLORENÇ,2,3,5
2022/2023,43009084,ZER MONTSIÀ,43078,430786,MASDENVERGE,3,3,6
2022/2023,43009072,ZER CONCA DE BARBERÀ,43147,431476,SOLIVELLA,6,1,7
2022/2023,43009059,ZER BAIX CAMP NORD,43007,430075,L'ALEIXAR,2,4,6
2022/2023,43009047,ZER BAIX PRIORAT,43114,431140,PORRERA,3,1,4
2022/2023,43009035,ZER ATZAVARA,43098,430982,NULLES,3,2,5
2022/2023,43009023,ZER L'AGLÀ,43069,430691,GRATALLOPS,3,1,4
2022/2023,43009011,ZER RIU AVALL,43155,431554,TORTOSA,2,3,5
2022/2023,43009001,ZER MONTSANT-SERRA DE PRADES,43116,431166,PRADES,5,0,5
2022/2023,43008912,ESCOLA CINTA CURTO,43155,431554,TORTOSA,15,2,17
2022/2023,43008857,CFA REUS,43123,431233,REUS,6,4,10
2022/2023,43008754,CFA SEBASTIÀ JUAN ARBÓ,43014,430141,AMPOSTA,6,1,7
2022/2023,43008729,CFA TARRAGONA,43148,431482,TARRAGONA,8,6,14
2022/2023,43008638,INSTITUT ANTONI BALLESTER,43092,430923,MONT-ROIG DEL CAMP,23,26,49
2022/2023,43008547,ESCOLA CAMBRILS,43038,430385,CAMBRILS,28,4,32
2022/2023,43008535,ESCOLA SOLCUNIT,43051,430516,CUNIT,25,7,32
2022/2023,43008523,INSTITUT VILA-SECA,43171,431711,VILA-SECA,44,29,73
2022/2023,43008511,INSTITUT JOAN PUIG I FERRETER,43145,431457,LA SELVA DEL CAMP,37,19,56
2022/2023,43008501,INSTITUT PONT DEL DIABLE,43148,431482,TARRAGONA,33,8,41
2022/2023,43008481,INSTITUT COLLBLANC,43907,439076,LA CANONJA,46,22,68
2022/2023,43008456,INSTITUT LES PLANES,43138,431384,SANTA BÀRBARA,23,15,38
2022/2023,43008444,INSTITUT JOSEP TAPIRÓ,43123,431233,REUS,45,33,78
2022/2023,43008432,INSTITUT SANT PERE I SANT PAU,43148,431482,TARRAGONA,45,15,60
2022/2023,43008420,INSTITUT ROQUETES,43133,431331,ROQUETES,50,23,73
2022/2023,43008419,INSTITUT CAMARLES,43903,439039,CAMARLES,32,13,45
2022/2023,43008407,INSTITUT EL MORELL,43095,430957,EL MORELL,35,26,61
2022/2023,43008390,INSTITUT TORREFORTA,43148,431482,TARRAGONA,44,21,65
2022/2023,43008389,ESCOLA SANT LLATZER,43155,431554,TORTOSA,15,2,17
2022/2023,43007661,INSTITUT RAMON DE LA TORRE,43153,431536,TORREDEMBARRA,51,23,74
2022/2023,43007658,INSTITUT JOAN GUINJOAN I GISPERT,43129,431299,RIUDOMS,46,27,73
2022/2023,43007646,INSTITUT DE CONSTANTÍ,43047,430477,CONSTANTÍ,36,12,48
2022/2023,43007580,INSTITUT DE L'ARBOÇ,43016,430167,L'ARBOÇ,41,29,70
2022/2023,43007543,INSTITUT JAUME I,43905,439057,SALOU,64,27,91
2022/2023,43007385,INSTITUT D'HORTICULTURA I JARDINERIA,43123,431233,REUS,15,19,34
2022/2023,43007257,INSTITUT CAMÍ DE MAR,43037,430379,CALAFELL,57,44,101
2022/2023,43007233,INSTITUT DE FLIX,43060,430607,FLIX,32,13,45
2022/2023,43007221,INSTITUT ELS ALFACS,43136,431362,SANT CARLES DE LA RÀPITA,52,28,80
2022/2023,43007208,INSTITUT BERENGUER D'ENTENÇA,43162,431628,VANDELLÒS I L'HOSPITALET DE L'INFANT,40,17,57
2022/2023,43007178,ESCOLA MOWGLI,43123,431233,REUS,17,2,19
2022/2023,43007166,INSTITUT LLUÍS DOMÈNECH I MONTANER,43123,431233,REUS,50,48,98
2022/2023,43007129,INSTITUT JULIO ANTONIO,43093,430939,MÓRA D'EBRE,37,34,71
2022/2023,43007117,ESCOLA PAX,43148,431482,TARRAGONA,28,2,30
2022/2023,43007105,ESCOLA MONTSANT,43123,431233,REUS,14,3,17
2022/2023,43007087,INSTITUT SÒL DE RIU,43004,430043,ALCANAR,34,25,59
2022/2023,43007051,CFA JOSEPA MASSANÉS I DALMAU,43148,431482,TARRAGONA,6,6,12
2022/2023,43007038,INSTITUT ESCOLA D'HOTELERIA I TURISME,43038,430385,CAMBRILS,27,27,54
2022/2023,43006988,CEE GARBÍ,43163,431634,EL VENDRELL,20,0,20
2022/2023,43006976,INSTITUT CANDELERA,43013,430136,L'AMETLLA DE MAR,26,21,47
2022/2023,43006964,INSTITUT DE DELTEBRE,43901,439018,DELTEBRE,42,31,73
2022/2023,43006952,INSTITUT TORREDEMBARRA,43153,431536,TORREDEMBARRA,34,32,66
2022/2023,43006940,EOI DE TARRAGONA,43148,431482,TARRAGONA,28,7,35
2022/2023,43006873,ESCOLA RIUMAR,43901,439018,DELTEBRE,11,6,17
2022/2023,43006861,ESCOLA ENXANETA,43161,431613,VALLS,15,3,18
2022/2023,43006851,ESCOLA MOLÍ DE VENT,43153,431536,TORREDEMBARRA,29,3,32
2022/2023,43006708,INSTITUT JOAN SEGURA I VALLS,43139,431397,SANTA COLOMA DE QUERALT,12,7,19
2022/2023,43006691,INSTITUT PRIORAT,43055,430555,FALSET,37,26,63
2022/2023,43006681,INSTITUT DE LA SÉNIA,43044,430445,LA SÉNIA,32,17,49
2022/2023,43006678,INSTITUT GABRIEL FERRATER I SOLER,43123,431233,REUS,56,33,89
2022/2023,43006654,INSTITUT CAMBRILS,43038,430385,CAMBRILS,45,15,60
2022/2023,43006642,INSTITUT TERRA ALTA,43064,430640,GANDESA,33,18,51
2022/2023,43006630,INSTITUT PERE MARTELL,43148,431482,TARRAGONA,44,90,134
2022/2023,43006617,INSTITUT JOAN AMIGÓ I CALLAU,43054,430542,L'ESPLUGA DE FRANCOLÍ,22,8,30
2022/2023,43006587,ESCOLA ÀNGELS GARRIGA,43163,431634,EL VENDRELL,33,5,38
2022/2023,43006575,ESCOLA ELADI HOMS,43161,431613,VALLS,20,3,23
2022/2023,43006563,ESCOLA MARCEL·LÍ DOMINGO,43148,431482,TARRAGONA,25,3,28
2022/2023,43006551,ESCOLA HORTA VELLA,43136,431362,SANT CARLES DE LA RÀPITA,26,7,33
2022/2023,43006541,ESCOLA TERESA MIQUEL I PÀMIES,43123,431233,REUS,27,8,35
2022/2023,43006496,INSTITUT MANUEL SALES I FERRÉ,43156,431567,ULLDECONA,32,20,52
2022/2023,43006393,ESCOLA EUROPA,43905,439057,SALOU,30,8,38
2022/2023,43006371,ESCOLA SANT ROC - ZER CONCA DE BARBERÀ,43130,431303,ROCAFORT DE QUERALT,2,1,3
2022/2023,43006356,ESCOLA MARINADA,43038,430385,CAMBRILS,27,6,33
2022/2023,43006332,ESCOLA MESTRAL,43171,431711,VILA-SECA,21,3,24
2022/2023,43006241,ESCOLA LA PLANA,43171,431711,VILA-SECA,12,1,13
2022/2023,43006228,ESCOLA ROSA SENSAT,43123,431233,REUS,14,6,20
2022/2023,43006216,ESCOLA CÈLIA ARTIGA,43123,431233,REUS,17,2,19
2022/2023,43006186,ESCOLA SORIANO MONTAGUT,43014,430141,AMPOSTA,27,8,35
2022/2023,43006174,ESCOLA LES MORERES,43001,430017,AIGUAMÚRCIA,8,2,10
2022/2023,43006125,INSTITUT CAMPCLAR,43148,431482,TARRAGONA,51,29,80
2022/2023,43006101,INSTITUT MONTSIÀ,43014,430141,AMPOSTA,52,54,106
2022/2023,43006061,ESCOLA RUBIÓ I ORS,43123,431233,REUS,31,8,39
2022/2023,43006046,ESCOLA DIVINA PASTORA - ZER MESTRAL,43155,431554,TORTOSA,3,0,3
2022/2023,43005972,INSTITUT RAMON BARBAT I MIRACLE,43171,431711,VILA-SECA,51,34,85
2022/2023,43005959,ESCOLA CÈSAR AUGUST,43148,431482,TARRAGONA,28,7,35
2022/2023,43005947,ESCOLA CAL·LÍPOLIS,43171,431711,VILA-SECA,28,6,34
2022/2023,43005935,ESCOLA SANT BERNAT CALVÓ,43123,431233,REUS,25,7,32
2022/2023,43005911,ESCOLA CAMPCLAR,43148,431482,TARRAGONA,23,3,26
2022/2023,43005901,ESCOLA JOAN REBULL,43123,431233,REUS,34,4,38
2022/2023,43005893,ESCOLA CENTCELLES,43047,430477,CONSTANTÍ,19,4,23
2022/2023,43005765,ESCOLA EDUARD TODA I GÜELL,43123,431233,REUS,29,1,30
2022/2023,43005753,ESCOLA DOCTOR ALBERICH I CASAS,43123,431233,REUS,29,5,34
2022/2023,43005704,INSTITUT FRANCESC VIDAL I BARRAQUER,43148,431482,TARRAGONA,80,53,133
2022/2023,43005698,ESCOLA MARJAL - ZER MEDITERRÀNIA,43004,430043,ALCANAR,8,2,10
2022/2023,43005686,ESCOLA RIU CLAR,43148,431482,TARRAGONA,17,3,20
2022/2023,43005674,ESCOLA RAVAL DE CRISTO - ZER MONT CARO,43133,431331,ROQUETES,6,2,8
2022/2023,43005662,ESCOLA JOSEP NIN,43135,431359,SALOMÓ,7,2,9
2022/2023,43005650,ESCOLA EL DIVÍ MESTRE - ZER TERRA ALTA NORD,43175,431750,VILALBA DELS ARCS,5,0,5
2022/2023,43005637,ESCOLA MANUEL DE CASTELLVÍ I FELIU - ZER ATZAVARA,43165,431652,VILABELLA,6,0,6
2022/2023,43005625,ESCOLA SANT ANTONI ABAT - ZER MONT CARO,43155,431554,TORTOSA,4,0,4
2022/2023,43005613,ESCOLA SETZE DE FEBRER - ZER MEDITERRÀNIA,43902,439023,SANT JAUME D'ENVEJA,2,1,3
2022/2023,43005601,ESCOLA EL TORMO - ZER RIBERA D'EBRE NORD,43152,431520,LA TORRE DE L'ESPANYOL,5,0,5
2022/2023,43005595,ESCOLA LA PARELLADA,43140,431401,SANTA OLIVA,16,7,23
2022/2023,43005583,ESCOLA ELS QUATRE VENTS,43137,431378,SANT JAUME DELS DOMENYS,19,4,23
2022/2023,43005571,ESCOLA LES COMES,43132,431325,RODONYÀ,13,2,15
2022/2023,43005561,ESCOLA MARE DE DÉU DEL ROSER,43128,431286,RIUDECOLS,11,1,12
2022/2023,43005558,ESCOLA SANT MATEU,43127,431270,RIUDECANYES,11,1,12
2022/2023,43005546,ESCOLA DE LA RIBA - ZER EL FRANCOLÍ,43124,431248,LA RIBA,2,3,5
2022/2023,43005534,ESCOLA LES ERES DE RASQUERA - ZER LA FONT DE L'AIGUADÍ,43121,431212,RASQUERA,7,0,7
2022/2023,43005522,ESCOLA SANTA MARINA,43118,431188,PRATDIP,5,5,10
2022/2023,43005510,ESCOLA SERRA DE PRADES - ZER MONTSANT-SERRA DE PRADES,43116,431166,PRADES,4,1,5
2022/2023,43005509,ESCOLA ROSSEND GIOL - ZER BAIX PRIORAT,43114,431140,PORRERA,1,2,3
2022/2023,43005492,ESCOLA SANTA MAGDALENA - ZER LA PARELLADA,43113,431135,EL PONT D'ARMENTERA,4,1,5
2022/2023,43005480,ESCOLA MARE DE DÉU DEL LLEDÓ,43109,431093,LA POBLA DE MAFUMET,26,7,33
2022/2023,43005479,ESCOLA 1 D'ABRIL - ZER EBRE,43099,430995,LA PALMA D'EBRE,3,0,3
2022/2023,43005467,ESCOLA LES CODINETES,43097,430976,LA NOU DE GAIÀ,14,1,15
2022/2023,43005455,ESCOLA PIUS XII - ZER L'AGLÀ,43085,430859,EL MOLAR,3,0,3
2022/2023,43005443,ESCOLA ROC LLOP I CONVALIA - ZER BENISSANET-MIRAVET,43084,430846,MIRAVET,4,1,5
2022/2023,43005421,ESCOLA BERENGUER DE MONTOLIU - ZER ELS CEPS,43079,430799,MASLLORENÇ,3,2,5
2022/2023,43005418,ESCOLA SANT SALVADOR - ZER MONTSIÀ,43068,430688,GODALL,4,0,4
2022/2023,43005406,ESCOLA EL VERGER - ZER RIBERA D'EBRE NORD,43065,430653,GARCIA,5,0,5
2022/2023,43005391,ESCOLA SANT LLORENÇ - ZER MONTSIÀ,43063,430635,LA GALERA,4,2,6
2022/2023,43005388,ESCOLA MESTRE JOSEP RONCERO I PALLARÈS - ZER MONTSIÀ,43062,430629,FREGINALS,3,1,4
2022/2023,43005376,ESCOLA PUIGMARÍ - ZER BAIX CAMP SUD,43053,430537,DUESAIGÜES,1,2,3
2022/2023,43005364,ESCOLA LES ERES,43050,430509,CREIXELL,20,1,21
2022/2023,43005340,ESCOLA SANTA ANNA,43042,430424,CASTELLVELL DEL CAMP,13,5,18
2022/2023,43005339,ESCOLA MONTSANT - ZER MONTSANT,43027,430271,LA BISBAL DE FALSET,3,0,3
2022/2023,43005327,ESCOLA RAMON SUGRAÑES,43011,430115,ALMOSTER,12,4,16
2022/2023,43005315,ESCOLA D'ALFARA DE CARLES - ZER MONT CARO,43008,430081,ALFARA DE CARLES,4,0,4
2022/2023,43005303,ESCOLA SANT JORDI - ZER RIU I SERRA,43006,430069,ALDOVER,6,0,6
2022/2023,43005297,ESCOLA JOAN PERUCHO,43002,430022,ALBINYANA,11,5,16
2022/2023,43005194,ESCOLA MEDITERRANI,43906,439060,L'AMPOLLA,15,4,19
2022/2023,43005170,ESCOLA LA FLORESTA,43148,431482,TARRAGONA,16,2,18
2022/2023,43005169,ESCOLA PAU DELCLÒS,43148,431482,TARRAGONA,33,1,34
2022/2023,43005157,ESCOLA MONTOLIU,43126,431264,LA RIERA DE GAIÀ,12,4,16
2022/2023,43005145,ESCOLA ELS AMETLLERS,43111,431114,LA POBLA DE MONTORNÈS,12,6,18
2022/2023,43005133,ESCOLA MARE DE DÉU DEL PRIORAT,43020,430206,BANYERES DEL PENEDÈS,14,4,18
2022/2023,43005121,ESCOLA SANTA CATERINA,43178,431785,VINYOLS I ELS ARCS,12,4,16
2022/2023,43005108,ESCOLA LES ERES - ZER RIBERA D'EBRE NORD,43177,431779,VINEBRE,5,1,6
2022/2023,43005081,ESCOLA MARE DE DÉU DELS TORRENTS - ZER POBLET,43176,431763,VIMBODÍ I POBLET,7,0,7
2022/2023,43005017,ESCOLA DEL MONTGOI - ZER POBLET,43172,431726,VILAVERD,2,1,3
2022/2023,43005005,ESCOLA SANT BERNAT CALVÓ,43171,431711,VILA-SECA,27,4,31
2022/2023,43004979,ESCOLA TORROJA I MIRET,43171,431711,VILA-SECA,27,4,31
2022/2023,43004931,ESCOLA SANTA MARIA DEL MAR,43905,439057,SALOU,33,4,37
2022/2023,43004921,ESCOLA BERNARDÍ TOLRÀ,43170,431704,VILA-RODONA,13,3,16
2022/2023,43004888,ESCOLA FONT DE L'ARC - ZER BAIX CAMP SUD,43167,431671,VILANOVA D'ESCORNALBOU,6,1,7
2022/2023,43004864,ESCOLA PERE VIRGILI,43166,431665,VILALLONGA DEL CAMP,23,3,26
2022/2023,43004815,ESCOLA PAU CASALS,43163,431634,EL VENDRELL,25,7,32
2022/2023,43004803,INSTITUT ANDREU NIN,43163,431634,EL VENDRELL,80,75,155
2022/2023,43004797,INSTITUT BAIX PENEDÈS,43163,431634,EL VENDRELL,44,26,70
2022/2023,43004748,ESCOLA ÀNGEL GUIMERÀ,43163,431634,EL VENDRELL,32,8,40
2022/2023,43004700,ESCOLA VALDELORS,43162,431628,VANDELLÒS I L'HOSPITALET DE L'INFANT,8,3,11
2022/2023,43004657,ESCOLA MESTRAL,43162,431628,VANDELLÒS I L'HOSPITALET DE L'INFANT,34,12,46
2022/2023,43004633,ESCOLA EUGENI D'ORS,43161,431613,VALLS,26,8,34
2022/2023,43004611,INSTITUT JAUME HUGUET,43161,431613,VALLS,73,64,137
2022/2023,43004608,INSTITUT NARCÍS OLLER,43161,431613,VALLS,68,29,97
2022/2023,43004530,ESCOLA BALTASAR SEGÚ,43161,431613,VALLS,18,5,23
2022/2023,43004529,ESCOLA MARE DE DÉU DE LA CANDELA,43161,431613,VALLS,16,3,19
2022/2023,43004517,ESCOLA ROCABRUNA - ZER EL FRANCOLÍ,43161,431613,VALLS,6,1,7
2022/2023,43004505,ESCOLA MARE DE DÉU DEL ROSER,43160,431606,VALLMOLL,15,1,16
2022/2023,43004487,ESCOLA MONTSANT - ZER MONTSANT-SERRA DE PRADES,43157,431573,ULLDEMOLINS,3,1,4
2022/2023,43004463,ESCOLA RAMÓN Y CAJAL,43156,431567,ULLDECONA,35,8,43
2022/2023,43004441,INSTITUT DE L'EBRE,43155,431554,TORTOSA,71,64,135
2022/2023,43004438,INSTITUT DERTOSA,43155,431554,TORTOSA,67,36,103
2022/2023,43004268,ESCOLA REMOLINS,43155,431554,TORTOSA,18,4,22
2022/2023,43004256,ESCOLA FERRERIES,43155,431554,TORTOSA,27,8,35
2022/2023,43004232,ESCOLA LA MERCÈ,43155,431554,TORTOSA,22,5,27
2022/2023,43004189,ESCOLA SANT JAUME,43902,439023,SANT JAUME D'ENVEJA,20,0,20
2022/2023,43004116,ESCOLA DEL LLIGALLO DEL GÀNGUIL - ZER MESTRAL,43903,439039,CAMARLES,7,1,8
2022/2023,43004074,ESCOLA L'ASSUMPCIÓ,43901,439018,DELTEBRE,20,5,25
2022/2023,43004050,ESCOLA 21 D'ABRIL,43904,439044,L'ALDEA,15,2,17
2022/2023,43004037,ESCOLA MARIA GARCÍA I CABANES,43904,439044,L'ALDEA,15,3,18
2022/2023,43004013,ESCOLA SANT MIQUEL,43901,439018,DELTEBRE,28,5,33
2022/2023,43003987,ESCOLA PORT RODÓ - ZER MESTRAL,43155,431554,TORTOSA,9,0,9
2022/2023,43003975,ESCOLA SANT ÀNGEL,43903,439039,CAMARLES,15,3,18
2022/2023,43003951,ESCOLA BÍTEM - ZER RIU AVALL,43155,431554,TORTOSA,7,1,8
2022/2023,43003884,ESCOLA ANTONI ROIG,43153,431536,TORREDEMBARRA,29,5,34
2022/2023,43003847,ESCOLA MARCEL·LÍ DOMINGO,43150,431508,TIVISSA,13,0,13
2022/2023,43003835,ESCOLA JOSEP RIBA - ZER LES VINYES,43150,431508,TIVISSA,1,1,2
2022/2023,43003801,ESCOLA LA PINEDA - ZER RIU AVALL,43149,431495,TIVENYS,5,1,6
2022/2023,43003768,ESCOLA ELS ÀNGELS,43148,431482,TARRAGONA,32,4,36
2022/2023,43003756,ESCOLA TORREFORTA,43148,431482,TARRAGONA,28,7,35
2022/2023,43003732,INSTITUT PONS D'ICART,43148,431482,TARRAGONA,47,13,60
2022/2023,43003720,ESCOLA EL MIRACLE,43148,431482,TARRAGONA,21,3,24
2022/2023,43003690,ESCOLA DE PRÀCTIQUES,43148,431482,TARRAGONA,28,4,32
2022/2023,43003653,INSTITUT COMTE DE RIUS,43148,431482,TARRAGONA,35,59,94
2022/2023,43003641,INSTITUT ANTONI DE MARTÍ I FRANQUÈS,43148,431482,TARRAGONA,79,49,128
2022/2023,43003321,ESCOLA SANT PERE I SANT PAU,43148,431482,TARRAGONA,16,5,21
2022/2023,43003306,ESCOLA SERRALLO,43148,431482,TARRAGONA,16,3,19
2022/2023,43003227,ESCOLA SANT SALVADOR,43148,431482,TARRAGONA,25,13,38
2022/2023,43003185,ESCOLA LA CANONJA,43907,439076,LA CANONJA,37,5,42
2022/2023,43003136,ESCOLA BONAVISTA,43148,431482,TARRAGONA,35,7,42
2022/2023,43003124,ESCOLA SAGRAT COR - ZER CONCA DE BARBERÀ,43147,431476,SOLIVELLA,3,1,4
2022/2023,43003100,ESCOLA ABEL FERRATER,43145,431457,LA SELVA DEL CAMP,27,4,31
2022/2023,43003082,ESCOLA GUILLEM DE CLARAMUNT,43144,431444,LA SECUITA,14,3,17
2022/2023,43003069,ESCOLA SALVADOR NINOT,43142,431423,SARRAL,14,2,16
2022/2023,43003011,ESCOLA COR DE ROURE,43139,431397,SANTA COLOMA DE QUERALT,14,2,16
2022/2023,43003008,ESCOLA JAUME BALMES,43138,431384,SANTA BÀRBARA,24,7,31
2022/2023,43002892,ESCOLA CARLES III,43136,431362,SANT CARLES DE LA RÀPITA,34,11,45
2022/2023,43002831,ESCOLA MESTRE MARCEL·LÍ DOMINGO,43133,431331,ROQUETES,42,7,49
2022/2023,43002776,ESCOLA SALVADOR ESPRIU,43131,431310,RODA DE BERÀ,25,6,31
2022/2023,43002752,ESCOLA BEAT BONAVENTURA GRAN,43129,431299,RIUDOMS,31,2,33
2022/2023,43002661,ESCOLA SANT AGUSTÍ - ZER EBRE,43125,431251,RIBA-ROJA D'EBRE,6,1,7
2022/2023,43002594,INSTITUT BAIX CAMP,43123,431233,REUS,107,55,162
2022/2023,43002582,INSTITUT SALVADOR VILASECA,43123,431233,REUS,46,26,72
2022/2023,43002570,INSTITUT GAUDÍ,43123,431233,REUS,77,29,106
2022/2023,43002272,ESCOLA GENERAL PRIM,43123,431233,REUS,19,4,23
2022/2023,43002259,ESCOLA MARIÀ FORTUNY,43123,431233,REUS,29,6,35
2022/2023,43002247,ESCOLA MISERICÒRDIA,43123,431233,REUS,18,3,21
2022/2023,43002235,ESCOLA POMPEU FABRA,43123,431233,REUS,20,3,23
2022/2023,43002211,ESCOLA PRAT DE LA RIBA,43123,431233,REUS,14,3,17
2022/2023,43002171,ESCOLA JOAN PLANA,43119,431191,PUIGPELAT,16,0,16
2022/2023,43002144,ESCOLA MARE DE DÉU DE LA FONTCALDA - ZER PORTS-ALGARS,43117,431172,PRAT DE COMTE,3,0,3
2022/2023,43002053,ESCOLA GARBÍ - ZER MONTSANT-SERRA DE PRADES,43112,431129,POBOLEDA,3,2,5
2022/2023,43002016,ESCOLA L'AMETLLER - ZER TERRA ALTA NORD,43110,431107,LA POBLA DE MASSALUCA,3,1,4
2022/2023,43001966,ESCOLA SANT RAMON,43108,431080,EL PLA DE SANTA MARIA,14,2,16
2022/2023,43001954,ESCOLA ANTONI TOUS - ZER CONCA DE BARBERÀ,43107,431074,PIRA,4,2,6
2022/2023,43001942,ESCOLA CÈSAR MARTINELL - ZER TERRA ALTA-CENTRE,43106,431068,EL PINELL DE BRAI,3,4,7
2022/2023,43001851,ESCOLA SANT ROC - ZER RIU I SERRA,43102,431021,PAÜLS,4,1,5
2022/2023,43001826,ESCOLA SANT SEBASTIÀ,43100,431009,ELS PALLARESOS,18,5,23
2022/2023,43001796,ESCOLA SANT SEBASTIÀ - ZER ATZAVARA,43098,430982,NULLES,7,1,8
2022/2023,43001735,ESCOLA VENTURA GASSOL,43095,430957,EL MORELL,29,4,33
2022/2023,43001681,ESCOLA LLUÍS VIÑAS I VIÑOLES,43093,430939,MÓRA D'EBRE,26,4,30
2022/2023,43001668,ESCOLA MARE DE DÉU DE LA ROCA,43092,430923,MONT-ROIG DEL CAMP,28,5,33
2022/2023,43001656,ESCOLA TERESA GODES I DOMÈNECH,43090,430901,EL MONTMELL,12,4,16
2022/2023,43001607,ESCOLA JOSEP M. SOLER I GENÉ,43088,430884,MONTBRIÓ DEL CAMP,21,5,26
2022/2023,43001553,ESCOLA LES MURALLES,43086,430862,MONTBLANC,29,5,34
2022/2023,43001498,ESCOLA ONZE DE SETEMBRE - ZER BAIX PRIORAT,43082,430825,EL MASROIG,3,1,4
2022/2023,43001462,ESCOLA ELS TIL·LERS - ZER EL FRANCOLÍ,43080,430803,LA MASÓ,4,0,4
2022/2023,43001437,ESCOLA ROSA GISBERT - ZER MONTSIÀ,43078,430786,MASDENVERGE,6,2,8
2022/2023,43001395,ESCOLA TERESA SUBIRATS I MESTRE - ZER MONTSIÀ,43077,430770,MAS DE BARBERANS,3,2,5
2022/2023,43001383,ESCOLA ANICET VILLAR - ZER LES VINYES,43076,430764,MARÇÀ,3,1,4
2022/2023,43001361,ESCOLA LES COMETES,43074,430748,LLORENÇ DEL PENEDÈS,18,6,24
2022/2023,43001346,ESCOLA MONTSAGRE,43071,430712,HORTA DE SANT JOAN,9,1,10
2022/2023,43001334,ESCOLA SANT FELIU - ZER LES VINYES,43070,430705,ELS GUIAMETS,2,1,3
2022/2023,43001310,ESCOLA LLICORELLA - ZER L'AGLÀ,43069,430691,GRATALLOPS,3,1,4
2022/2023,43001280,ESCOLA PÀMIES - ZER LA FONT DE L'AIGUADÍ,43067,430672,GINESTAR,5,1,6
2022/2023,43001231,ESCOLA PUIG CAVALLER,43064,430640,GANDESA,22,7,29
2022/2023,43001127,ESCOLA ENRIC GRAU I FONTSERÈ,43060,430607,FLIX,21,3,24
2022/2023,43001115,ESCOLA MARE DE DÉU DE L'ESPERANÇA - ZER LA PARELLADA,43059,430593,FIGUEROLA DEL CAMP,5,0,5
2022/2023,43001097,ESCOLA LOS CASTELLETS - ZER TERRA ALTA NORD,43056,430568,LA FATARELLA,6,0,6
2022/2023,43001051,ESCOLA ANTONI VILANOVA,43055,430555,FALSET,24,2,26
2022/2023,43001036,ESCOLA MARTÍ POCH,43054,430542,L'ESPLUGA DE FRANCOLÍ,15,1,16
2022/2023,43001000,ESCOLA DE XERTA,43052,430521,XERTA,9,1,10
2022/2023,43000998,ESCOLA POMPEU FABRA,43051,430516,CUNIT,21,6,27
2022/2023,43000950,ESCOLA DOCTOR FERRAN - ZER TERRA ALTA-CENTRE,43048,430483,CORBERA D'EBRE,6,1,7
2022/2023,43000895,ESCOLA MOSSÈN RAMON BERGADÀ,43047,430477,CONSTANTÍ,30,8,38
2022/2023,43000871,ESCOLA MARIA JESÚS ORTÍ I ABELLA,43044,430445,LA SÉNIA,32,7,39
2022/2023,43000809,ESCOLA LA GESSERA - ZER PORTS-ALGARS,43041,430419,CASERES,1,2,3
2022/2023,43000792,ESCOLA SANT ISIDRE - ZER LES VINYES,43040,430402,CAPÇANES,3,1,4
2022/2023,43000779,INSTITUT RAMON BERENGUER IV,43038,430385,CAMBRILS,41,31,72
2022/2023,43000721,ESCOLA MOSSÈN JACINT VERDAGUER,43037,430379,CALAFELL,29,9,38
2022/2023,43000706,ESCOLA SANTA CREU DE CALAFELL,43037,430379,CALAFELL,40,10,50
2022/2023,43000688,ESCOLA DE CABRA DEL CAMP - ZER LA PARELLADA,43036,430363,CABRA DEL CAMP,3,2,5
2022/2023,43000676,ESCOLA EL CASTELL - ZER MONTSANT,43035,430350,CABACÉS,3,0,3
2022/2023,43000652,ESCOLA SANT JAUME DE BRÀFIM - ZER ATZAVARA,43034,430347,BRÀFIM,7,2,9
2022/2023,43000640,ESCOLA MARE DE DÉU DE LA CANDELA,43033,430332,BOTARELL,15,1,16
2022/2023,43000639,ESCOLA SANT BLAI - ZER TERRA ALTA-CENTRE,43032,430326,BOT,5,0,5
2022/2023,43000627,ESCOLA ROCABRUNA,43031,430311,LES BORGES DEL CAMP,13,4,17
2022/2023,43000615,ESCOLA L'ESTEL - ZER ELS CEPS,43030,430304,BONASTRE,1,5,6
2022/2023,43000603,ESCOLA DE BLANCAFORT - ZER POBLET,43029,430290,BLANCAFORT,3,0,3
2022/2023,43000597,ESCOLA ULL DEL VENT,43028,430287,LA BISBAL DEL PENEDÈS,18,9,27
2022/2023,43000561,ESCOLA ANTONI NAT - ZER BENISSANET-MIRAVET,43026,430265,BENISSANET,8,0,8
2022/2023,43000551,ESCOLA LLORENÇ VALLESPÍ I VIDIELLA - ZER RIU I SERRA,43025,430252,BENIFALLET,3,2,5
2022/2023,43000548,ESCOLA LA MUNTANYETA,43024,430249,BELLVEI,18,4,22
2022/2023,43000512,ESCOLA EL SARRAÍ - ZER BAIX PRIORAT,43023,430234,BELLMUNT DEL PRIORAT,2,1,3
2022/2023,43000470,ESCOLA VALLDEMUR - ZER CONCA DE BARBERÀ,43021,430213,BARBERÀ DE LA CONCA,6,1,7
2022/2023,43000433,ESCOLA SANT MIQUEL,43019,430192,ASCÓ,13,3,16
2022/2023,43000421,ESCOLA LA MIRANDA - ZER PORTS-ALGARS,43018,430189,ARNES,5,1,6
2022/2023,43000378,ESCOLA SANT JULIÀ,43016,430167,L'ARBOÇ,27,10,37
2022/2023,43000329,INSTITUT RAMON BERENGUER IV,43014,430141,AMPOSTA,53,26,79
2022/2023,43000275,ESCOLA MIQUEL GRANELL,43014,430141,AMPOSTA,24,7,31
2022/2023,43000263,ESCOLA SANT JORDI,43013,430136,L'AMETLLA DE MAR,35,3,38
2022/2023,43000251,ESCOLA LA PORTALADA,43012,430120,ALTAFULLA,27,5,32
2022/2023,43000226,ESCOLA LA BARQUERA - ZER ATZAVARA,43010,430108,ALIÓ,5,0,5
2022/2023,43000214,ESCOLA JOSEP FUSTÉ,43009,430094,ALFORJA,15,1,16
2022/2023,43000184,ESCOLA TERESA SALVAT I LLAURADÓ - ZER BAIX CAMP NORD,43007,430075,L'ALEIXAR,6,0,6
2022/2023,43000135,ESCOLA MARE DE DÉU DEL REMEI,43005,430056,ALCOVER,31,5,36
2022/2023,43000081,ESCOLA JOAN BAPTISTA SERRA,43004,430043,ALCANAR,42,5,47
2022/2023,43000020,ESCOLA SANT MIQUEL,43001,430017,AIGUAMÚRCIA,5,2,7
2022/2023,25010413,ESCOLA BALÀFIA-PINYANA,25120,251207,LLEIDA,30,7,37
2022/2023,25010383,INSTITUT ESCOLA D'OLIANA,25149,251497,OLIANA,26,5,31
2022/2023,25010361,INSTITUT CENTRE D'ESPORTS DE MUNTANYA DEL PALLARS,25171,251713,LA POBLA DE SEGUR,9,11,20
2022/2023,25010358,INSTITUT ESCOLA VALL DE LORD,25193,251930,SANT LLORENÇ DE MORUNYS,16,7,23
2022/2023,25010334,INSTITUT ESCOLA MAGRANERS,25120,251207,LLEIDA,22,11,33
2022/2023,25010310,INSTITUT DE MOLLERUSSA IV,25137,251370,MOLLERUSSA,30,3,33
2022/2023,25010280,INSTITUT ESCOLA TORRE QUERALT,25120,251207,LLEIDA,37,8,45
2022/2023,25010231,ESCOLA DE SALÀS DE PALLARS - ZER PALLARS JUSSÀ,25190,251902,SALÀS DE PALLARS,4,0,4
2022/2023,25010127,INSTITUT CASTELL DELS TEMPLERS,25120,251207,LLEIDA,24,13,37
2022/2023,25010085,ESCOLA JOSEP MAÑÉ I GAVALDÀ - ZER PONENT,25120,251207,LLEIDA,4,1,5
2022/2023,25009836,INSTITUT LA MITJANA,25120,251207,LLEIDA,45,10,55
2022/2023,25009800,ESCOLA TORRELAMEU - ZER ARGELAGA,25231,252311,TORRELAMEU,5,0,5
2022/2023,25009733,INSTITUT JOAN SOLÀ,25228,252287,TORREFARRERA,39,20,59
2022/2023,25009721,INSTITUT D'ALPICAT,25023,250236,ALPICAT,21,8,29
2022/2023,25009368,ESCOLA LA VALIRA-ZER URGELLET,25203,252038,LA SEU D'URGELL,3,0,3
2022/2023,25009356,ESCOLA LES ARRELS,25137,251370,MOLLERUSSA,14,5,19
2022/2023,25009344,ESCOLA LA MITJANA,25120,251207,LLEIDA,29,2,31
2022/2023,25009186,INSTITUT LA VALIRA,25203,252038,LA SEU D'URGELL,15,9,24
2022/2023,25009113,ESCOLA MESTRE RAMON ESTADELLA I TORRADEFLOT,25110,251109,GUISSONA,27,0,27
2022/2023,25009101,ESCOLA EL VINYET,25207,252075,SOLSONA,17,1,18
2022/2023,25009095,ESCOLA LES SAVINES,25072,250729,CERVERA,13,4,17
2022/2023,25009071,ESCOLA PAÏSOS CATALANS,25120,251207,LLEIDA,31,2,33
2022/2023,25009034,ESCOLA CIUTAT JARDÍ,25120,251207,LLEIDA,29,4,33
2022/2023,25009009,ZER EL SOLSONÈS,25207,252075,SOLSONA,6,1,7
2022/2023,25008984,CFA TREMP,25234,252347,TREMP,3,0,3
2022/2023,25008935,ESCOLA LA RÀPITA - ZER EL JONC,25240,252402,VALLFOGONA DE BALAGUER,4,0,4
2022/2023,25008923,CFA ENRIC GRANADOS,25120,251207,LLEIDA,8,6,14
2022/2023,25008893,ESCOLA PARC DEL SALADAR,25011,250117,ALCARRÀS,39,5,44
2022/2023,25008790,ESCOLA MARIA-MERCÈ MARÇAL,25217,252173,TÀRREGA,23,6,29
2022/2023,25008789,ESCOLA MONT-ROIG,25040,250404,BALAGUER,18,3,21
2022/2023,25008777,ESCOLA PARC DE L'AIGUA,25120,251207,LLEIDA,29,3,32
2022/2023,25008765,ESCOLA LA VALL FOSCA - ZER PALLARS JUSSÀ,25227,252271,LA TORRE DE CABDELLA,5,0,5
2022/2023,25008753,CFA SOLSONÈS,25207,252075,SOLSONA,6,0,6
2022/2023,25008741,CFA VAL D'ARAN,25243,252430,VIELHA E MIJARAN,2,1,3
2022/2023,25008649,ESCOLA FRANCESCO TONUCCI,25120,251207,LLEIDA,16,2,18
2022/2023,25008625,CFA MOLLERUSSA,25137,251370,MOLLERUSSA,7,3,10
2022/2023,25008595,CFA TÀRREGA,25217,252173,TÀRREGA,5,2,7
2022/2023,25008583,CFA LA SEU D'URGELL,25203,252038,LA SEU D'URGELL,5,1,6
2022/2023,25008571,CFA JOAN COMORERA,25072,250729,CERVERA,2,3,5
2022/2023,25008561,CFA BALAGUER,25040,250404,BALAGUER,1,3,4
2022/2023,25008558,EOI DE LA SEU D'URGELL,25203,252038,LA SEU D'URGELL,5,3,8
2022/2023,25008546,EOI DE TÀRREGA,25217,252173,TÀRREGA,5,1,6
2022/2023,25008534,ESCOLA DE LA VALL DE BOÍ - ZER ALTA RIBAGORÇA,25043,250432,LA VALL DE BOÍ,6,1,7
2022/2023,25008352,INSTITUT DE LA POBLA DE SEGUR,25171,251713,LA POBLA DE SEGUR,22,10,32
2022/2023,25008236,ZER PEDRERA,25081,250812,L'ESPLUGA CALBA,3,1,4
2022/2023,25008224,ZER ARGELAGA,25254,252542,VILANOVA DE LA BARCA,3,1,4
2022/2023,25008212,ESCOLA PRÀCTIQUES II,25120,251207,LLEIDA,29,3,32
2022/2023,25008157,ZER RIU ONDARA,25225,252252,TORNABOUS,4,1,5
2022/2023,25008145,ZER ALT SEGRIÀ,25251,252516,VILANOVA DE SEGRIÀ,4,1,5
2022/2023,25008133,ZER PONENT,25120,251207,LLEIDA,4,1,5
2022/2023,25008111,ZER LA COMA,25211,252115,SUDANELL,4,0,4
2022/2023,25008108,ZER L'ERAL,25200,252000,SARROCA DE LLEIDA,4,1,5
2022/2023,25008091,ZER VENT SERÈ,25068,250680,CASTELLNOU DE SEANA,5,1,6
2022/2023,25008081,ZER EL JONC,25062,250621,CAMARASA,3,2,5
2022/2023,25008078,ZER EL ROMANÍ,25138,251386,MONTGAI,3,3,6
2022/2023,25008066,ZER ESPERNALLAC,25070,250707,CASTELLSERÀ,4,2,6
2022/2023,25008054,ZER VALL DE L'ARANYÓ,25067,250674,CASTELLDANS,4,1,5
2022/2023,25008042,ZER RIU SET,25009,250096,L'ALBI,3,2,5
2022/2023,25007992,ESCOLA D'ALMENAR,25021,250215,ALMENAR,19,3,22
2022/2023,25007943,ZER PLAURCÉN,25168,251689,EL POAL,5,1,6
2022/2023,25007931,ZER VAL D'ARAN,25025,250254,NAUT ARAN,4,1,5
2022/2023,25007921,ZER L'HORTA DE LLEIDA,25120,251207,LLEIDA,5,0,5
2022/2023,25007918,ZER L'OLIVER,25133,251333,MAIALS,4,1,5
2022/2023,25007906,ZER SERRA LLARGA,25015,250156,ALGERRI,2,3,5
2022/2023,25007891,ZER ALTA RIBAGORÇA,25245,252458,VILALLER,6,1,7
2022/2023,25007888,ZER GARRIGUES ALTES,25118,251180,JUNCOSA,3,2,5
2022/2023,25007876,ZER RIU CORB,25046,250463,BELIANES,4,1,5
2022/2023,25007864,ZER URGELLET,25203,252038,LA SEU D'URGELL,5,1,6
2022/2023,25007852,ZER EL SIÓ,25138,251386,MONTGAI,4,1,5
2022/2023,25007840,ZER MONTSEC,25037,250371,LES AVELLANES I SANTA LINYA,5,2,7
2022/2023,25007839,ZER PALLARS JUSSÀ,25115,251155,ISONA I CONCA DELLÀ,3,2,5
2022/2023,25007827,ZER NARIEDA,25155,251556,ORGANYÀ,4,2,6
2022/2023,25007815,ZER ELAIA,25101,251018,LA GRANADELLA,2,2,4
2022/2023,25007803,ZER ALT PALLARS SOBIRÀ,25126,251266,LLAVORSÍ,4,1,5
2022/2023,25007797,ZER BARIDÀ-BATLLIA,25139,251399,MONTELLÀ I MARTINET,4,1,5
2022/2023,25007773,ZER LA SEGARRA,25905,259059,RIBERA D'ONDARA,2,3,5
2022/2023,25007761,ZER GUICIVERVI,25244,252445,VILAGRASSA,6,0,6
2022/2023,25007700,INSTITUT ERMENGOL IV,25047,250479,BELLCAIRE D'URGELL,32,6,38
2022/2023,25007611,CFA VICTORINA VILA,25120,251207,LLEIDA,8,5,13
2022/2023,25007529,INSTITUT SERÒS,25204,252043,SERÒS,29,19,48
2022/2023,25007517,INSTITUT LA SERRA,25137,251370,MOLLERUSSA,37,20,57
2022/2023,25007505,INSTITUT DE GUISSONA,25110,251109,GUISSONA,48,23,71
2022/2023,25007499,INSTITUT L'OLIVERA,25101,251018,LA GRANADELLA,9,4,13
2022/2023,25007189,INSTITUT MARIA RÚBIES,25120,251207,LLEIDA,44,18,62
2022/2023,25007153,INSTITUT D'ALCARRÀS,25011,250117,ALCARRÀS,53,22,75
2022/2023,25007025,INSTITUT MORELLÓ,25086,250864,ESTERRI D'ÀNEU,6,7,13
2022/2023,25006781,INSTITUT ALFONS COSTAFREDA,25217,252173,TÀRREGA,54,33,87
2022/2023,25006771,INSTITUT RONDA,25120,251207,LLEIDA,77,16,93
2022/2023,25006744,CEE ESPERANÇA,25120,251207,LLEIDA,12,2,14
2022/2023,25006732,INSTITUT TORREVICENS,25120,251207,LLEIDA,118,26,144
2022/2023,25006720,INSTITUT D'HOTELERIA I TURISME,25120,251207,LLEIDA,18,20,38
2022/2023,25006598,INSTITUT LO PLA D'URGELL,25050,250501,BELLPUIG,34,23,57
2022/2023,25006574,INSTITUT DE PONTS,25172,251728,PONTS,21,7,28
2022/2023,25006549,ESCOLA D'ESPLUGA DE SERRA - ZER ALTA RIBAGORÇA,25234,252347,TREMP,1,0,1
2022/2023,25006525,INSTITUT JOSEP VALLVERDÚ,25058,250582,LES BORGES BLANQUES,55,17,72
2022/2023,25006513,INSTITUT MANUEL DE MONTSUAR,25120,251207,LLEIDA,43,13,56
2022/2023,25006501,ESCOLA ALBA,25078,250788,CORBINS,26,3,29
2022/2023,25006495,INSTITUT JOSEP LLADONOSA,25120,251207,LLEIDA,38,22,60
2022/2023,25006483,INSTITUT CANIGÓ,25019,250194,ALMACELLES,31,18,49
2022/2023,25006410,CFA SEGRIÀ,25120,251207,LLEIDA,7,5,12
2022/2023,25006409,ESCOLA JOC DE LA BOLA,25120,251207,LLEIDA,31,3,34
2022/2023,25006291,INSTITUT HUG ROGER III,25209,252094,SORT,30,15,45
2022/2023,25006288,INSTITUT DE TREMP,25234,252347,TREMP,39,25,64
2022/2023,25006276,ESCOLA SANT JORDI,25120,251207,LLEIDA,15,2,17
2022/2023,25006264,ESCOLA ESPIGA,25120,251207,LLEIDA,26,3,29
2022/2023,25006252,EOI DE LLEIDA,25120,251207,LLEIDA,34,7,41
2022/2023,25006240,INSTITUT EL PONT DE SUERT,25173,251734,EL PONT DE SUERT,32,17,49
2022/2023,25006239,INSTITUT D'ARAN,25243,252430,VIELHA E MIJARAN,39,19,58
2022/2023,25006227,INSTITUT D'ALMENAR,25021,250215,ALMENAR,31,18,49
2022/2023,25006148,INSTITUT D'OSTALARIA DE LES-VAL D'ARAN,25121,251214,LES,6,5,11
2022/2023,25006069,ESCOLA D'ARDÈVOL - ZER EL SOLSONÈS,25167,251673,PINÓS,3,0,3
2022/2023,25005983,ESCOLA SANT SERNI - ZER BARIDÀ-BATLLIA,25175,251752,PRATS I SANSOR,5,0,5
2022/2023,25005910,ESCOLA ABAT RUERA - ZER PEDRERA,25180,251804,PUIGGRÒS,4,1,5
2022/2023,25005892,ESCOLA MALDANELL - ZER RIU CORB,25130,251305,MALDÀ,2,1,3
2022/2023,25005880,ESCOLA FREDERIC GODAS,25120,251207,LLEIDA,30,7,37
2022/2023,25005727,INSTITUT ALMATÀ,25040,250404,BALAGUER,53,23,76
2022/2023,25005685,INSTITUT LA SEGARRA,25072,250729,CERVERA,54,25,79
2022/2023,25005673,ESCOLA JOAN MARAGALL,25120,251207,LLEIDA,19,6,25
2022/2023,25005582,INSTITUT TERRES DE PONENT,25137,251370,MOLLERUSSA,50,9,59
2022/2023,25005557,CEE SILOÉ,25137,251370,MOLLERUSSA,10,1,11
2022/2023,25005545,ESCOLA POMPEU FABRA,25137,251370,MOLLERUSSA,32,2,34
2022/2023,25005533,ESCOLA PAU CLARIS,25203,252038,LA SEU D'URGELL,20,3,23
2022/2023,25005454,INSTITUT FRANCESC RIBALTA,25207,252075,SOLSONA,42,21,63
2022/2023,25005442,INSTITUT ESCOLA DEL TREBALL,25120,251207,LLEIDA,52,34,86
2022/2023,25005430,ESCOLA JOAN XXIII,25120,251207,LLEIDA,19,5,24
2022/2023,25005429,INSTITUT ELS PLANELLS,25034,250349,ARTESA DE SEGRE,30,8,38
2022/2023,25005260,INSTITUT RIBERA DEL SIÓ,25003,250030,AGRAMUNT,33,14,47
2022/2023,25005171,ESCOLA MESTRE IGNASI PERAIRE,25137,251370,MOLLERUSSA,27,6,33
2022/2023,25005144,ESCOLA ÀNGEL SERAFÍ I CASANOVAS,25209,252094,SORT,22,1,23
2022/2023,25005120,ESCOLA TERESA BERGADÀ,25016,250169,ALGUAIRE,20,1,21
2022/2023,25005119,ESCOLA PINYANA,25013,250138,ALFARRÀS,19,1,20
2022/2023,25005107,ESCOLA SANT BONIFACI - ZER RIU SET,25255,252555,VINAIXA,2,1,3
2022/2023,25005090,ESCOLA MESTRAL - ZER ARGELAGA,25254,252542,VILANOVA DE LA BARCA,6,2,8
2022/2023,25005077,ESCOLA MOSSÈN TON CLAVÉ - ZER VENT SERÈ,25252,252521,VILA-SANA,7,0,7
2022/2023,25005065,ESCOLA DE VILANOVA DE SEGRIÀ - ZER ALT SEGRIÀ,25251,252516,VILANOVA DE SEGRIÀ,7,1,8
2022/2023,25005053,ESCOLA MARE DE DÉU DEL PUIG DE MEIÀ - ZER EL ROMANÍ,25250,252509,VILANOVA DE MEIÀ,3,0,3
2022/2023,25005016,ESCOLA MARINADA,25248,252483,VILANOVA DE BELLPUIG,14,2,16
2022/2023,25004981,ESCOLA VIDAL I ABAD - ZER ALTA RIBAGORÇA,25245,252458,VILALLER,5,0,5
2022/2023,25004966,ESCOLA RAMON PERELLÓ - ZER GUICIVERVI,25244,252445,VILAGRASSA,6,1,7
2022/2023,25004929,ESCOLA GARONA,25243,252430,VIELHA E MIJARAN,34,5,39
2022/2023,25004863,ESCOLA JARDÍ - ZER GUICIVERVI,25242,252424,VERDÚ,3,3,6
2022/2023,25004851,ESCOLA SALVADOR ESPRIU,25240,252402,VALLFOGONA DE BALAGUER,15,1,16
2022/2023,25004826,ESCOLA DE TUIXENT - ZER URGELLET,25910,259101,JOSA I TUIXÉN,2,0,2
2022/2023,25004772,ESCOLA VALLDEFLORS,25234,252347,TREMP,26,3,29
2022/2023,25004759,ESCOLA EL ROSER - ZER ALT SEGRIÀ,25233,252332,TORRE-SERONA,3,0,3
2022/2023,25004747,ESCOLA CARRASSUMADA,25232,252326,TORRES DE SEGRE,15,1,16
2022/2023,25004723,ESCOLA LA BASSA,25230,252304,TORREGROSSA,15,2,17
2022/2023,25004711,ESCOLA LA CREU,25228,252287,TORREFARRERA,30,4,34
2022/2023,25004656,ESCOLA DE TORREBESSES - ZER L'ERAL,25226,252265,TORREBESSES,2,1,3
2022/2023,25004644,ESCOLA ESPÍGOL - ZER RIU ONDARA,25225,252252,TORNABOUS,7,0,7
2022/2023,25004607,ESCOLA SANT GIL,25223,252234,TORÀ,13,1,14
2022/2023,25004577,ESCOLA DE TÍRVIA - ZER ALT PALLARS SOBIRÀ,25221,252213,TÍRVIA,2,0,2
2022/2023,25004565,ESCOLA ALFRED POTRONY,25220,252206,TÉRMENS,9,2,11
2022/2023,25004531,ESCOLA ÀNGEL GUIMERÀ,25217,252173,TÀRREGA,30,3,33
2022/2023,25004528,EA ONDARA,25217,252173,TÀRREGA,23,12,35
2022/2023,25004498,INSTITUT MANUEL DE PEDROLO,25217,252173,TÀRREGA,35,18,53
2022/2023,25004462,ESCOLA JACINT VERDAGUER,25217,252173,TÀRREGA,33,4,37
2022/2023,25004413,ESCOLA DE SUNYER - ZER L'ERAL,25212,252120,SUNYER,3,0,3
2022/2023,25004401,ESCOLA EL ROSER - ZER LA COMA,25211,252115,SUDANELL,7,1,8
2022/2023,25004395,ESCOLA JAUME MIRET,25210,252108,SOSES,18,0,18
2022/2023,25004243,ESCOLA SETELSIS,25207,252075,SOLSONA,30,5,35
2022/2023,25004231,ESCOLA DEL SOLERÀS - ZER GARRIGUES ALTES,25206,252069,EL SOLERÀS,3,0,3
2022/2023,25004221,ESCOLA EL TIMÓ - ZER PLAURCÉN,25205,252056,SIDAMON,5,1,6
2022/2023,25004218,ESCOLA MIQUEL BARÓ DABAN,25204,252043,SERÒS,17,1,18
2022/2023,25004188,INSTITUT JOAN BRUDIEU,25203,252038,LA SEU D'URGELL,57,33,90
2022/2023,25004140,ESCOLA MOSSÈN ALBERT VIVES,25203,252038,LA SEU D'URGELL,28,5,33
2022/2023,25004115,ESCOLA LA ROCA - ZER L'ERAL,25200,252000,SARROCA DE LLEIDA,3,0,3
2022/2023,25004103,ESCOLA EL TALLAT - ZER RIU CORB,25902,259025,SANT MARTÍ DE RIUCORB,5,1,6
2022/2023,25004085,ESCOLA VALL ONDARA - ZER LA SEGARRA,25905,259059,RIBERA D'ONDARA,4,1,5
2022/2023,25004073,ESCOLA MARE DE DÉU DE LA MERCÈ,25194,251945,SANT RAMON,9,3,12
2022/2023,25004036,ESCOLA L'ESTEL,25192,251924,SANT GUIM DE FREIXENET,12,4,16
2022/2023,25004024,ESCOLA DE SANAÜJA - ZER LA SEGARRA,25191,251919,SANAÜJA,2,1,3
2022/2023,25004000,ESCOLA LA ROSELLA,25189,251898,ROSSELLÓ,22,3,25
2022/2023,25003974,ESCOLA DE FREIXINET DE SOLSONA - ZER EL SOLSONÈS,25186,251863,RINER,3,1,4
2022/2023,25003950,ESCOLA ARNAU MIR - ZER URGELLET,25185,251850,RIBERA D'URGELLET,4,0,4
2022/2023,25003895,ESCOLA ELS MINAIRONS - ZER ALT PALLARS SOBIRÀ,25901,259010,VALL DE CARDÓS,5,0,5
2022/2023,25003871,ESCOLA MONTSENT DE PALLARS - ZER ALT PALLARS SOBIRÀ,25183,251832,RIALP,6,0,6
2022/2023,25003861,ESCOLA SANT JORDI,25182,251826,PUIGVERD DE LLEIDA,11,1,12
2022/2023,25003858,ESCOLA DE PUIGVERD D'AGRAMUNT - ZER EL SIÓ,25181,251811,PUIGVERD D'AGRAMUNT,2,0,2
2022/2023,25003846,ESCOLA EL PUIG - ZER BARIDÀ-BATLLIA,25179,251790,PRULLANS,3,0,3
2022/2023,25003810,ESCOLA DE PREIXENS - ZER EL SIÓ,25177,251771,PREIXENS,3,0,3
2022/2023,25003809,ESCOLA MONTALBÀ - ZER RIU CORB,25176,251765,PREIXANA,3,1,4
2022/2023,25003792,ESCOLA BLANCA DE VILLALONGA - ZER ALT SEGRIÀ,25174,251749,LA PORTELLA,7,0,7
2022/2023,25003755,ESCOLA RIBAGORÇANA,25173,251734,EL PONT DE SUERT,17,1,18
2022/2023,25003718,ESCOLA DE PONTS,25172,251728,PONTS,22,4,26
2022/2023,25003688,ESCOLA ELS RAIERS,25171,251713,LA POBLA DE SEGUR,22,3,25
2022/2023,25003676,ESCOLA ELS SET FOCS - ZER ELAIA,25170,251706,BELLAGUARDA,3,0,3
2022/2023,25003652,ESCOLA EL ROSER - ZER PLAURCÉN,25168,251689,EL POAL,6,0,6
2022/2023,25003627,ESCOLA DE SANT CLIMENÇ - ZER EL SOLSONÈS,25166,251667,PINELL DE SOLSONÈS,3,0,3
2022/2023,25003585,ESCOLA SANT MIQUEL - ZER NARIEDA,25165,251654,PERAMOLA,3,0,3
2022/2023,25003551,ESCOLA RAMON GOMBAL - ZER ESPERNALLAC,25164,251641,PENELLES,3,0,3
2022/2023,25003536,ESCOLA DE LA COMA - ZER EL SOLSONÈS,25163,251636,LA COMA I LA PEDRA,3,0,3
2022/2023,25003500,ESCOLA DE LES PALLARGUES - ZER LA SEGARRA,25911,259118,ELS PLANS DE SIÓ,3,2,5
2022/2023,25003494,ESCOLA ARNAU BERENGUER,25158,251581,EL PALAU D'ANGLESOLA,15,2,17
2022/2023,25003482,ESCOLA LEANDRE CRISTÒFOL - ZER MONTSEC,25156,251569,OS DE BALAGUER,3,1,4
2022/2023,25003470,ESCOLA L'ESPÍGOL - ZER MONTSEC,25156,251569,OS DE BALAGUER,6,0,6
2022/2023,25003469,ESCOLA MIRET I SANS - ZER NARIEDA,25155,251556,ORGANYÀ,6,1,7
2022/2023,25003330,ESCOLA AIGUADORA - ZER EL SOLSONÈS,25146,251462,NAVÈS,4,1,5
2022/2023,25003305,ESCOLA SANT ISIDRE - ZER LA COMA,25142,251425,MONTOLIU DE LLEIDA,2,2,4
2022/2023,25003299,ESCOLA ROSA CAMPÀ,25140,251403,MONTFERRER I CASTELLBÒ,11,2,13
2022/2023,25003275,ESCOLA RIDOLAINA,25139,251399,MONTELLÀ I MARTINET,6,1,7
2022/2023,25003263,ESCOLA PERE SARRET - ZER BARIDÀ-BATLLIA,25139,251399,MONTELLÀ I MARTINET,3,0,3
2022/2023,25003241,ESCOLA COLOMINA - ZER EL ROMANÍ,25138,251386,MONTGAI,3,0,3
2022/2023,25003238,ESCOLA DE BUTSÈNIT - ZER EL SIÓ,25138,251386,MONTGAI,2,0,2
2022/2023,25003202,INSTITUT MOLLERUSSA,25137,251370,MOLLERUSSA,39,40,79
2022/2023,25003147,ESCOLA SANT MIQUEL,25135,251351,MIRALCAMP,13,5,18
2022/2023,25003135,ESCOLA JOAN ROS I PORTA - ZER EL JONC,25134,251348,MENÀRGUENS,6,0,6
2022/2023,25003123,ESCOLA OTOGESA - ZER L'OLIVER,25133,251333,MAIALS,7,1,8
2022/2023,25003111,ESCOLA DE MASSALCOREIG - ZER L'OLIVER,25131,251312,MASSALCOREIG,5,0,5
2022/2023,25003093,ESCOLA DE LLOBERA - ZER EL SOLSONÈS,25129,251291,LLOBERA,4,0,4
2022/2023,25003056,ESCOLA PORTELLA BLANCA - ZER BARIDÀ-BATLLIA,25127,251272,LLES DE CERDANYA,3,1,4
2022/2023,25003032,ESCOLA DE LLAVORSÍ - ZER ALT PALLARS SOBIRÀ,25126,251266,LLAVORSÍ,4,0,4
2022/2023,25003019,ESCOLA ARC D'ADÀ - ZER L'OLIVER,25125,251253,LLARDECANS,2,2,4
2022/2023,25002982,ESCOLA DE LLADURS - ZER EL SOLSONÈS,25124,251240,LLADURS,3,1,4
2022/2023,25002970,ESCOLA EL SITJAR,25122,251229,LINYOLA,24,1,25
2022/2023,25002957,ESCOLA ESTUDI ALEJANDRO CASONA,25121,251214,LES,11,0,11
2022/2023,25002921,ESCOLA EL VILOT - ZER PONENT,25120,251207,LLEIDA,6,1,7
2022/2023,25002854,ESCOLA EL SEGRIÀ - ZER L'HORTA DE LLEIDA,25120,251207,LLEIDA,7,1,8
2022/2023,25002799,INSTITUT CAPARRELLA,25120,251207,LLEIDA,57,81,138
2022/2023,25002787,INSTITUT JOAN ORÓ,25120,251207,LLEIDA,56,24,80
2022/2023,25002726,INSTITUT GUINDÀVOLS,25120,251207,LLEIDA,46,37,83
2022/2023,25002696,INSTITUT MARIUS TORRES,25120,251207,LLEIDA,53,26,79
2022/2023,25002684,INSTITUT SAMUEL GILI I GAYA,25120,251207,LLEIDA,46,15,61
2022/2023,25002672,ESCOLA DE PRÀCTIQUES I,25120,251207,LLEIDA,15,4,19
2022/2023,25002659,ESCOLA SANT JOSEP DE CALASSANÇ,25120,251207,LLEIDA,20,3,23
2022/2023,25002131,ESCOLA CREU DEL BATLLE - ZER L'HORTA DE LLEIDA,25120,251207,LLEIDA,2,1,3
2022/2023,25002121,ESCOLA PRÍNCEP DE VIANA,25120,251207,LLEIDA,17,4,21
2022/2023,25002106,ESCOLA PARDINYES,25120,251207,LLEIDA,19,2,21
2022/2023,25002091,ESCOLA MAGÍ MORERA I GALÍCIA,25120,251207,LLEIDA,14,6,20
2022/2023,25002088,ESCOLA RIU SEGRE,25120,251207,LLEIDA,27,7,34
2022/2023,25002076,ESCOLA LA SEU VELLA,25120,251207,LLEIDA,13,2,15
2022/2023,25002064,ESCOLA CAMPS ELISIS,25120,251207,LLEIDA,20,5,25
2022/2023,25002003,ESCOLA SANTA MARIA DE GARDENY,25120,251207,LLEIDA,22,9,31
2022/2023,25001990,ESCOLA ANTONI BERGÓS - ZER L'HORTA DE LLEIDA,25120,251207,LLEIDA,2,1,3
2022/2023,25001953,ESCOLA ENRIC FARRENY,25120,251207,LLEIDA,14,4,18
2022/2023,25001928,ESCOLA MANUEL ORTIZ I CASTELLÓ,25119,251193,JUNEDA,24,3,27
2022/2023,25001916,ESCOLA L'ESPÍGOL - ZER GARRIGUES ALTES,25118,251180,JUNCOSA,4,0,4
2022/2023,25001886,ESCOLA AESO - ZER PALLARS JUSSÀ,25115,251155,ISONA I CONCA DELLÀ,6,1,7
2022/2023,25001801,ESCOLA MARE DE DÉU DE L'HORTA,25113,251137,IVARS D'URGELL,16,0,16
2022/2023,25001795,ESCOLA SANT SEBASTIÀ - ZER SERRA LLARGA,25112,251121,IVARS DE NOGUERA,3,1,4
2022/2023,25001761,ESCOLA RAMON FAUS I ESTEVE,25110,251109,GUISSONA,35,4,39
2022/2023,25001758,ESCOLA DE GUIMERÀ - ZER GUICIVERVI,25109,251095,GUIMERÀ,2,0,2
2022/2023,25001722,ESCOLA SANT JAUME - ZER L'OLIVER,25102,251023,LA GRANJA D'ESCARP,6,2,8
2022/2023,25001710,ESCOLA DE LA GRANADELLA - ZER ELAIA,25101,251018,LA GRANADELLA,6,0,6
2022/2023,25001709,ESCOLA SANTA MARGARIDA - ZER ALT BERGUEDÀ,25100,251001,GÓSOL,2,1,3
2022/2023,25001692,ESCOLA FRANCESC ARENES,25099,250997,GOLMÉS,16,1,17
2022/2023,25001618,ESCOLA GUILLEM ISARN,25096,250962,LA FULIOLA,16,1,17
2022/2023,25001606,ESCOLA MINYONS D'URGELL,25093,250931,FONDARELLA,12,2,14
2022/2023,25001539,ESCOLA LA CLOSA,25086,250864,ESTERRI D'ÀNEU,14,2,16
2022/2023,25001473,ESCOLA PORCEL DE CERVERA - ZER PEDRERA,25081,250812,L'ESPLUGA CALBA,3,0,3
2022/2023,25001436,ESCOLA SOL NAIXENT - ZER EL ROMANÍ,25079,250791,CUBELLS,2,1,3
2022/2023,25001424,ESCOLA SOL IXENT,25078,250788,CORBINS,13,3,16
2022/2023,25001400,ESCOLA SANT CLIMENT - ZER NARIEDA,25077,250772,COLL DE NARGÓ,4,1,5
2022/2023,25001357,ESCOLA DE CIUTADILLA - ZER GUICIVERVI,25074,250740,CIUTADILLA,2,0,2
2022/2023,25001333,ESCOLA EL CÉRVOL - ZER RIU SET,25073,250735,CERVIÀ DE LES GARRIGUES,5,0,5
2022/2023,25001321,ESCOLA MOSSÈN JOSEP ARQUES,25072,250729,CERVERA,26,5,31
2022/2023,25001311,INSTITUT ANTONI TORROJA,25072,250729,CERVERA,30,15,45
2022/2023,25001291,ESCOLA JAUME BALMES,25072,250729,CERVERA,28,2,30
2022/2023,25001281,ESCOLA EL TERRALL - ZER ESPERNALLAC,25070,250707,CASTELLSERÀ,8,0,8
2022/2023,25001278,ESCOLA SANTA MARIA - ZER SERRA LLARGA,25069,250693,CASTELLÓ DE FARFANYA,2,1,3
2022/2023,25001266,ESCOLA L'ESTEL - ZER VENT SERÈ,25068,250680,CASTELLNOU DE SEANA,5,1,6
2022/2023,25001254,ESCOLA TIMORELL - ZER VALL DE L'ARANYÓ,25067,250674,CASTELLDANS,5,1,6
2022/2023,25001242,ESCOLA CASTELL-CIUTAT - ZER URGELLET,25203,252038,LA SEU D'URGELL,4,0,4
2022/2023,25001229,ESCOLA DOS RIUS - ZER EL JONC,25062,250621,CAMARASA,5,1,6
2022/2023,25001199,ESCOLA SANT RÒC,25059,250595,BOSSÒST,11,1,12
2022/2023,25001141,ESCOLA JOAN XXIII,25058,250582,LES BORGES BLANQUES,24,9,33
2022/2023,25001138,ESCOLA CASTETH LEON - ZER VAL D'ARAN,25057,250576,ES BÒRDES,4,0,4
2022/2023,25001126,ESCOLA VALLMAJOR - ZER ELAIA,25056,250560,BOVERA,2,1,3
2022/2023,25001096,ESCOLA SANT JOAN,25053,250539,BENAVENT DE SEGRIÀ,13,1,14
2022/2023,25001084,ESCOLA JOAQUIM PALACÍN,25052,250523,BELLVÍS,14,3,17
2022/2023,25001059,ESCOLA MARE DE DÉU DE TALLÓ,25051,250518,BELLVER DE CERDANYA,16,0,16
2022/2023,25001011,ESCOLA VALERI SERRA,25050,250501,BELLPUIG,21,2,23
2022/2023,25001001,ESCOLA SANT BARTOMEU - ZER ESPERNALLAC,25049,250498,BELLMUNT D'URGELL,1,1,2
2022/2023,25000985,ESCOLA RAMON FARRERONS,25048,250485,BELL-LLOC D'URGELL,16,1,17
2022/2023,25000961,ESCOLA BONAVISTA,25047,250479,BELLCAIRE D'URGELL,12,1,13
2022/2023,25000951,ESCOLA PERE TEIXINÉ - ZER RIU CORB,25046,250463,BELIANES,3,1,4
2022/2023,25000869,ESCOLA SANT ROC - ZER RIU ONDARA,25041,250411,BARBENS,6,1,7
2022/2023,25000857,ESCOLA LA NOGUERA,25040,250404,BALAGUER,14,3,17
2022/2023,25000833,INSTITUT CIUTAT DE BALAGUER,25040,250404,BALAGUER,41,19,60
2022/2023,25000781,ESCOLA ÀNGEL GUIMERÀ,25040,250404,BALAGUER,17,2,19
2022/2023,25000778,ESCOLA GASPAR DE PORTOLÀ,25040,250404,BALAGUER,30,4,34
2022/2023,25000730,ESCOLA FRANCESC FELIU,25038,250387,AITONA,23,7,30
2022/2023,25000717,ESCOLA DE TARTAREU - ZER MONTSEC,25037,250371,LES AVELLANES I SANTA LINYA,1,1,2
2022/2023,25000699,ESCOLA DE LES AVELLANES - ZER MONTSEC,25037,250371,LES AVELLANES I SANTA LINYA,3,1,4
2022/2023,25000675,ESCOLA MARE DE DÉU DE LA GUARDIOLA - ZER EL ROMANÍ,25035,250352,LA SENTIU DE SIÓ,3,0,3
2022/2023,25000638,ESCOLA ELS PLANELLS,25034,250349,ARTESA DE SEGRE,29,2,31
2022/2023,25000626,ESCOLA ELS TIL.LERS,25033,250334,ARTESA DE LLEIDA,9,5,14
2022/2023,25000602,ESCOLA ALBIRKA,25029,250292,ARBECA,14,2,16
2022/2023,25000584,ESCOLA SANTA CREU,25027,250273,ANGLESOLA,15,2,17
2022/2023,25000560,ESCOLA RUDA - ZER VAL D'ARAN,25025,250254,NAUT ARAN,8,0,8
2022/2023,25000559,ESCOLA SANT MARTÍ - ZER VAL D'ARAN,25025,250254,NAUT ARAN,3,0,3
2022/2023,25000535,ESCOLA LOSERON - ZER VAL D'ARAN,25025,250254,NAUT ARAN,6,0,6
2022/2023,25000511,ESCOLA INOCENCIO PARDOS - ZER PONENT,25912,259123,GIMENELLS I EL PLA DE LA FONT,3,0,3
2022/2023,25000481,ESCOLA SANT ISIDRE - ZER PONENT,25912,259123,GIMENELLS I EL PLA DE LA FONT,5,0,5
2022/2023,25000468,ESCOLA DOCTOR SERÉS,25023,250236,ALPICAT,29,4,33
2022/2023,25000341,ESCOLA ANTÒNIA SIMÓ ARNÓ,25019,250194,ALMACELLES,34,6,40
2022/2023,25000316,ESCOLA D'ALINS - ZER ALT PALLARS SOBIRÀ,25017,250175,ALINS,2,0,2
2022/2023,25000286,ESCOLA SANT BLAI - ZER SERRA LLARGA,25015,250156,ALGERRI,3,1,4
2022/2023,25000274,ESCOLA D'ALFÉS - ZER L'ERAL,25014,250143,ALFÉS,3,0,3
2022/2023,25000225,ESCOLA MARE DE DÉU DEL CARME,25012,250122,ALCOLETGE,24,6,30
2022/2023,25000195,ESCOLA COMTES DE TORREGROSSA,25011,250117,ALCARRÀS,32,8,40
2022/2023,25000183,ESCOLA LA DULA - ZER L'ERAL,25010,250100,ALCANÓ,3,0,3
2022/2023,25000171,ESCOLA ELS AUBIS - ZER RIU SET,25009,250096,L'ALBI,5,1,6
2022/2023,25000161,ESCOLA L'ÀLBER,25008,250083,ALBESA,12,3,15
2022/2023,25000158,ESCOLA SANT SALVADOR,25007,250077,ALBATÀRREC,16,1,17
2022/2023,25000146,ESCOLA MARE DE DÉU DE MONTSERRAT - ZER VALL DE L'ARANYÓ,25006,250061,L'ALBAGÉS,3,0,3
2022/2023,25000122,ESCOLA SANT ESTEVE - ZER URGELLET,25005,250058,ALÀS I CERC,3,0,3
2022/2023,25000110,ESCOLA ARRELS - ZER L'HORTA DE LLEIDA,25004,250045,ELS ALAMÚS,6,0,6
2022/2023,25000067,ESCOLA MACIÀ-COMPANYS,25003,250030,AGRAMUNT,25,4,29
2022/2023,25000031,ESCOLA ANDREU FARRAN - ZER MONTSEC,25002,250024,ÀGER,1,3,4
2022/2023,17010931,ESCOLA LES CURCULLES-ZER EMPORDÀ,17119,171194,PALAU DE SANTA EULÀLIA,2,0,2
2022/2023,17010921,INSTITUT ESCOLA MONTSENY,17027,170274,BREDA,43,11,54
2022/2023,17010840,INSTITUT LA SUREDA,17117,171175,PALAFRUGELL,17,8,25
2022/2023,17010839,INSTITUT DE PERALADA,17132,171328,PERALADA,13,5,18
2022/2023,17010827,INSTITUT ESCOLA GREDA,17114,171143,OLOT,40,4,44
2022/2023,17010815,INSTITUT ESCOLA VILA-ROMÀ,17118,171181,PALAMÓS,38,11,49
2022/2023,17010803,INSTITUT ESCOLA VALL DE RIBES,17145,171450,RIBES DE FRESER,23,5,28
2022/2023,17010797,INSTITUT ESCOLA CARITAT SERINYANA - CAP DE CREUS,17032,170329,CADAQUÉS,26,7,33
2022/2023,17010700,INSTITUT SANT QUIRZE,17095,170950,LLORET DE MAR,15,11,26
2022/2023,17010694,INSTITUT ESCOLA EL BRUEL-EMPURIABRAVA,17047,170470,CASTELLÓ D'EMPÚRIES,35,10,45
2022/2023,17010682,INSTITUT DE SARRIÀ DE TER,17186,171864,SARRIÀ DE TER,28,22,50
2022/2023,17010451,CFA TRAMUNTANA,17066,170669,FIGUERES,12,7,19
2022/2023,17010441,CFA NOU GIRONA,17079,170792,GIRONA,6,5,11
2022/2023,17010414,INSTITUT ERMESSENDA DE GIRONA,17079,170792,GIRONA,40,17,57
2022/2023,17010189,INSTITUT VALL DE LLÉMENA,17163,171637,SANT GREGORI,26,13,39
2022/2023,17010049,ESCOLA BALANDRAU,17079,170792,GIRONA,16,2,18
2022/2023,17010037,INSTITUT EL BRUC,17146,171463,RIELLS I VIABREA,13,6,19
2022/2023,17009898,INSTITUT ESCOLA LLORET DE MAR,17095,170950,LLORET DE MAR,55,13,68
2022/2023,17009850,ESCOLA LES ARRELS,17155,171557,SALT,35,5,40
2022/2023,17009813,INSTITUT ESCOLA MESTRE ANDREU,17167,171674,SANT JOAN DE LES ABADESSES,38,6,44
2022/2023,17009801,INSTITUT ESCOLA SALVADOR VILARRASA,17019,170195,BESALÚ,35,12,47
2022/2023,17009795,INSTITUT ESCOLA FRANCESC CAMBÓ I BATLLE,17211,172116,VERGES,32,12,44
2022/2023,17009783,INSTITUT LA MIQUELA,17020,170209,BESCANÓ,26,11,37
2022/2023,17009710,ESCOLA EMPORDANET,17022,170221,LA BISBAL D'EMPORDÀ,19,0,19
2022/2023,17009631,ZER CAP DE CREUS,17140,171404,EL PORT DE LA SELVA,3,2,5
2022/2023,17009473,ZER EMPORDANET-GAVARRES,17130,171306,LA PERA,5,0,5
2022/2023,17009345,ESCOLA CAMINS,17015,170157,BANYOLES,18,1,19
2022/2023,17009308,INSTITUT DE SILS,17193,171931,SILS,27,12,39
2022/2023,17009278,ESCOLA FANALS D'ARO,17048,170486,CASTELL-PLATJA D'ARO,14,3,17
2022/2023,17009242,ESCOLA NOU DE QUART,17142,171426,QUART,16,1,17
2022/2023,17009205,INSTITUT DE VILABLAREIX,17215,172155,VILABLAREIX,39,23,62
2022/2023,17009199,ESCOLA ELS ESTANYS,17193,171931,SILS,12,4,16
2022/2023,17009138,ESCOLA PUIG DE LES CADIRETES,17089,170890,LLAGOSTERA,27,4,31
2022/2023,17009126,ESCOLA EL BOSC DE LA PABORDIA,17079,170792,GIRONA,28,2,30
2022/2023,17008997,ESCOLA FORALLAC,17902,179026,FORALLAC,12,3,15
2022/2023,17008951,INSTITUT MAÇANET DE LA SELVA,17103,171030,MAÇANET DE LA SELVA,26,12,38
2022/2023,17008894,ESCOLA ALZINES BALLADORES,17159,171595,SANT FELIU DE BUIXALLEU,13,2,15
2022/2023,17008882,ESCOLA LA BÒBILA,17139,171390,LES PRESES,16,0,16
2022/2023,17008821,EOI DE BANYOLES,17015,170157,BANYOLES,4,1,5
2022/2023,17008808,ESCOLA CARME GUASCH I DARNÉ,17066,170669,FIGUERES,29,2,31
2022/2023,17008781,ESCOLA LA BENAULA,17033,170335,CALDES DE MALAVELLA,17,1,18
2022/2023,17008778,ESCOLA EL MORROT,17114,171143,OLOT,16,3,19
2022/2023,17008687,ESCOLA LES DEVESES,17155,171557,SALT,30,8,38
2022/2023,17008675,ESCOLA PERICOT,17079,170792,GIRONA,25,9,34
2022/2023,17008651,INSTITUT DE CALDES DE MALAVELLA,17033,170335,CALDES DE MALAVELLA,27,13,40
2022/2023,17008641,ESCOLA DE CABANES,17030,170307,CABANES,9,2,11
2022/2023,17008547,ESCOLA LES ARRELS,17103,171030,MAÇANET DE LA SELVA,16,3,19
2022/2023,17008523,ESCOLA PI VERD,17117,171175,PALAFRUGELL,30,6,36
2022/2023,17008501,ESCOLA ALDRIC,17044,170448,CASSÀ DE LA SELVA,29,1,30
2022/2023,17008493,ESCOLA VALL-LLOBREGA,17209,172095,VALL-LLOBREGA,14,0,14
2022/2023,17008481,ESCOLA L'ESCULAPI,17062,170622,L'ESCALA,16,5,21
2022/2023,17008471,ESCOLA LES FALGUERES,17049,170499,CELRÀ,30,0,30
2022/2023,17008468,ESCOLA LA SÍNIA,17034,170340,CALONGE I SANT ANTONI,15,2,17
2022/2023,17008444,ESCOLA PARC DE LES AIGÜES,17066,170669,FIGUERES,27,7,34
2022/2023,17008419,ESCOLA LLUMS DEL NORD,17141,171411,PUIGCERDÀ,15,3,18
2022/2023,17008407,INSTITUT SALVADOR SUNYER I AIMERIC,17155,171557,SALT,37,11,48
2022/2023,17008390,INSTITUT DE VILAFANT,17221,172214,VILAFANT,37,16,53
2022/2023,17008389,CFA LA SELVA,17180,171805,SANTA COLOMA DE FARNERS,5,3,8
2022/2023,17008377,CFA RIPOLLÈS,17147,171479,RIPOLL,2,1,3
2022/2023,17008365,CFA PLA DE L'ESTANY,17015,170157,BANYOLES,6,3,9
2022/2023,17008298,ESCOLA EL GEGANT DEL REC,17155,171557,SALT,33,5,38
2022/2023,17008286,ESCOLA DOMENY,17079,170792,GIRONA,31,1,32
2022/2023,17008274,ESCOLA SA FORCANERA,17023,170237,BLANES,29,3,32
2022/2023,17008249,ESCOLA CASTELL DE FARNERS,17180,171805,SANTA COLOMA DE FARNERS,33,3,36
2022/2023,17008237,ESCOLA MONTSERRAT VAYREDA,17152,171523,ROSES,25,3,28
2022/2023,17008146,CFA PALAFRUGELL,17117,171175,PALAFRUGELL,5,3,8
2022/2023,17008134,EOI DE FIGUERES,17066,170669,FIGUERES,8,2,10
2022/2023,17008122,EOI DE BLANES,17023,170237,BLANES,7,2,9
2022/2023,17008110,EOI DE SANT FELIU DE GUÍXOLS,17160,171609,SANT FELIU DE GUÍXOLS,6,2,8
2022/2023,17008080,ESCOLA ÀNGELS ALEMANY I BORIS,17095,170950,LLORET DE MAR,44,6,50
2022/2023,17008018,ESCOLA ARDENYA,17160,171609,SANT FELIU DE GUÍXOLS,28,1,29
2022/2023,17008006,ESCOLA AMISTAT,17066,170669,FIGUERES,27,3,30
2022/2023,17007981,EOI D'OLOT,17114,171143,OLOT,7,2,9
2022/2023,17007919,ESCOLA MAS MASÓ,17155,171557,SALT,36,4,40
2022/2023,17007907,ESCOLA JOANA D'EMPÚRIES,17047,170470,CASTELLÓ D'EMPÚRIES,23,6,29
2022/2023,17007828,ESCOLA PINYA DE ROSA,17023,170237,BLANES,30,3,33
2022/2023,17007695,ZER EMPORDÀ,17228,172288,VILANANT,5,1,6
2022/2023,17007671,CFA LA GARROTXA,17114,171143,OLOT,6,6,12
2022/2023,17007658,CFA SANT FELIU DE GUÍXOLS,17160,171609,SANT FELIU DE GUÍXOLS,8,2,10
2022/2023,17007609,INSTITUT OLIVAR GRAN,17066,170669,FIGUERES,55,37,92
2022/2023,17007531,ZER MONTGRÍ,17018,170182,BELLCAIRE D'EMPORDÀ,5,0,5
2022/2023,17007518,ZER LES SALINES,17001,170010,AGULLANA,4,1,5
2022/2023,17007488,ZER REQUESENS,17042,170427,CAPMANY,5,0,5
2022/2023,17007464,ZER COMTE ARNAU,17170,171707,VALLFOGONA DE RIPOLLÈS,0,3,3
2022/2023,17007452,ZER EL LLIERCA,17200,172001,TORTELLÀ,4,1,5
2022/2023,17007440,ZER VALL DE TER,17177,171772,SANT PAU DE SEGÚRIES,5,1,6
2022/2023,17007439,ZER CERDANYA,17094,170947,LLÍVIA,7,0,7
2022/2023,17007427,ZER TRAMUNTANA,17210,172109,VENTALLÓ,5,1,6
2022/2023,17007300,INSTITUT LA BISBAL,17022,170221,LA BISBAL D'EMPORDÀ,71,35,106
2022/2023,17007181,CFA GIRONA,17079,170792,GIRONA,13,5,18
2022/2023,17007178,CFA MARIA VERDAGUER,17066,170669,FIGUERES,8,3,11
2022/2023,17007129,CFA ES PITEUS,17023,170237,BLANES,8,6,14
2022/2023,17007014,CFA LLORET DE MAR,17095,170950,LLORET DE MAR,7,2,9
2022/2023,17006952,ESCOLA LA DRAGA,17015,170157,BANYOLES,28,2,30
2022/2023,17006940,ESCOLA DE LLIURONA,17003,170031,ALBANYÀ,2,1,3
2022/2023,17006939,INSTITUT SANTA EUGÈNIA,17079,170792,GIRONA,71,62,133
2022/2023,17006873,ESCOLA CASTELLUM,17169,171693,SANT JULIÀ DE RAMIS,21,3,24
2022/2023,17006851,INSTITUT ILLA DE RODES,17152,171523,ROSES,47,31,78
2022/2023,17006836,ESCOLA LES MÈLIES,17221,172214,VILAFANT,25,5,30
2022/2023,17006824,INSTITUT VIDRERES,17213,172137,VIDRERES,39,26,65
2022/2023,17006812,INSTITUT DE TOSSA DE MAR,17202,172023,TOSSA DE MAR,24,12,36
2022/2023,17006800,ESCOLA ELS GRECS,17152,171523,ROSES,24,3,27
2022/2023,17006782,ESCOLA CARRILET,17117,171175,PALAFRUGELL,32,5,37
2022/2023,17006770,INSTITUT ROCAGROSSA,17095,170950,LLORET DE MAR,39,40,79
2022/2023,17006769,INSTITUT DE LLANÇÀ,17092,170926,LLANÇÀ,33,18,51
2022/2023,17006757,INSTITUT DE LLAGOSTERA,17089,170890,LLAGOSTERA,31,21,52
2022/2023,17006745,INSTITUT DE LA JONQUERA,17086,170865,LA JONQUERA,30,10,40
2022/2023,17006733,INSTITUT VESCOMTAT DE CABRERA,17083,170834,HOSTALRIC,37,21,58
2022/2023,17006721,ESCOLA MARTA MATA,17079,170792,GIRONA,27,4,31
2022/2023,17006711,ESCOLA M. ÀNGELS ANGLADA,17066,170669,FIGUERES,16,3,19
2022/2023,17006708,INSTITUT DE CELRÀ,17049,170499,CELRÀ,44,21,65
2022/2023,17006691,INSTITUT RIDAURA,17048,170486,CASTELL-PLATJA D'ARO,52,15,67
2022/2023,17006681,INSTITUT GERMANS VILA-RIERA,17039,170391,CAMPRODON,16,6,22
2022/2023,17006666,INSTITUT PLA DE L'ESTANY,17015,170157,BANYOLES,58,29,87
2022/2023,17006605,INSTITUT MONTSORIU,17009,170097,ARBÚCIES,39,19,58
2022/2023,17006083,INSTITUT CASTELLÓ D'EMPÚRIES,17047,170470,CASTELLÓ D'EMPÚRIES,48,25,73
2022/2023,17005923,INSTITUT MONTGRÍ,17199,171997,TORROELLA DE MONTGRÍ,49,27,76
2022/2023,17005911,INSTITUT RAMON COLL I RODÉS,17095,170950,LLORET DE MAR,56,37,93
2022/2023,17005893,INSTITUT BOSC DE LA COMA,17114,171143,OLOT,52,41,93
2022/2023,17005741,INSTITUT PERE BORRELL,17141,171411,PUIGCERDÀ,64,25,89
2022/2023,17005731,INSTITUT S'AGULLA,17023,170237,BLANES,48,25,73
2022/2023,17005704,INSTITUT ABAT OLIBA,17147,171479,RIPOLL,56,35,91
2022/2023,17005662,INSTITUT SERRALLARGA,17023,170237,BLANES,70,50,120
2022/2023,17005650,INSTITUT DE CASSÀ DE LA SELVA,17044,170448,CASSÀ DE LA SELVA,47,19,66
2022/2023,17005649,INSTITUT CENDRASSOS,17066,170669,FIGUERES,66,40,106
2022/2023,17005522,ESCOLA VEÏNAT,17155,171557,SALT,22,1,23
2022/2023,17005388,INSTITUT VALLVERA,17155,171557,SALT,87,24,111
2022/2023,17005376,INSTITUT DE SANTA COLOMA DE FARNERS,17180,171805,SANTA COLOMA DE FARNERS,77,36,113
2022/2023,17005364,INSTITUT CAP NORFEU,17152,171523,ROSES,48,22,70
2022/2023,17005352,INSTITUT DE PALAMÓS,17118,171181,PALAMÓS,56,34,90
2022/2023,17005340,EA D'OLOT,17114,171143,OLOT,34,13,47
2022/2023,17005339,CFA LES BERNARDES,17155,171557,SALT,14,6,20
2022/2023,17005261,ESCOLA MONTPALAU - ZER EL LLIERCA,17010,170101,ARGELAGUER,2,2,4
2022/2023,17005251,INSTITUT EL PEDRÓ,17062,170622,L'ESCALA,42,26,68
2022/2023,17005248,ESCOLA MAS CLARÀ,17022,170221,LA BISBAL D'EMPORDÀ,24,5,29
2022/2023,17005182,ESCOLA CAN PUIG,17015,170157,BANYOLES,26,5,31
2022/2023,17005042,INSTITUT CARLES RAHOLA I LLORENS,17079,170792,GIRONA,40,21,61
2022/2023,17005029,ESCOLA L'ESQUIROL - ZER VALL DE TER,17112,171122,OGASSA,3,0,3
2022/2023,17005017,ESCOLA QUATRE VENTS,17023,170237,BLANES,26,5,31
2022/2023,17004955,ESCOLA POMPEU FABRA,17095,170950,LLORET DE MAR,36,10,46
2022/2023,17004943,ESCOLA MONTFALGARS,17079,170792,GIRONA,30,3,33
2022/2023,17004906,ESCOLA SALVADOR ESPRIU,17213,172137,VIDRERES,27,3,30
2022/2023,17004891,ESCOLA JOSEP PALLACH,17066,170669,FIGUERES,32,5,37
2022/2023,17004888,ESCOLA SANTA CECÍLIA - ZER CERDANYA,17024,170242,BOLVIR,4,1,5
2022/2023,17004876,ESCOLA L'OLIVAR VELL,17013,170139,BEGUR,10,2,12
2022/2023,17004864,ESCOLA EL PLA,17155,171557,SALT,32,9,41
2022/2023,17004852,EOI DE GIRONA,17079,170792,GIRONA,35,6,41
2022/2023,17004827,ESCOLA ALZINA RECLAMADORA,17071,170715,FONTCOBERTA,15,1,16
2022/2023,17004761,CEE DOCTOR RAMON SURIÑACH,17147,171479,RIPOLL,9,0,9
2022/2023,17004751,ESCOLA TOMÀS RAGUER,17147,171479,RIPOLL,17,1,18
2022/2023,17004748,CEE MARE DE DÉU DEL MONT,17221,172214,VILAFANT,30,4,34
2022/2023,17004736,CEE ELS ÀNGELS,17118,171181,PALAMÓS,28,2,30
2022/2023,17004724,CEE PALAU,17079,170792,GIRONA,16,2,18
2022/2023,17004712,CEE VENTIJOL,17023,170237,BLANES,33,2,35
2022/2023,17004694,ESCOLA CASSIÀ COSTAL,17079,170792,GIRONA,28,3,31
2022/2023,17004682,ESCOLA L'ESTACIÓ,17160,171609,SANT FELIU DE GUÍXOLS,28,3,31
2022/2023,17004657,ESCOLA ESTEVE CARLES,17095,170950,LLORET DE MAR,21,4,25
2022/2023,17004578,INSTITUT CASTELL D'ESTELA,17007,170078,AMER,22,11,33
2022/2023,17004566,ESCOLA NAPOLEÓ SOLIVA,17023,170237,BLANES,21,3,24
2022/2023,17004530,INSTITUT SANTIAGO SOBREQUÉS I VIDAL,17079,170792,GIRONA,50,22,72
2022/2023,17004529,ESCOLA MIGDIA,17079,170792,GIRONA,28,4,32
2022/2023,17004517,INSTITUT ANTON BUSQUETS I PUNSET,17164,171642,SANT HILARI SACALM,27,9,36
2022/2023,17004499,INSTITUT NARCÍS XIFRA I MASMITJÀ,17079,170792,GIRONA,114,57,171
2022/2023,17004487,INSTITUT RAFAEL CAMPALANS,17008,170084,ANGLÈS,37,25,62
2022/2023,17004463,ESCOLA ANICET DE PAGÈS I DE PUIG,17066,170669,FIGUERES,28,7,35
2022/2023,17004451,ESCOLA JAUME VICENS I VIVES,17152,171523,ROSES,23,4,27
2022/2023,17004438,INSTITUT ALEXANDRE DEULOFEU,17066,170669,FIGUERES,56,27,83
2022/2023,17004360,CEE LA MAÇANA,17155,171557,SALT,9,0,9
2022/2023,17004347,ESCOLA FONT DE LA PÓLVORA,17079,170792,GIRONA,7,1,8
2022/2023,17004335,ESCOLA SANTA EUGÈNIA,17079,170792,GIRONA,17,1,18
2022/2023,17004293,ESCOLA MANUEL DE PEDROLO - ZER LES SALINES,17234,172348,BIURE,4,0,4
2022/2023,17004281,ESCOLA JOSEP MADRENYS,17233,172333,VILOBÍ D'ONYAR,23,3,26
2022/2023,17004244,ESCOLA TRAMUNTANA - ZER EMPORDÀ,17228,172288,VILANANT,3,0,3
2022/2023,17004232,ESCOLA JOSEP DE RIBOT I OLIVAS,17226,172266,VILAMALLA,16,1,17
2022/2023,17004220,ESCOLA ELS VALENTINS - ZER TRAMUNTANA,17225,172253,VILAMACOLUM,2,3,5
2022/2023,17004219,ESCOLA LA DAINA - ZER VALL DE TER,17224,172240,VILALLONGA DE TER,3,0,3
2022/2023,17004207,ESCOLA SANTIAGO RATÉS,17223,172235,VILAJUÏGA,11,1,12
2022/2023,17004190,ESCOLA SOL I VENT,17221,172214,VILAFANT,15,1,16
2022/2023,17004189,ESCOLA ELS CASTANYERS - ZER GUILLERIES,17220,172207,VILADRAU,9,0,9
2022/2023,17004153,ESCOLA DE SANT ESTEVE DE GUIALBES,17218,172180,VILADEMULS,10,4,14
2022/2023,17004128,ESCOLA PUIG SEGALAR - ZER TRAMUNTANA,17217,172174,VILADAMAT,4,1,5
2022/2023,17004116,ESCOLA MADRENC,17215,172155,VILABLAREIX,27,2,29
2022/2023,17004098,ESCOLA TORRE D'EN REIG,17214,172142,VILABERTRAN,15,1,16
2022/2023,17004074,ESCOLA SANT ISCLE,17213,172137,VIDRERES,16,3,19
2022/2023,08030285,ESCOLA AURÓ,08279,082798,TERRASSA,16,3,19
2022/2023,17004062,ESCOLA SANTA BÀRBARA - ZER ELS CASTELLS,17212,172121,VIDRÀ,2,0,2
2022/2023,17004049,ESCOLA OLIVERES MIL·LENÀRIES - ZER TRAMUNTANA,17210,172109,VENTALLÓ,7,0,7
2022/2023,17004001,ESCOLA VERNTALLAT,17207,172076,LA VALL D'EN BAS,21,1,22
2022/2023,17003951,PARVULARI DE SANT ESTEVE D'EN BAS,17207,172076,LA VALL D'EN BAS,4,0,4
2022/2023,17003941,ESCOLA L'ESTANY - ZER EMPORDANET-GAVARRES,17205,172057,ULLASTRET,4,0,4
2022/2023,17003938,ESCOLA PUIG RODÓ - ZER MONTGRÍ,17204,172044,ULLÀ,7,0,7
2022/2023,17003926,ESCOLA IGNASI MELÉ I FARRÉ,17202,172023,TOSSA DE MAR,29,4,33
2022/2023,17003902,ESCOLA JOAN ROURA I PARELLA - ZER EL LLIERCA,17200,172001,TORTELLÀ,4,3,7
2022/2023,17003872,ESCOLA GUILLEM DE MONTGRÍ,17199,171997,TORROELLA DE MONTGRÍ,37,6,43
2022/2023,17003860,ESCOLA PORTITXOL,17199,171997,TORROELLA DE MONTGRÍ,25,3,28
2022/2023,17003823,ESCOLA VERDAGUER,17193,171931,SILS,25,5,30
2022/2023,17003801,ESCOLA BORA GRAN,17190,171903,SERINYÀ,12,3,15
2022/2023,17003781,ESCOLA JUNCADELLA,17189,171899,LA CELLERA DE TER,14,3,17
2022/2023,17003768,ESCOLA ELS TERRAPRIMS,17187,171870,"SAUS, CAMALLERA I LLAMPAIES",14,1,15
2022/2023,17003756,ESCOLA MONTSERRAT,17186,171864,SARRIÀ DE TER,28,3,31
2022/2023,17003732,ESCOLA CASTANYER,17185,171851,SANT JOAN LES FONTS,17,6,23
2022/2023,17003719,ESCOLA JOAN MARAGALL,17184,171848,SANTA PAU,13,2,15
2022/2023,17003689,ESCOLA PEDRALTA,17181,171812,SANTA CRISTINA D'ARO,24,7,31
2022/2023,17003641,ESCOLA SANT SALVADOR D'HORTA,17180,171805,SANTA COLOMA DE FARNERS,34,4,38
2022/2023,17003631,ESCOLA LA PEDRA DRETA - ZER EMPORDANET-GAVARRES,17901,179011,"CRUÏLLES, MONELLS I SANT SADURNÍ L'HEURA",4,1,5
2022/2023,17003628,ESCOLA LLAGUT,17178,171788,SANT PERE PESCADOR,15,5,20
2022/2023,17003616,ESCOLA ELS PINETS - ZER VALL DE TER,17177,171772,SANT PAU DE SEGÚRIES,7,0,7
2022/2023,17003598,ESCOLA VALLGARRIGA,17175,171753,SANT MIQUEL DE FLUVIÀ,9,2,11
2022/2023,17003537,ESCOLA DE VALLFOGONA DE RIPOLLÈS - ZER COMTE ARNAU,17170,171707,VALLFOGONA DE RIPOLLÈS,2,0,2
2022/2023,17003471,ESCOLA SANT JORDI,17166,171668,SANT JORDI DESVALLS,10,2,12
2022/2023,17003461,ESCOLA LES ESCOMES,17165,171655,SANT JAUME DE LLIERCA,12,3,15
2022/2023,17003434,ESCOLA GUILLERIES,17164,171642,SANT HILARI SACALM,26,4,30
2022/2023,17003422,ESCOLA TAIALÀ,17079,170792,GIRONA,31,3,34
2022/2023,17003392,ESCOLA AGUSTÍ GIFRE,17163,171637,SANT GREGORI,31,9,40
2022/2023,17003343,ESCOLA ROCALBA,17161,171616,SANT FELIU DE PALLEROLS,12,3,15
2022/2023,17003321,ESCOLA MOSSÈN BALDIRI REIXACH,17160,171609,SANT FELIU DE GUÍXOLS,27,4,31
2022/2023,17003318,INSTITUT DE SANT FELIU DE GUÍXOLS,17160,171609,SANT FELIU DE GUÍXOLS,69,37,106
2022/2023,17003306,INSTITUT SANT ELM,17160,171609,SANT FELIU DE GUÍXOLS,34,17,51
2022/2023,17003264,ESCOLA GAZIEL,17160,171609,SANT FELIU DE GUÍXOLS,21,8,29
2022/2023,17003227,ESCOLA SANT SEBASTIÀ - ZER REQUESENS,17158,171582,SANT CLIMENT SESCEBES,6,0,6
2022/2023,17003215,ESCOLA LA FARGA,17155,171557,SALT,34,6,40
2022/2023,17003203,INSTITUT SALVADOR ESPRIU,17155,171557,SALT,59,32,91
2022/2023,17003151,ESCOLA SILVESTRE SANTALÓ,17155,171557,SALT,18,4,22
2022/2023,17003136,ESCOLA NARCÍS MONTURIOL,17152,171523,ROSES,15,4,19
2022/2023,17003094,ESCOLA DE RIUDELLOTS DE LA SELVA,17150,171501,RIUDELLOTS DE LA SELVA,15,1,16
2022/2023,17003082,ESCOLA LLUÍS CASTELLS,17149,171498,RIUDAURA,11,1,12
2022/2023,17003070,ESCOLA JOSEP BOADA,17148,171485,RIUDARENES,16,1,17
2022/2023,17002995,ESCOLA JOAN MARAGALL,17147,171479,RIPOLL,23,2,25
2022/2023,17002983,ESCOLA EL BRUC,17146,171463,RIELLS I VIABREA,16,3,19
2022/2023,17002922,ESCOLA SANTA MARGARIDA,17142,171426,QUART,19,0,19
2022/2023,17002880,ESCOLA ALFONS I,17141,171411,PUIGCERDÀ,25,7,32
2022/2023,17002879,ESCOLA LES CLISQUES - ZER CAP DE CREUS,17140,171404,EL PORT DE LA SELVA,7,1,8
2022/2023,17002831,ESCOLA SANT JAUME,17138,171387,PORTBOU,7,1,8
2022/2023,17002818,ESCOLA FRIGOLET,17137,171371,PORQUERES,10,1,11
2022/2023,17002791,ESCOLA L'ENTORN,17137,171371,PORQUERES,25,4,29
2022/2023,17002776,ESCOLA TRAMUNTANA - ZER EMPORDÀ,17135,171352,PONT DE MOLINS,5,0,5
2022/2023,17002764,ESCOLA NÚRIA MORER I PI - ZER COMTE ARNAU,17134,171349,PLANOLES,4,0,4
2022/2023,17002752,ESCOLA SANT CRISTÒFOL,17133,171334,LES PLANES D'HOSTOLES,13,4,17
2022/2023,17002740,ESCOLA RAMON MUNTANER,17132,171328,PERALADA,18,0,18
2022/2023,17002715,ESCOLA PEDRA BLANCA - ZER EMPORDANET-GAVARRES,17130,171306,LA PERA,4,1,5
2022/2023,17002703,ESCOLA PAU,17128,171289,PAU,7,2,9
2022/2023,17002651,ESCOLA QUERMANY,17124,171241,PALS,13,3,16
2022/2023,17002624,ESCOLA MARTÍ INGLÈS,17120,171208,PALAU-SAVERDERA,14,1,15
2022/2023,17002569,ESCOLA LA VILA,17118,171181,PALAMÓS,27,4,31
2022/2023,17002557,INSTITUT BAIX EMPORDÀ,17117,171175,PALAFRUGELL,67,53,120
2022/2023,17002545,INSTITUT FREDERIC MARTÍ I CARRERAS,17117,171175,PALAFRUGELL,43,26,69
2022/2023,17002491,ESCOLA JOSEP BARCELÓ I MATAS,17117,171175,PALAFRUGELL,27,7,34
2022/2023,17002481,ESCOLA TORRES JONAMA,17117,171175,PALAFRUGELL,34,4,38
2022/2023,17002442,ESCOLA LA VALL,17116,171169,OSOR,3,3,6
2022/2023,17002430,ESCOLA MARIA PAGÈS I TRAYTER,17115,171156,ORDIS,5,3,8
2022/2023,17002429,ESCOLA SANT ROC,17114,171143,OLOT,28,6,34
2022/2023,17002399,INSTITUT LA GARROTXA,17114,171143,OLOT,81,41,122
2022/2023,17002387,INSTITUT MONTSACOPA,17114,171143,OLOT,59,20,79
2022/2023,17002326,ESCOLA VOLCÀ BISAROQUES,17114,171143,OLOT,32,3,35
2022/2023,17002314,ESCOLA PLA DE DALT,17114,171143,OLOT,30,4,34
2022/2023,17002296,ESCOLA MALAGRIDA,17114,171143,OLOT,31,5,36
2022/2023,17002260,ESCOLA JOAQUIM VALLMAJÓ,17111,171117,NAVATA,14,2,16
2022/2023,17002259,ESCOLA TORRES JONAMA,17110,171100,MONT-RAS,12,4,16
2022/2023,17002247,ESCOLA MONT CÓS - ZER EL LLIERCA,17109,171096,MONTAGUT I OIX,6,0,6
2022/2023,17002201,ESCOLA FINESTRES,17105,171058,MIERES,7,0,7
2022/2023,17002193,ESCOLA SANTA FE,17169,171693,SANT JULIÀ DE RAMIS,10,2,12
2022/2023,17002181,ESCOLA SANT JORDI,17103,171030,MAÇANET DE LA SELVA,22,8,30
2022/2023,17002168,ESCOLA LES SALINES - ZER LES SALINES,17102,171024,MAÇANET DE CABRENYS,5,0,5
2022/2023,17002107,ESCOLA PERE TORRENT,17095,170950,LLORET DE MAR,39,9,48
2022/2023,17002090,ESCOLA JAUME I - ZER CERDANYA,17094,170947,LLÍVIA,9,1,10
2022/2023,17002089,ESCOLA DE LLERS,17093,170932,LLERS,14,2,16
2022/2023,17002077,ESCOLA POMPEU FABRA,17092,170926,LLANÇÀ,24,5,29
2022/2023,17002065,ESCOLA LES MORERES - ZER VALL DE TER,17091,170911,LLANARS,4,0,4
2022/2023,17002031,ESCOLA LACUSTÀRIA,17089,170890,LLAGOSTERA,34,4,38
2022/2023,17002028,ESCOLA MONTSERRAT VAYREDA I TRULLOL,17088,170887,LLADÓ,12,0,12
2022/2023,17002004,ESCOLA JOSEP PEÑUELAS DEL RIO,17086,170865,LA JONQUERA,27,7,34
2022/2023,17001981,ESCOLA MARE DE DÉU DELS SOCORS,17083,170834,HOSTALRIC,31,4,35
2022/2023,17001954,ESCOLA DE VILA-ROJA,17079,170792,GIRONA,12,2,14
2022/2023,17001930,ESCOLA JOSEP DALMAU I CARLES,17079,170792,GIRONA,26,6,32
2022/2023,17001887,ESCOLA CARME AUGUET,17079,170792,GIRONA,18,0,18
2022/2023,17001838,ESCOLA ÀGORA,17079,170792,GIRONA,21,0,21
2022/2023,17001759,INSTITUT ESCOLA D'HOSTALERIA I TURISME DE GIRONA,17079,170792,GIRONA,32,19,51
2022/2023,17001735,INSTITUT MONTILIVI,17079,170792,GIRONA,99,70,169
2022/2023,17001723,INSTITUT JAUME VICENS VIVES,17079,170792,GIRONA,55,23,78
2022/2023,17001693,CEE FONT DE L'ABELLA,17079,170792,GIRONA,41,7,48
2022/2023,17001516,ESCOLA PLA DE GIRONA,17079,170792,GIRONA,27,4,31
2022/2023,17001486,ESCOLA MONTJUÏC,17079,170792,GIRONA,14,3,17
2022/2023,17001462,ESCOLA VERD,17079,170792,GIRONA,15,2,17
2022/2023,17001450,ESCOLA JOAN BRUGUERA,17079,170792,GIRONA,13,4,17
2022/2023,17001449,ESCOLA ANNEXA - JOAN PUIGBERT,17079,170792,GIRONA,24,5,29
2022/2023,17001425,ESCOLA EIXIMENIS,17079,170792,GIRONA,15,2,17
2022/2023,17001395,ESCOLA SANTA COLOMA - ZER CERDANYA,17078,170789,GER,9,1,10
2022/2023,17001383,ESCOLA JOAQUIM GIFRE,17077,170773,GARRIGUELLA,13,3,16
2022/2023,17001371,ESCOLA DE GARRIGÀS - ZER EMPORDÀ,17075,170754,GARRIGÀS,3,1,4
2022/2023,17001361,ESCOLA TERESA DE PALLEJÀ,17074,170741,FORTIÀ,11,0,11
2022/2023,17001346,ESCOLA FORN D'ANELLS,17073,170736,FORNELLS DE LA SELVA,22,3,25
2022/2023,17001292,ESCOLA LES MORERES,17067,170675,FLAÇÀ,13,3,16
2022/2023,17001280,ESCOLA JOAQUIM CUSÍ I FURTUNET,17066,170669,FIGUERES,28,6,34
2022/2023,17001279,ESCOLA SANT PAU,17066,170669,FIGUERES,30,3,33
2022/2023,17001221,INSTITUT NARCÍS MONTURIOL,17066,170669,FIGUERES,53,39,92
2022/2023,17001218,INSTITUT RAMON MUNTANER,17066,170669,FIGUERES,48,24,72
2022/2023,17001115,ESCOLA JOSEP POUS I PAGÈS,17066,170669,FIGUERES,16,2,18
2022/2023,17001103,ESCOLA SALVADOR DALÍ,17066,170669,FIGUERES,31,3,34
2022/2023,17001097,ESCOLA CARLES DE FORTUNY,17065,170656,ESPONELLÀ,6,1,7
2022/2023,17001085,ESCOLA ANTONI BALMANYA - ZER REQUESENS,17064,170643,ESPOLLA,3,0,3
2022/2023,17001048,ESCOLA EMPÚRIES,17062,170622,L'ESCALA,35,3,38
2022/2023,17001036,ESCOLA MONT-ROIG - ZER REQUESENS,17060,170600,DARNIUS,3,1,4
2022/2023,17001024,ESCOLA LES GAVARRES - ZER EMPORDANET-GAVARRES,17901,179011,"CRUÏLLES, MONELLS I SANT SADURNÍ L'HEURA",6,0,6
2022/2023,17000998,ESCOLA EL RODONELL,17057,170577,CORÇÀ,14,4,18
2022/2023,17000986,ESCOLA LA VALL DEL TERRI,17056,170561,CORNELLÀ DEL TERRI,20,2,22
2022/2023,17000950,ESCOLA PUIG D'ESQUERS - ZER CAP DE CREUS,17054,170545,COLERA,2,1,3
2022/2023,17000937,ESCOLA MOSSÈN JOSEP MARIA ALBERT - ZER EMPORDÀ,17051,170519,CISTELLA,2,0,2
2022/2023,17000925,ESCOLA L'AIXART,17050,170502,CERVIÀ DE TER,14,0,14
2022/2023,17000913,ESCOLA L'AULET,17049,170499,CELRÀ,20,1,21
2022/2023,17000895,ESCOLA ELS ESTANYS,17048,170486,CASTELL-PLATJA D'ARO,25,6,31
2022/2023,17000883,ESCOLA VALL D'ARO,17048,170486,CASTELL-PLATJA D'ARO,16,2,18
2022/2023,17000871,ESCOLA RUIZ AMADO,17047,170470,CASTELLÓ D'EMPÚRIES,29,3,32
2022/2023,17000861,ESCOLA CASTELLROC,17046,170464,CASTELLFOLLIT DE LA ROCA,9,3,12
2022/2023,17000846,ESCOLA PUIG D'ARQUES,17044,170448,CASSÀ DE LA SELVA,25,8,33
2022/2023,17000822,ESCOLA ELS DÒLMENS - ZER REQUESENS,17042,170427,CAPMANY,3,1,4
2022/2023,17000779,ESCOLA DOCTOR ROBERT,17039,170391,CAMPRODON,19,2,21
2022/2023,17000731,ESCOLA PIRINEU,17036,170366,CAMPDEVÀNOL,17,0,17
2022/2023,17000718,ESCOLA LLEVANTÍ DE MAR,17034,170340,CALONGE I SANT ANTONI,17,1,18
2022/2023,17000706,INSTITUT PUIG CARGOL,17034,170340,CALONGE I SANT ANTONI,33,24,57
2022/2023,17000688,ESCOLA PERE ROSSELLÓ,17034,170340,CALONGE I SANT ANTONI,29,2,31
2022/2023,17000676,ESCOLA SANT ESTEVE,17033,170335,CALDES DE MALAVELLA,30,4,34
2022/2023,17000603,ESCOLA SANTA CECÍLIA - ZER LES SALINES,17029,170293,BOADELLA I LES ESCAULES,2,0,2
2022/2023,17000573,ESCOLA SANT ANDREU DE BORRASSÀ,17026,170268,BORRASSÀ,11,0,11
2022/2023,17000561,ESCOLA DE BORDILS,17025,170255,BORDILS,13,5,18
2022/2023,17000551,INSTITUT SA PALOMERA,17023,170237,BLANES,53,40,93
2022/2023,17000548,ESCOLA MOSSÈN JOAN BATLLE,17023,170237,BLANES,18,8,26
2022/2023,17000470,ESCOLA CARLES FAUST,17023,170237,BLANES,11,5,16
2022/2023,17000469,ESCOLA JOAQUIM RUYRA,17023,170237,BLANES,17,1,18
2022/2023,17000411,ESCOLA JOAN DE MARGARIT,17022,170221,LA BISBAL D'EMPORDÀ,24,5,29
2022/2023,17000408,ESCOLA DOCTOR SOBREQUÉS,17020,170209,BESCANÓ,32,5,37
2022/2023,17000381,ESCOLA EL RAJARET - ZER MONTGRÍ,17018,170182,BELLCAIRE D'EMPORDÀ,6,0,6
2022/2023,17000354,ESCOLA JOAN REGLÀ,17016,170160,BÀSCARA,11,4,15
2022/2023,17000342,ESCOLA DE LA VILA BALDIRI REIXAC,17015,170157,BANYOLES,30,4,34
2022/2023,17000330,INSTITUT JOSEP BRUGULAT,17015,170157,BANYOLES,62,38,100
2022/2023,17000329,ESCOLA PLA DE L'AMETLLER,17015,170157,BANYOLES,32,1,33
2022/2023,17000305,INSTITUT PERE ALSIUS I TORRENT,17015,170157,BANYOLES,48,31,79
2022/2023,17000263,ESCOLA DOCTOR ARRUGA,17013,170139,BEGUR,14,3,17
2022/2023,17000251,ESCOLA GONÇAL COMELLAS,17012,170123,AVINYONET DE PUIGVENTÓS,14,3,17
2022/2023,17000241,ESCOLA FLUVIANETS,17011,170118,L'ARMENTERA,13,3,16
2022/2023,17000160,ESCOLA DOCTOR CARULLA,17009,170097,ARBÚCIES,30,5,35
2022/2023,17000135,ESCOLA POMPEU FABRA,17008,170084,ANGLÈS,26,6,32
2022/2023,17000123,ESCOLA SANT JORDI,17903,179032,SANT JULIÀ DEL LLOR I BONMATÍ,14,2,16
2022/2023,17000093,ESCOLA GASPAR DE QUERALT,17007,170078,AMER,16,2,18
2022/2023,17000071,ESCOLA BAC DE CERDANYA,17006,170062,ALP,13,2,15
2022/2023,17000068,ESCOLA DEL FAR D'EMPORDÀ,17005,170059,EL FAR D'EMPORDÀ,13,1,14
2022/2023,17000056,ESCOLA LA BRANCA - ZER MONTGRÍ,17004,170046,ALBONS,5,1,6
2022/2023,17000032,ESCOLA VILADEMANY,17002,170025,AIGUAVIVA,10,2,12
2022/2023,17000019,ESCOLA LLUÍS MARIÀ VIDAL - ZER LES SALINES,17001,170010,AGULLANA,8,1,9
2022/2023,08077991,INSTITUT DE LOGÍSTICA DE BARCELONA,08019,080193,BARCELONA,18,16,34
2022/2023,08077988,ESCOLA CASTELLFOLLIT DEL BOIX-ZER TRES BRANQUES,08059,080594,CASTELLFOLLIT DEL BOIX,4,0,4
2022/2023,08077976,INSTITUT MIQUEL BIADA,08121,081213,MATARÓ,60,73,133
2022/2023,08077964,INSTITUT ESCOLA EL MOLÍ,08019,080193,BARCELONA,40,19,59
2022/2023,08077952,INSTITUT ESCOLA PROJECTE,08019,080193,BARCELONA,20,9,29
2022/2023,08077940,INSTITUT ESCOLA MARIA MIRET,08101,081017,L'HOSPITALET DE LLOBREGAT,28,8,36
2022/2023,08077939,ESCOLA DE LA VILA,08167,081672,POLINYÀ,26,12,38
2022/2023,08077851,INSTITUT ESCOLA DE TORRELLES,08289,082896,TORRELLES DE LLOBREGAT,49,15,64
2022/2023,08077782,INSTITUT ESCOLA MIQUEL MARTÍ I POL,08107,081075,LLIÇÀ D'AMUNT,19,4,23
2022/2023,08077514,ESCOLA ALDANA,08019,080193,BARCELONA,20,4,24
2022/2023,08077502,INSTITUT ESCOLA LONDRES,08019,080193,BARCELONA,42,14,56
2022/2023,08077496,INSTITUT ESCOLA SICÍLIA,08019,080193,BARCELONA,31,6,37
2022/2023,08077484,INSTITUT ESCOLA ELISABETS,08019,080193,BARCELONA,32,8,40
2022/2023,08077472,INSTITUT ESCOLA INTERMUNICIPAL DEL PENEDÈS,08240,082401,SANT SADURNÍ D'ANOIA,61,37,98
2022/2023,08077460,INSTITUT ESCOLA SANTA ANNA,08230,082303,PREMIÀ DE DALT,35,8,43
2022/2023,08077459,INSTITUT ESCOLA SANTIGA,08260,082606,SANTA PERPÈTUA DE MOGODA,30,14,44
2022/2023,08077447,INSTITUT DE FORMACIÓ PROFESSIONAL ANTONI ALGUERÓ,08221,082212,SANT JUST DESVERN,18,12,30
2022/2023,08077435,INSTITUT DELS ALIMENTS DE BARCELONA,08019,080193,BARCELONA,25,17,42
2022/2023,08077401,INSTITUT ESCOLA GUILLEM DE BALSARENY,08018,080180,BALSARENY,16,7,23
2022/2023,08077393,INSTITUT ESCOLA LLUÍS MILLET,08118,081189,EL MASNOU,29,8,37
2022/2023,08077381,INSTITUT ESCOLA VIROLET,08187,081878,SABADELL,33,11,44
2022/2023,08077371,INSTITUT ESCOLA EL MORSELL,08148,081483,OLIVELLA,25,4,29
2022/2023,08077356,ESCOLA LES FILADORES,08267,082671,SENTMENAT,4,0,4
2022/2023,08077228,INSTITUT PROFESSIONAL DE TURISME EQÜESTRE DEL MARESME,08261,082613,SANTA SUSANNA,6,8,14
2022/2023,08077174,INSTITUT LA VALL DEL TENES,08248,082482,SANTA EULÀLIA DE RONÇANA,40,23,63
2022/2023,08077162,ESCOLA ATENEU IGUALADÍ,08102,081022,IGUALADA,17,3,20
2022/2023,08077149,INSTITUT ESCOLA EIXAMPLE,08019,080193,BARCELONA,31,16,47
2022/2023,08077137,INSTITUT DE L'ESPORT DE BARCELONA,08019,080193,BARCELONA,24,28,52
2022/2023,08077125,INSTITUT ESCOLA ANTONI UBACH I SOLER,08279,082798,TERRASSA,43,10,53
2022/2023,08077113,ESCOLA VOLTREGÀ,08215,082153,SANT HIPÒLIT DE VOLTREGÀ,25,3,28
2022/2023,08077101,INSTITUT ESCOLA TRES FONTS DE LES CORTS,08019,080193,BARCELONA,40,8,48
2022/2023,08077095,INSTITUT ESCOLA MIRADES,08019,080193,BARCELONA,38,14,52
2022/2023,08077083,INSTITUT VAPOR DEL FIL,08019,080193,BARCELONA,17,4,21
2022/2023,08077071,INSTITUT ESCOLA MAS RAMPINYO,08125,081252,MONTCADA I REIXAC,42,6,48
2022/2023,08077061,INSTITUT ESCOLA ONZE DE SETEMBRE,08238,082384,SANT QUIRZE DEL VALLÈS,28,5,33
2022/2023,08077058,INSTITUT ESCOLA CATALUNYA,08205,082055,SANT CUGAT DEL VALLÈS,42,9,51
2022/2023,08077046,INSTITUT ESCOLA JOAN SALLARÈS I PLA,08187,081878,SABADELL,31,18,49
2022/2023,08077034,INSTITUT ESCOLA EL PI GROS,08203,082037,SANT CEBRIÀ DE VALLALTA,28,11,39
2022/2023,08077022,INSTITUT ESCOLA ELS TRES PINS,08296,082969,VALLROMANES,26,8,34
2022/2023,08077010,INSTITUT ESCOLA COVES D'EN CIMANY,08019,080193,BARCELONA,27,7,34
2022/2023,08077009,INSTITUT ESCOLA CASTELL D'ÒDENA,08143,081430,ÒDENA,31,7,38
2022/2023,08076996,INSTITUT ESCOLA MOSSEN CINTO,08083,080832,FOLGUEROLES,28,5,33
2022/2023,08076984,INSTITUT ESCOLA JOSEP MARIA XANDRI,08233,082331,SANT PERE DE TORELLÓ,21,7,28
2022/2023,08076972,INSTITUT ESCOLA PIERA,08161,081614,PIERA,40,20,60
2022/2023,08076960,INSTITUT ESCOLA RENAIXENÇA,08162,081629,ELS HOSTALETS DE PIEROLA,38,8,46
2022/2023,08076959,INSTITUT ESCOLA CARLES CAPDEVILA,08017,080174,BALENYÀ,33,14,47
2022/2023,08076947,INSTITUT ESCOLA LLUÍS MILLET,08245,082457,SANTA COLOMA DE GRAMENET,18,9,27
2022/2023,08076935,INSTITUT ESCOLA PUIG I GAIRALT,08101,081017,L'HOSPITALET DE LLOBREGAT,38,24,62
2022/2023,08076923,INSTITUT ESCOLA LLIBERTAT,08015,080155,BADALONA,26,7,33
2022/2023,08076901,INSTITUT ESCOLA TURÓ D'EN CARITG,08015,080155,BADALONA,47,17,64
2022/2023,08076893,INSTITUT VILAFRANCA 2,08305,083054,VILAFRANCA DEL PENEDÈS,11,6,17
2022/2023,08076820,INSTITUT ESCOLA SALA I BADRINAS,08279,082798,TERRASSA,38,12,50
2022/2023,08076650,CFA SANT ADRIÀ DE BESÒS,08194,081944,SANT ADRIÀ DE BESÒS,10,7,17
2022/2023,08076649,INSTITUT DE JARDINERIA I AGRICULTURA LES GARBERES,08051,080517,CASTELLAR DEL VALLÈS,8,8,16
2022/2023,08076637,INSTITUT FP SANT CUGAT DEL VALLÈS,08205,082055,SANT CUGAT DEL VALLÈS,50,28,78
2022/2023,08076613,INSTITUT ESCOLA BARNOLA,08012,080121,AVINYÓ,21,7,28
2022/2023,08076601,INSTITUT ESCOLA PERE VIVER,08279,082798,TERRASSA,46,13,59
2022/2023,08076595,INSTITUT ESCOLA TERESA ALTET,08184,081846,RUBÍ,39,14,53
2022/2023,08076583,INSTITUT ESCOLA ELS PINETONS,08180,081803,RIPOLLET,49,19,68
2022/2023,08076571,INSTITUT ESCOLA EL MARTINET,08180,081803,RIPOLLET,49,9,58
2022/2023,08076561,INSTITUT ESCOLA EL VIVER,08125,081252,MONTCADA I REIXAC,52,11,63
2022/2023,08076558,INSTITUT ESCOLA SANT ESTEVE,08051,080517,CASTELLAR DEL VALLÈS,41,11,52
2022/2023,08076546,INSTITUT ESCOLA CAN LLOBET,08252,082520,BARBERÀ DEL VALLÈS,43,14,57
2022/2023,08076534,INSTITUT ESCOLA MONTAGUT,08261,082613,SANTA SUSANNA,37,13,50
2022/2023,08076522,INSTITUT ESCOLA PALLEROLA,08202,082021,SANT CELONI,54,14,68
2022/2023,08076510,INSTITUT ESCOLA PLA DE L'AVELLÀ,08029,080291,CABRERA DE MAR,43,13,56
2022/2023,08076509,INSTITUT ESCOLA ARTS,08019,080193,BARCELONA,43,12,55
2022/2023,08076492,INSTITUT ESCOLA POMPEU FABRA,08182,081825,EL PONT DE VILOMARA I ROCAFORT,41,16,57
2022/2023,08076480,INSTITUT ESCOLA PALLARESA,08245,082457,SANTA COLOMA DE GRAMENET,41,14,55
2022/2023,08076479,INSTITUT ESCOLA SANT QUINTÍ DE MEDIONA,08236,082362,SANT QUINTÍ DE MEDIONA,35,13,48
2022/2023,08076467,INSTITUT ESCOLA PERE LLISCART,08101,081017,L'HOSPITALET DE LLOBREGAT,54,14,68
2022/2023,08076455,INSTITUT ESCOLA SANT JORDI,08015,080155,BADALONA,21,8,29
2022/2023,08076443,INSTITUT ESCOLA RAFAEL ALBERTI,08015,080155,BADALONA,38,14,52
2022/2023,08076431,INSTITUT ESCOLA BALDOMER SOLÀ,08015,080155,BADALONA,41,9,50
2022/2023,08076421,INSTITUT ESCOLA PEPA COLOMER,08169,081691,EL PRAT DE LLOBREGAT,47,12,59
2022/2023,08076406,INSTITUT NARCISA FREIXAS I CRUELLS,08187,081878,SABADELL,19,8,27
2022/2023,08076391,INSTITUT PEDRALBES,08019,080193,BARCELONA,81,62,143
2022/2023,08076194,INSTITUT TECNOLÒGIC DE BARCELONA,08019,080193,BARCELONA,20,45,65
2022/2023,08076169,INSTITUT ESCOLA GORNAL,08101,081017,L'HOSPITALET DE LLOBREGAT,24,9,33
2022/2023,08076157,INSTITUT ESCOLA ÀNGELA BRANSUELA,08121,081213,MATARÓ,38,11,49
2022/2023,08076145,INSTITUT ESCOLA MAR MEDITERRÀNIA,08121,081213,MATARÓ,45,10,55
2022/2023,08076111,INSTITUT JAUME BOTEY,08101,081017,L'HOSPITALET DE LLOBREGAT,36,13,49
2022/2023,08076108,INSTITUT JAUME CABRÉ,08279,082798,TERRASSA,22,9,31
2022/2023,08076091,INSTITUT CA N'ORIAC,08187,081878,SABADELL,17,12,29
2022/2023,08076078,ESCOLA AUDITORI,08019,080193,BARCELONA,15,2,17
2022/2023,08075724,ESCOLA NORAI,08126,081265,MONTGAT,12,0,12
2022/2023,08075712,INSTITUT LES CINC SÉNIES,08121,081213,MATARÓ,42,12,54
2022/2023,08075700,ESCOLA XIRINACS,08019,080193,BARCELONA,18,2,20
2022/2023,08075682,INSTITUT OLÍMPIA,08301,083015,VILADECANS,23,11,34
2022/2023,08075670,INSTITUT ESCOLA TRINITAT NOVA,08019,080193,BARCELONA,51,16,67
2022/2023,08075669,INSTITUT ESCOLA EL TIL·LER,08019,080193,BARCELONA,25,11,36
2022/2023,08075657,INSTITUT ESCOLA ANTAVIANA,08019,080193,BARCELONA,49,19,68
2022/2023,08075645,ESCOLA LA FLOR DE MAIG,08019,080193,BARCELONA,20,4,24
2022/2023,08075633,ESCOLA ANGLESOLA,08019,080193,BARCELONA,21,5,26
2022/2023,08075621,ESCOLA TEIXIDORES DE GRÀCIA,08019,080193,BARCELONA,18,2,20
2022/2023,08075611,ESCOLA GAIA,08019,080193,BARCELONA,22,2,24
2022/2023,08075608,ESCOLA 9 GRAONS,08019,080193,BARCELONA,14,7,21
2022/2023,08075384,INSTITUT ESCOLA LA MINA,08194,081944,SANT ADRIÀ DE BESÒS,49,28,77
2022/2023,08075293,INSTITUT ESCOLA GAVÀ MAR,08089,080898,GAVÀ,46,14,60
2022/2023,08075281,INSTITUT BITÀCOLA,08252,082520,BARBERÀ DEL VALLÈS,15,12,27
2022/2023,08075268,ESCOLA LA MIRADA,08205,082055,SANT CUGAT DEL VALLÈS,25,3,28
2022/2023,08075256,INSTITUT ESCOLA MARTA MATA,08285,082858,TORELLÓ,46,9,55
2022/2023,08075244,ESCOLA LES BASES,08113,081136,MANRESA,15,2,17
2022/2023,08075207,ESCOLA ENTENÇA,08019,080193,BARCELONA,25,1,26
2022/2023,08075074,INSTITUT DE SANTA COLOMA DE GRAMENET,08245,082457,SANTA COLOMA DE GRAMENET,25,16,41
2022/2023,08074847,INSTITUT DE NÀUTICA DE BARCELONA,08019,080193,BARCELONA,11,22,33
2022/2023,08074835,ESCOLA JAUME LLULL,08197,081976,SANT ANDREU DE LLAVANERES,27,4,31
2022/2023,08074823,ESCOLA ELS PICOTS,08107,081075,LLIÇÀ D'AMUNT,26,4,30
2022/2023,08074811,ESCOLA TURÓ DE CAN GILI,08096,080961,GRANOLLERS,21,4,25
2022/2023,08074801,INSTITUT MARTA ESTRADA,08096,080961,GRANOLLERS,18,8,26
2022/2023,08074641,ESCOLA ELS 30 PASSOS,08019,080193,BARCELONA,22,5,27
2022/2023,08074631,INSTITUT LES SALINES,08169,081691,EL PRAT DE LLOBREGAT,64,58,122
2022/2023,08074628,INSTITUT EL PRAT DE LLOBREGAT,08169,081691,EL PRAT DE LLOBREGAT,16,11,27
2022/2023,08074410,INSTITUT LA SERRA,08187,081878,SABADELL,17,11,28
2022/2023,08074380,ESCOLA CASTELL DE DOSRIUS,08075,080752,DOSRIUS,25,6,31
2022/2023,08074070,EOI DE CALELLA,08035,080351,CALELLA,4,3,7
2022/2023,08073961,INSTITUT PLA DEL BOSC,08043,080431,CANYELLES,22,14,36
2022/2023,08073958,ESCOLA NOVA D'ARGENTONA,08009,080095,ARGENTONA,20,4,24
2022/2023,08073843,INSTITUT TORDÀRIA,08284,082845,TORDERA,18,7,25
2022/2023,08073651,INSTITUT PIC DEL VENT,08033,080333,CALDES DE MONTBUI,19,6,25
2022/2023,08073193,INSTITUT BADIA I MARGARIT,08102,081022,IGUALADA,25,21,46
2022/2023,08073171,INSTITUT LA RIERA,08015,080155,BADALONA,19,12,31
2022/2023,08073119,INSTITUT CAN PERIQUET,08156,081568,PALAU-SOLITÀ I PLEGAMANS,22,2,24
2022/2023,08073077,INSTITUT MARIA CANELA,08114,081141,MARTORELL,20,11,31
2022/2023,08073031,INSTITUT NEUS CATALÀ,08073,080734,CORNELLÀ DE LLOBREGAT,14,13,27
2022/2023,08073028,INSTITUT DE SANT POL DE MAR,08235,082359,SANT POL DE MAR,28,17,45
2022/2023,08072978,INSTITUT SUNSI MÓRA,08040,080403,CANET DE MAR,18,15,33
2022/2023,08072607,EOI DE CORNELLÀ DE LLOBREGAT,08073,080734,CORNELLÀ DE LLOBREGAT,8,2,10
2022/2023,08072590,EOI DE RUBÍ,08184,081846,RUBÍ,5,1,6
2022/2023,08072589,EOI BARCELONA-GUINARDÓ,08019,080193,BARCELONA,7,4,11
2022/2023,08072401,INSTITUT TORRENT DELS ALOUS,08184,081846,RUBÍ,48,17,65
2022/2023,08072383,INSTITUT DOMUS D'OLIVET,08041,080410,CANOVELLES,19,8,27
2022/2023,08072310,INSTITUT ESCOLA REC COMTAL,08019,080193,BARCELONA,42,18,60
2022/2023,08072292,INSTITUT ESCOLA TURÓ DE ROQUETES,08019,080193,BARCELONA,48,15,63
2022/2023,08072255,INSTITUT PREMIÀ DE MAR,08172,081727,PREMIÀ DE MAR,54,66,120
2022/2023,08072188,INSTITUT ESCOLA SANT JORDI,08141,081419,NAVÀS,46,12,58
2022/2023,08072176,INSTITUT DEL TER,08112,081120,MANLLEU,28,9,37
2022/2023,08071691,INSTITUT ESCOLA DEL PRAT,08169,081691,EL PRAT DE LLOBREGAT,23,9,32
2022/2023,08071573,ESC.SUP.DISSENY ESDAP - CATALUNYA,08019,080193,BARCELONA,2,2,4
2022/2023,08071421,ZER EL MOIANÈS LLEVANT,08079,080790,L'ESTANY,4,1,5
2022/2023,08071238,INSTITUT ESCOLA JACINT VERDAGUER,08240,082401,SANT SADURNÍ D'ANOIA,46,20,66
2022/2023,08071226,INSTITUT ESCOLA COSTA I LLOBERA,08019,080193,BARCELONA,46,20,66
2022/2023,08071214,INSTITUT ESCOLA CASTELLTERÇOL,08064,080641,CASTELLTERÇOL,30,8,38
2022/2023,08071196,INSTITUT CAN ROCA,08279,082798,TERRASSA,43,22,65
2022/2023,08071147,ESCOLA ROSER CAPDEVILA,08217,082172,SANT JOAN DESPÍ,19,4,23
2022/2023,08071020,ESCOLA ENXANETA,08301,083015,VILADECANS,18,1,19
2022/2023,08070908,INSTITUT ESCOLA LA TORDERA,08259,082592,SANTA MARIA DE PALAUTORDERA,45,9,54
2022/2023,08070799,ESCOLA TIZIANA,08282,082824,TIANA,14,2,16
2022/2023,08070234,ESCOLA CAN FABRA,08019,080193,BARCELONA,28,1,29
2022/2023,08070143,ESCOLA RIERA ALTA,08245,082457,SANTA COLOMA DE GRAMENET,26,4,30
2022/2023,08069751,ESCOLA SANTA COLOMA,08245,082457,SANTA COLOMA DE GRAMENET,14,3,17
2022/2023,08069748,ESCOLA MONTIGALÀ,08015,080155,BADALONA,13,4,17
2022/2023,08069736,ESCOLA PACO CANDEL,08101,081017,L'HOSPITALET DE LLOBREGAT,27,3,30
2022/2023,08069581,CFA CARME KARR,08218,082188,SANT JOAN DE VILATORRADA,14,2,16
2022/2023,08069499,ESCOLA VIC-CENTRE,08298,082981,VIC,15,5,20
2022/2023,08068616,INSTITUT BAGES SUD,08053,080538,CASTELLBELL I EL VILAR,20,8,28
2022/2023,08068537,INSTITUT LES AIMERIGUES,08279,082798,TERRASSA,43,21,64
2022/2023,08068495,INSTITUT JOSEFINA CASTELLVÍ I PIULACHS,08301,083015,VILADECANS,30,20,50
2022/2023,08068410,ESCOLA PALAU D'AMETLLA,08136,081363,MONTORNÈS DEL VALLÈS,11,6,17
2022/2023,08068380,INSTITUT GURB,08100,081000,GURB,22,13,35
2022/2023,08068379,ESCOLA MAR NOVA,08172,081727,PREMIÀ DE MAR,13,1,14
2022/2023,08068343,ESCOLA LES CIÈNCIES,08015,080155,BADALONA,12,4,16
2022/2023,08068331,ESCOLA BADALONA PORT,08015,080155,BADALONA,17,0,17
2022/2023,08068197,ZER EL CARDENER,08229,082299,SANT MATEU DE BAGES,3,1,4
2022/2023,08068136,CFA VÍCTOR CATALÀ,08208,082080,SANT ESTEVE SESROVIRES,18,6,24
2022/2023,08067818,ESCOLA LA SÍNIA,08298,082981,VIC,32,7,39
2022/2023,08067764,ESCOLA LA MAQUINISTA,08019,080193,BARCELONA,26,4,30
2022/2023,08067752,INSTITUT SAGRERA SANT ANDREU,08019,080193,BARCELONA,25,12,37
2022/2023,08067661,ESCOLA JOAN COROMINES,08121,081213,MATARÓ,26,3,29
2022/2023,08067648,INSTITUT LES VINYES,08074,080749,CUBELLES,13,11,24
2022/2023,08067636,INSTITUT MANRESA SIS,08113,081136,MANRESA,20,9,29
2022/2023,08067600,ESCOLA VALLDAURA,08113,081136,MANRESA,17,1,18
2022/2023,08067594,INSTITUT ESCOLA LES VINYES,08054,080543,CASTELLBISBAL,37,9,46
2022/2023,08067582,ESCOLA MARTA MATA,08252,082520,BARBERÀ DEL VALLÈS,14,4,18
2022/2023,08067430,ESCOLA MONTSERRAT SOLÀ,08121,081213,MATARÓ,25,5,30
2022/2023,08067247,ESCOLA EL VAPOR,08279,082798,TERRASSA,34,3,37
2022/2023,08067235,ESCOLA ROC ALABERN,08279,082798,TERRASSA,27,7,34
2022/2023,08067211,INSTITUT SALAS I XANDRI,08238,082384,SANT QUIRZE DEL VALLÈS,19,4,23
2022/2023,08067201,ESCOLA LOLA ANGLADA,08238,082384,SANT QUIRZE DEL VALLÈS,24,2,26
2022/2023,08067193,ESCOLA DEL BOSC,08184,081846,RUBÍ,14,4,18
2022/2023,08067181,ESCOLA DE RELLINARS,08179,081799,RELLINARS,8,4,12
2022/2023,08067144,INSTITUT DE CERVELLÓ,08068,080689,CERVELLÓ,24,14,38
2022/2023,08067132,ESCOLA JOSEFINA IBÁÑEZ,08001,080018,ABRERA,16,1,17
2022/2023,08067120,ESCOLA SANTA AGNÈS DE MALANYANES,08181,081810,LA ROCA DEL VALLÈS,12,2,14
2022/2023,08067090,ESCOLA CAN MANENT,08046,080462,CARDEDEU,26,3,29
2022/2023,08067041,ESCOLA XORIGUER,08067,080673,CENTELLES,14,1,15
2022/2023,08067016,ESCOLA ERNEST LLUCH,08101,081017,L'HOSPITALET DE LLOBREGAT,21,4,25
2022/2023,08066905,INSTITUT VILADOMAT,08019,080193,BARCELONA,26,20,46
2022/2023,08066887,EOI DE VILADECANS,08301,083015,VILADECANS,9,3,12
2022/2023,08066851,EOI DE MOLLET DEL VALLÈS,08124,081249,MOLLET DEL VALLÈS,4,4,8
2022/2023,08066565,INSTITUT JONCAR,08019,080193,BARCELONA,26,17,43
2022/2023,08066541,INSTITUT MARIA ESPINALT,08019,080193,BARCELONA,39,20,59
2022/2023,08066531,ESCOLA FLUVIÀ,08019,080193,BARCELONA,28,5,33
2022/2023,08066528,INSTITUT MARTÍ POUS,08019,080193,BARCELONA,30,19,49
2022/2023,08066516,ESCOLA CONGRÉS-INDIANS,08019,080193,BARCELONA,25,5,30
2022/2023,08066504,ESCOLA L'UNIVERS,08019,080193,BARCELONA,28,2,30
2022/2023,08066462,ESCOLA DELS ENCANTS,08019,080193,BARCELONA,25,6,31
2022/2023,08066437,INSTITUT MONT PERDUT,08279,082798,TERRASSA,40,26,66
2022/2023,08066413,ESCOLA COLORS,08086,080863,LES FRANQUESES DEL VALLÈS,17,0,17
2022/2023,08066334,ESCOLA LA SERRETA,08192,081923,SANTPEDOR,14,2,16
2022/2023,08066322,INSTITUT CARDENER,08218,082188,SANT JOAN DE VILATORRADA,18,8,26
2022/2023,08066048,ESCOLA ROSER CAPDEVILA,08279,082798,TERRASSA,28,3,31
2022/2023,08065664,EOI DEL BERGUEDÀ,08022,080229,BERGA,5,0,5
2022/2023,08065652,EOI DE L'ALT PENEDÈS,08305,083054,VILAFRANCA DEL PENEDÈS,3,4,7
2022/2023,08065512,ESCOLA SERRA DE L'OBAC,08279,082798,TERRASSA,28,4,32
2022/2023,08065482,ESCOLA ELS VENTETS - ZER EL MOIANÈS LLEVANT,08070,080706,COLLSUSPINA,3,2,5
2022/2023,08065469,INSTITUT CAN RECORD,08207,082074,SANT ESTEVE DE PALAUTORDERA,21,6,27
2022/2023,08065433,INSTITUT LA SÍNIA,08159,081593,PARETS DEL VALLÈS,15,8,23
2022/2023,08065421,INSTITUT MARTA MATA,08136,081363,MONTORNÈS DEL VALLÈS,32,20,52
2022/2023,08065411,INSTITUT AIGUAVIVA,08124,081249,MOLLET DEL VALLÈS,32,16,48
2022/2023,08065408,INSTITUT HIPÀTIA D'ALEXANDRIA,08107,081075,LLIÇÀ D'AMUNT,14,5,19
2022/2023,08065391,INSTITUT EL TIL·LER,08086,080863,LES FRANQUESES DEL VALLÈS,38,18,56
2022/2023,08065366,INSTITUT DE PINEDA DE MAR,08163,081635,PINEDA DE MAR,37,11,48
2022/2023,08065354,INSTITUT BAIX A MAR,08307,083073,VILANOVA I LA GELTRÚ,35,17,52
2022/2023,08065342,INSTITUT XALOC,08231,082310,SANT PERE DE RIBES,18,8,26
2022/2023,08065330,INSTITUT CAL GRAVAT,08113,081136,MANRESA,37,24,61
2022/2023,08065329,INSTITUT DE L'ALT FOIX,08227,082270,SANT MARTÍ SARROCA,28,15,43
2022/2023,08065305,ESCOLA SOLER DE VILARDELL,08202,082021,SANT CELONI,19,1,20
2022/2023,08065299,ESCOLA EL CALDERÍ,08033,080333,CALDES DE MONTBUI,16,0,16
2022/2023,08065287,ESCOLA MARTA MATA,08121,081213,MATARÓ,28,2,30
2022/2023,08065275,ESCOLA VOLERANY,08307,083073,VILANOVA I LA GELTRÚ,25,5,30
2022/2023,08065263,ESCOLA PUIGSOLER,08262,082628,SANT VICENÇ DE CASTELLET,21,2,23
2022/2023,08065251,ESCOLA PLA DEL PUIG,08213,082135,SANT FRUITÓS DE BAGES,14,2,16
2022/2023,08065238,ESCOLA LA SAGRERA,08248,082482,SANTA EULÀLIA DE RONÇANA,25,5,30
2022/2023,08065019,INSTITUT DE VALLBONA D'ANOIA,08292,082922,VALLBONA D'ANOIA,18,7,25
2022/2023,08065007,ESCOLA POBLENOU,08163,081635,PINEDA DE MAR,14,3,17
2022/2023,08064994,ESCOLA MARIA-MERCÈ MARÇAL,08121,081213,MATARÓ,27,3,30
2022/2023,08064982,ESCOLA DE SANT QUIRZE SAFAJA - ZER EL MOIANÈS LLEVANT,08239,082397,SANT QUIRZE SAFAJA,5,0,5
2022/2023,08064970,INSTITUT NOU DE VILAFRANCA DEL PENEDÈS,08305,083054,VILAFRANCA DEL PENEDÈS,30,22,52
2022/2023,08064945,ESCOLA MANSUET,08069,080692,COLLBATÓ,16,2,18
2022/2023,08064921,INSTITUT DE SANT ANDREU,08196,081960,SANT ANDREU DE LA BARCA,24,12,36
2022/2023,08064911,INSTITUT VALÈRIA HALINÉ,08056,080569,CASTELLDEFELS,21,19,40
2022/2023,08064908,INSTITUT BEGUES,08020,080207,BEGUES,22,6,28
2022/2023,08064881,ESCOLA CAMPDERRÓS,08295,082956,VALLIRANA,21,3,24
2022/2023,08064866,ESCOLA DOLORS MARTÍ I BADIA,08102,081022,IGUALADA,26,4,30
2022/2023,08064854,ESCOLA MARTINET,08073,080734,CORNELLÀ DE LLOBREGAT,21,9,30
2022/2023,08064830,INSTITUT SERRA DE NOET,08022,080229,BERGA,28,7,35
2022/2023,08064829,ESCOLA VALLDENEU,08224,082248,SANT MARTÍ DE CENTELLES,9,0,9
2022/2023,08000086,ESCOLA LA FORJA - ZER ALT LLUÇANÈS,08004,080044,ALPENS,4,0,4
2022/2023,08064817,ESCOLA CAMINS,08086,080863,LES FRANQUESES DEL VALLÈS,29,2,31
2022/2023,08064805,ESCOLA ELS QUATRE VENTS,08041,080410,CANOVELLES,28,9,37
2022/2023,08064787,ESCOLA EMILI TEIXIDOR,08183,081831,RODA DE TER,18,0,18
2022/2023,08064751,ESCOLA MAR I CEL,08074,080749,CUBELLES,15,3,18
2022/2023,08064741,ESCOLA ÍTACA,08113,081136,MANRESA,26,7,33
2022/2023,08064738,ESCOLA DOLORS PIERA,08305,083054,VILAFRANCA DEL PENEDÈS,31,6,37
2022/2023,08064659,CFA SALVADOR DALÍ,08181,081810,LA ROCA DEL VALLÈS,18,6,24
2022/2023,08064647,CFA ARTUR MARTORELL,08208,082080,SANT ESTEVE SESROVIRES,16,8,24
2022/2023,08064635,CFA SANTIAGO RUSIÑOL,08181,081810,LA ROCA DEL VALLÈS,11,4,15
2022/2023,08064623,CFA CONCEPCIÓ ARENAL,08019,080193,BARCELONA,4,1,5
2022/2023,08064222,ESCOLA LA ROUREDA,08284,082845,TORDERA,27,3,30
2022/2023,08064192,INSTITUT ANGELETA FERRER,08019,080193,BARCELONA,13,5,18
2022/2023,08064179,ESCOLA LA LLACUNA DEL POBLENOU,08019,080193,BARCELONA,30,1,31
2022/2023,08064167,ESCOLA SANT MARTÍ,08019,080193,BARCELONA,28,3,31
2022/2023,08064155,INSTITUT QUATRE CANTONS,08019,080193,BARCELONA,31,18,49
2022/2023,08064143,ESCOLA LA NOVA ELECTRA,08279,082798,TERRASSA,34,7,41
2022/2023,08064118,ESCOLA CIUTAT D'ALBA,08205,082055,SANT CUGAT DEL VALLÈS,30,2,32
2022/2023,08064088,ESCOLA MAS BOADELLA,08187,081878,SABADELL,27,3,30
2022/2023,08064076,ESCOLA RIVO RUBEO,08184,081846,RUBÍ,26,4,30
2022/2023,08064027,ESCOLA EL SOL I LA LLUNA,08051,080517,CASTELLAR DEL VALLÈS,19,5,24
2022/2023,08064003,INSTITUT CAN MARGARIT,08072,080728,CORBERA DE LLOBREGAT,22,14,36
2022/2023,08063965,ESCOLA CAU DE LA GUINEU,08072,080728,CORBERA DE LLOBREGAT,15,1,16
2022/2023,08063931,ESCOLA LES FALGUERES,08082,080826,FOGARS DE LA SELVA,15,1,16
2022/2023,08063928,ESCOLA MUNTANYOLA,08129,081290,MUNTANYOLA,6,1,7
2022/2023,08063916,ESCOLA VILA PARIETES,08159,081593,PARETS DEL VALLÈS,14,3,17
2022/2023,08063904,INSTITUT MONTGRÒS,08231,082310,SANT PERE DE RIBES,29,16,45
2022/2023,08063898,ESCOLA LA SÈQUIA,08113,081136,MANRESA,29,3,32
2022/2023,08063886,ESCOLA ARRELS,08251,082515,SANTA MARGARIDA I ELS MONJOS,16,1,17
2022/2023,08063874,ESCOLA ANTONIO MACHADO,08121,081213,MATARÓ,25,4,29
2022/2023,08063862,ESCOLA L'OLIVAR,08062,080620,CASTELLNOU DE BAGES,14,3,17
2022/2023,08063837,INSTITUT LES MARGUES,08037,080370,CALLDETENES,27,12,39
2022/2023,08063813,INSTITUT CREU DE SABA,08147,081477,OLESA DE MONTSERRAT,33,18,51
2022/2023,08063801,INSTITUT DE COLLBATÓ,08069,080692,COLLBATÓ,23,12,35
2022/2023,08063795,ESCOLA MARTA MATA,08302,083020,VILANOVA DEL CAMÍ,13,3,16
2022/2023,08063783,ESCOLA MEDITERRÀNIA,08301,083015,VILADECANS,15,2,17
2022/2023,08063771,ESCOLA PLA DE LES VINYES,08244,082444,SANTA COLOMA DE CERVELLÓ,21,3,24
2022/2023,08063761,ESCOLA VICENTE FERRER,08200,082009,SANT BOI DE LLOBREGAT,16,2,18
2022/2023,08063758,ESCOLA CAN SALVI,08196,081960,SANT ANDREU DE LA BARCA,28,4,32
2022/2023,08063734,ESCOLA PUIGVENTÓS,08147,081477,OLESA DE MONTSERRAT,25,4,29
2022/2023,08063710,ESCOLA ESCOLA NOVA,08068,080689,CERVELLÓ,18,1,19
2022/2023,08063643,CFA LA COOPERATIVA,08285,082858,TORELLÓ,1,2,3
2022/2023,08063621,CFA MARTÍ I POL,08112,081120,MANLLEU,4,1,5
2022/2023,08063618,CFA ESPARREGUERA,08076,080765,ESPARREGUERA,3,2,5
2022/2023,08063394,ESCOLA MIQUEL MARTÍ I POL,08211,082114,SANT FELIU DE LLOBREGAT,29,2,31
2022/2023,08063229,INSTITUT MONTPEDRÓS,08244,082444,SANTA COLOMA DE CERVELLÓ,39,20,59
2022/2023,08063072,ESCOLA FRUCTUÓS GELABERT,08019,080193,BARCELONA,30,2,32
2022/2023,08062948,ESCOLA MIQUEL MARTÍ I POL,08301,083015,VILADECANS,34,4,38
2022/2023,08062924,ESCOLA JOSEP GUINOVART,08056,080569,CASTELLDEFELS,14,3,17
2022/2023,08062870,INSTITUT LA PLANA,08298,082981,VIC,41,20,61
2022/2023,08062869,ESCOLA SERRA DE MIRALLES,08284,082845,TORDERA,15,3,18
2022/2023,08062857,INSTITUT TIANA,08282,082824,TIANA,30,17,47
2022/2023,08062833,ESCOLA AGNÈS DE SITGES,08270,082704,SITGES,18,1,19
2022/2023,08062811,ESCOLA MATAGALLS,08259,082592,SANTA MARIA DE PALAUTORDERA,14,3,17
2022/2023,08062808,INSTITUT ESTEVE ALBERT,08264,082649,SANT VICENÇ DE MONTALT,30,18,48
2022/2023,08062791,INSTITUT VILAMAJOR,08234,082346,SANT PERE DE VILAMAJOR,36,17,53
2022/2023,08062781,ESCOLA MEDITERRÀNIA,08231,082310,SANT PERE DE RIBES,24,4,28
2022/2023,08062778,ESCOLA AMETLLERS,08218,082188,SANT JOAN DE VILATORRADA,25,3,28
2022/2023,08062754,ESCOLA LES FONTS,08091,080919,GELIDA,24,4,28
2022/2023,08062742,ESCOLA BENVIURE,08054,080543,CASTELLBISBAL,14,3,17
2022/2023,08062730,INSTITUT ELS ROURES,08075,080752,DOSRIUS,17,7,24
2022/2023,08062729,INSTITUT PLA MARCELL,08046,080462,CARDEDEU,55,16,71
2022/2023,08062717,INSTITUT CABRILS,08030,080305,CABRILS,26,15,41
2022/2023,08062705,ESCOLA LA CABANA,08027,080272,LES CABANYES,13,2,15
2022/2023,08062687,ESCOLA PONENT,08279,082798,TERRASSA,26,4,30
2022/2023,08062675,ESCOLA PERE IV,08019,080193,BARCELONA,29,3,32
2022/2023,08062641,ESCOLA L'OLIVERA,08205,082055,SANT CUGAT DEL VALLÈS,28,4,32
2022/2023,08062638,ESCOLA LA TRAMA,08187,081878,SABADELL,21,4,25
2022/2023,08062626,ESCOLA COLLSEROLA,08266,082665,CERDANYOLA DEL VALLÈS,16,0,16
2022/2023,08062614,ESCOLA JOAN BLANQUER,08051,080517,CASTELLAR DEL VALLÈS,16,1,17
2022/2023,08062523,CFA MARINADA,08136,081363,MONTORNÈS DEL VALLÈS,2,2,4
2022/2023,08062511,CFA ALARONA,08121,081213,MATARÓ,5,1,6
2022/2023,08062493,CFA SANT RAMON,08101,081017,L'HOSPITALET DE LLOBREGAT,5,3,8
2022/2023,08062481,CFA SANT JOSEP,08101,081017,L'HOSPITALET DE LLOBREGAT,5,1,6
2022/2023,08062471,CFA GAVÀ,08089,080898,GAVÀ,3,3,6
2022/2023,08062468,CFA BELLAVISTA,08086,080863,LES FRANQUESES DEL VALLÈS,2,2,4
2022/2023,08062331,CFA PERE CALDERS,08019,080193,BARCELONA,6,4,10
2022/2023,08062262,CFA MONTSERRAT ROIG,08019,080193,BARCELONA,6,2,8
2022/2023,08062250,CFA GUINARDÓ,08019,080193,BARCELONA,4,1,5
2022/2023,08062249,CFA EL CARMEL,08019,080193,BARCELONA,6,4,10
2022/2023,08062225,EOI GARRAF,08307,083073,VILANOVA I LA GELTRÚ,6,3,9
2022/2023,08062213,EOI VALLÈS ORIENTAL,08096,080961,GRANOLLERS,4,4,8
2022/2023,08062201,EOI BARCELONA V,08019,080193,BARCELONA,7,1,8
2022/2023,08062195,EOI BARCELONA IV,08019,080193,BARCELONA,9,3,12
2022/2023,08062183,EOI OSONA,08298,082981,VIC,5,2,7
2022/2023,08062171,EOI D'IGUALADA,08102,081022,IGUALADA,7,1,8
2022/2023,08062161,EOI DE SANT CUGAT DEL VALLÈS,08205,082055,SANT CUGAT DEL VALLÈS,7,2,9
2022/2023,08062158,EOI DE MARTORELL,08114,081141,MARTORELL,8,1,9
2022/2023,08062146,CFA LA VERNEDA,08019,080193,BARCELONA,5,4,9
2022/2023,08062122,CFA MARTORELL,08114,081141,MARTORELL,3,5,8
2022/2023,08062110,CFA SANFELIU,08101,081017,L'HOSPITALET DE LLOBREGAT,3,3,6
2022/2023,08062109,AFA CIUTAT MERIDIANA,08019,080193,BARCELONA,4,4,8
2022/2023,08062092,CFA VILAFRANCA DEL PENEDÈS,08305,083054,VILAFRANCA DEL PENEDÈS,6,4,10
2022/2023,08062080,CFA EGARA,08279,082798,TERRASSA,7,4,11
2022/2023,08062079,CFA RAMON LLULL,08279,082798,TERRASSA,3,3,6
2022/2023,08062055,CFA SANT JUST DESVERN,08221,082212,SANT JUST DESVERN,2,2,4
2022/2023,08062043,CFA PARETS DEL VALLÈS,08159,081593,PARETS DEL VALLÈS,1,3,4
2022/2023,08062031,CFA MARE DE DÉU DE MONTSERRAT,08147,081477,OLESA DE MONTSERRAT,4,1,5
2022/2023,08035957,ESCOLA CAN DEU,08187,081878,SABADELL,12,6,18
2022/2023,08062021,CFA MONTCADA I REIXAC,08125,081252,MONTCADA I REIXAC,5,3,8
2022/2023,08062018,CFA ANOIA,08102,081022,IGUALADA,1,4,5
2022/2023,08061993,CFA EUGENI D'ORS,08077,080771,ESPLUGUES DE LLOBREGAT,7,3,10
2022/2023,08061971,CFA BERGUEDÀ,08022,080229,BERGA,4,2,6
2022/2023,08061968,CFA LES CORTS,08019,080193,BARCELONA,6,2,8
2022/2023,08061956,CFA PROSPERITAT,08019,080193,BARCELONA,4,2,6
2022/2023,08061944,CFA MADRID,08019,080193,BARCELONA,4,0,4
2022/2023,08061932,CFA BON PASTOR,08019,080193,BARCELONA,4,5,9
2022/2023,08061919,CFA RIUS I TAULET,08019,080193,BARCELONA,7,3,10
2022/2023,08061907,CFA BARCELONETA,08019,080193,BARCELONA,3,4,7
2022/2023,08061774,ESCOLA LES ARENES,08279,082798,TERRASSA,28,4,32
2022/2023,08061762,ESCOLA MAS MARIA,08030,080305,CABRILS,22,3,25
2022/2023,08061725,EOI BARCELONA III,08019,080193,BARCELONA,7,4,11
2022/2023,08061701,CFA MARIA RUBIES,08019,080193,BARCELONA,6,4,10
2022/2023,08061683,CFA PALAU DE MAR,08019,080193,BARCELONA,6,3,9
2022/2023,08061610,ESCOLA LA SÍNIA,08123,081234,MOLINS DE REI,23,7,30
2022/2023,08061609,ESCOLA MERCÈ RODOREDA,08114,081141,MARTORELL,34,0,34
2022/2023,08061580,CFA LLOREDA-LA PAU,08015,080155,BADALONA,5,2,7
2022/2023,08061555,CFA CAN FOLGUERA,08260,082606,SANTA PERPÈTUA DE MOGODA,7,1,8
2022/2023,08061543,ESCOLA ROSER CAPDEVILA,08167,081672,POLINYÀ,23,6,29
2022/2023,08061521,ESCOLA VALL DE NÉSPOLA - ZER EL MOIANÈS PONENT,08139,081398,MURA,3,1,4
2022/2023,08061348,ESCOLA BUFALÀ,08015,080155,BADALONA,32,3,35
2022/2023,08061221,CFA VALLÈS,08096,080961,GRANOLLERS,8,5,13
2022/2023,08061208,INSTITUT VACARISSES,08291,082917,VACARISSES,28,20,48
2022/2023,08061191,ESCOLA FONT DE L'ORPINA,08291,082917,VACARISSES,16,2,18
2022/2023,08061178,ESCOLA TURÓ DE CAN MATES,08205,082055,SANT CUGAT DEL VALLÈS,30,2,32
2022/2023,08061166,ESCOLA DE CAN LLONG,08187,081878,SABADELL,23,6,29
2022/2023,08061154,ESCOLA CA N'ALZAMORA,08184,081846,RUBÍ,27,5,32
2022/2023,08061142,ESCOLA MIQUEL MARTÍ I POL,08252,082520,BARBERÀ DEL VALLÈS,31,1,32
2022/2023,08061129,INSTITUT MONTSERRAT COLOMER,08208,082080,SANT ESTEVE SESROVIRES,39,18,57
2022/2023,08061117,INSTITUT TURÓ D'EN BALDIRI,08281,082819,TEIÀ,17,9,26
2022/2023,08061105,ESCOLA SOT DEL CAMP,08264,082649,SANT VICENÇ DE MONTALT,26,0,26
2022/2023,08061099,INSTITUT FONT DEL FERRO,08155,081555,PALAFOLLS,42,20,62
2022/2023,08061087,ESCOLA MARINA,08126,081265,MONTGAT,28,3,31
2022/2023,08061063,ESCOLA LA SERRETA,08003,080039,ALELLA,17,2,19
2022/2023,08061051,ESCOLA ÍTACA,08307,083073,VILANOVA I LA GELTRÚ,26,2,28
2022/2023,08061041,ESCOLA SANT JORDI,08307,083073,VILANOVA I LA GELTRÚ,28,6,34
2022/2023,08061038,INSTITUT DE VILANOVA DEL VALLÈS,08902,089024,VILANOVA DEL VALLÈS,26,21,47
2022/2023,08061026,ESCOLA LA FALGUERA,08902,089024,VILANOVA DEL VALLÈS,16,2,18
2022/2023,08061014,INSTITUT VINYET,08270,082704,SITGES,36,17,53
2022/2023,08061002,ESCOLA LES PARELLADES,08231,082310,SANT PERE DE RIBES,12,5,17
2022/2023,08060991,ESCOLA MOGENT,08181,081810,LA ROCA DEL VALLÈS,26,2,28
2022/2023,08060988,ESCOLA CAL MÚSIC,08124,081249,MOLLET DEL VALLÈS,18,6,24
2022/2023,08060976,INSTITUT DEL VOLTREGANÈS,08117,081173,LES MASIES DE VOLTREGÀ,30,8,38
2022/2023,08060964,ESCOLA QUATRE VENTS,08112,081120,MANLLEU,37,4,41
2022/2023,08060952,ESCOLA ELS VINYALS,08108,081081,LLIÇÀ DE VALL,13,3,16
2022/2023,08060940,ESCOLA ROSA ORIOL ANGUERA,08107,081075,LLIÇÀ D'AMUNT,25,4,29
2022/2023,08060939,ESCOLA GUERAU DE LIOST,08086,080863,LES FRANQUESES DEL VALLÈS,27,5,32
2022/2023,08060927,ESCOLA VORA DEL MAR,08074,080749,CUBELLES,31,2,33
2022/2023,08060915,INSTITUT MARIA DE BELL-LLOC,08023,080235,BIGUES I RIELLS,33,17,50
2022/2023,08060903,ESCOLA EL COLOMER,08023,080235,BIGUES I RIELLS,27,3,30
2022/2023,08060873,ESCOLA EULÀLIA BOTA,08019,080193,BARCELONA,26,5,31
2022/2023,08060851,ESCOLA L'OLIVERA,08295,082956,VALLIRANA,24,6,30
2022/2023,08060848,ESCOLA DE SANT ANDREU DE LA BARCA,08196,081960,SANT ANDREU DE LA BARCA,26,5,31
2022/2023,08060836,ESCOLA TURÓ DEL DRAC,08040,080403,CANET DE MAR,28,4,32
2022/2023,08060757,ESCOLA JOAN TORREDEMER CANELA,08120,081206,MATADEPERA,29,1,30
2022/2023,08060629,ESCOLA EL CORB,08072,080728,CORBERA DE LLOBREGAT,16,2,18
2022/2023,08060605,ESCOLA FONT DEL ROURE,08119,081192,MASQUEFA,27,4,31
2022/2023,08060599,ESCOLA GARIGOT,08056,080569,CASTELLDEFELS,26,4,30
2022/2023,08060538,EOI DEL PRAT DE LLOBREGAT,08169,081691,EL PRAT DE LLOBREGAT,9,2,11
2022/2023,08060526,ESCOLA CREIXÀ,08161,081614,PIERA,11,2,13
2022/2023,08060514,INSTITUT DE MASQUEFA,08119,081192,MASQUEFA,38,20,58
2022/2023,08060484,ESCOLA TAULA RODONA,08238,082384,SANT QUIRZE DEL VALLÈS,27,4,31
2022/2023,08060423,ESCOLA MAS PRATS,08155,081555,PALAFOLLS,28,2,30
2022/2023,08060411,CFA SANTS-SANT RAIMON DE PENYAFORT,08019,080193,BARCELONA,4,3,7
2022/2023,08060319,ESCOLA LES FONTS,08009,080095,ARGENTONA,20,5,25
2022/2023,08060290,CFA SINGUERLÍN,08245,082457,SANTA COLOMA DE GRAMENET,6,5,11
2022/2023,08060289,CFA FONDO,08245,082457,SANTA COLOMA DE GRAMENET,7,7,14
2022/2023,08060277,CFA PAU CASALS,08184,081846,RUBÍ,7,5,12
2022/2023,08060265,CFA PREMIÀ DE MAR,08172,081727,PREMIÀ DE MAR,5,3,8
2022/2023,08060253,CFA CAN MARFÀ,08121,081213,MATARÓ,11,2,13
2022/2023,08060231,CFA PEGASO,08019,080193,BARCELONA,8,3,11
2022/2023,08060216,CFA MORERA POMAR,08015,080155,BADALONA,10,2,12
2022/2023,08060204,CFA GRAN SOL,08015,080155,BADALONA,7,6,13
2022/2023,08060137,CFA EDÈLIA HERNÁNDEZ,08301,083015,VILADECANS,8,3,11
2022/2023,08060113,CFA JACINT CARRIÓ I VILASECA,08113,081136,MANRESA,10,4,14
2022/2023,08060095,CFA MONTSENY,08298,082981,VIC,8,3,11
2022/2023,08060009,INSTITUT MANUEL CARRASCO I FORMIGUERA,08210,082107,SANT FELIU DE CODINES,12,12,24
2022/2023,08059998,ESCOLA LA PAU,08240,082401,SANT SADURNÍ D'ANOIA,25,5,30
2022/2023,08059871,ESCOLA GERBERT D'ORLHAC,08205,082055,SANT CUGAT DEL VALLÈS,29,4,33
2022/2023,08059822,ESCOLA ERNEST LLUCH,08001,080018,ABRERA,28,3,31
2022/2023,08059810,ESCOLA VINYA DEL SASTRET,08208,082080,SANT ESTEVE SESROVIRES,14,4,18
2022/2023,08059809,ESCOLA EL ROURE,08209,082093,SANT FOST DE CAMPSENTELLES,16,1,17
2022/2023,08059792,ESCOLA MOGENT,08136,081363,MONTORNÈS DEL VALLÈS,28,4,32
2022/2023,08059780,ESCOLA BELLAVISTA-JOAN CAMPS I GIRÓ,08086,080863,LES FRANQUESES DEL VALLÈS,24,5,29
2022/2023,08059767,ESCOLA TANIT,08245,082457,SANTA COLOMA DE GRAMENET,17,5,22
2022/2023,08059755,ESCOLA LA FONT,08113,081136,MANRESA,30,6,36
2022/2023,08059731,CFA ARQUITECTE JUJOL,08217,082172,SANT JOAN DESPÍ,10,4,14
2022/2023,08059721,ESCOLA MARTA MATA,08301,083015,VILADECANS,31,2,33
2022/2023,08059706,CFA SALVADOR ESPRIU,08279,082798,TERRASSA,5,1,6
2022/2023,08059691,CFA ANNA MURIÀ,08279,082798,TERRASSA,10,3,13
2022/2023,08059688,INSTITUT MARIA AURÈLIA CAPMANY,08073,080734,CORNELLÀ DE LLOBREGAT,41,22,63
2022/2023,08059639,ESCOLA PROGRÉS,08015,080155,BADALONA,29,4,33
2022/2023,08059551,EOI DE MANRESA,08113,081136,MANRESA,12,2,14
2022/2023,08059524,INSTITUT DE NAVARCLES,08140,081402,NAVARCLES,14,11,25
2022/2023,08059354,ESCOLA LES ROQUES BLAVES,08076,080765,ESPARREGUERA,19,1,20
2022/2023,08059329,INSTITUT CAN PEIXAUET,08245,082457,SANTA COLOMA DE GRAMENET,38,28,66
2022/2023,08059287,ZER GUILLERIES,17220,172207,VILADRAU,4,1,5
2022/2023,08059093,ESCOLA D'HORTSAVINYÀ,08284,082845,TORDERA,6,2,8
2022/2023,08059044,CFA LA LLAGOSTA,08105,081056,LA LLAGOSTA,7,4,11
2022/2023,08058969,INSTITUT EL VERN,08108,081081,LLIÇÀ DE VALL,24,10,34
2022/2023,08058957,ESCOLA ELS COSTERETS,08231,082310,SANT PERE DE RIBES,26,2,28
2022/2023,08058817,ZER TRES BRANQUES,08063,080636,CASTELLOLÍ,2,3,5
2022/2023,08058775,INSTITUT FRONT MARÍTIM,08019,080193,BARCELONA,32,17,49
2022/2023,08058520,INSTITUT PUIG DE LA CREU,08051,080517,CASTELLAR DEL VALLÈS,40,12,52
2022/2023,08058519,ESCOLA SINERA,08006,080060,ARENYS DE MAR,26,5,31
2022/2023,08058465,ESCOLA ENXANETA,08279,082798,TERRASSA,43,3,46
2022/2023,08058441,ESCOLA GIROI,08088,080885,LA GARRIGA,19,2,21
2022/2023,08058428,INSTITUT BISAURA,08237,082378,SANT QUIRZE DE BESORA,13,5,18
2022/2023,08058416,ESCOLA L'ARENAL DE LLEVANT,08019,080193,BARCELONA,29,2,31
2022/2023,08058404,INSTITUT CIRVIÀNUM DE TORELLÓ,08285,082858,TORELLÓ,53,25,78
2022/2023,08058374,ESCOLA ELS ALOCS,08219,082191,VILASSAR DE MAR,16,1,17
2022/2023,08058362,ESCOLA RIERA DE RIBES,08231,082310,SANT PERE DE RIBES,25,5,30
2022/2023,08058210,CFA BADIA DEL VALLÈS,08904,089045,BADIA DEL VALLÈS,3,0,3
2022/2023,08058209,CFA SANT BOI,08200,082009,SANT BOI DE LLOBREGAT,8,4,12
2022/2023,08058091,ZER BAIX BERGUEDÀ,08144,081445,OLVAN,4,1,5
2022/2023,08058088,ZER BERGUEDÀ CENTRE,08299,082994,VILADA,4,0,4
2022/2023,08058076,ZER ELS CASTELLS,08253,082536,SANTA MARIA DE BESORA,4,1,5
2022/2023,08057965,CFA CAN SERRA,08101,081017,L'HOSPITALET DE LLOBREGAT,10,2,12
2022/2023,08057874,CFA CATALÒNIA,08101,081017,L'HOSPITALET DE LLOBREGAT,5,5,10
2022/2023,08057734,ESCOLA ANTONI GAUDÍ,08250,082508,SANTA MARGARIDA DE MONTBUI,29,5,34
2022/2023,08057679,CFA BELLVITGE-GORNAL,08101,081017,L'HOSPITALET DE LLOBREGAT,10,2,12
2022/2023,08057667,CFA TRINITAT VELLA,08019,080193,BARCELONA,5,1,6
2022/2023,08057540,INSTITUT JOAN BROSSA,08019,080193,BARCELONA,50,33,83
2022/2023,08057281,ZER CEP DE SIS,08249,082495,SANTA FE DEL PENEDÈS,5,1,6
2022/2023,08057266,ESCOLA ELS CINGLES,08005,080057,L'AMETLLA DEL VALLÈS,23,2,25
2022/2023,08057254,INSTITUT PERE RIBOT,08219,082191,VILASSAR DE MAR,32,15,47
2022/2023,08057242,ESCOLA SERENA VALL,08197,081976,SANT ANDREU DE LLAVANERES,26,4,30
2022/2023,08057230,INSTITUT CUBELLES,08074,080749,CUBELLES,40,20,60
2022/2023,08057229,ESCOLA ELS ARENYS,08054,080543,CASTELLBISBAL,16,2,18
2022/2023,08057163,CFA TERESA MAÑÉ,08307,083073,VILANOVA I LA GELTRÚ,8,7,15
2022/2023,08057102,ESCOLA ANDERSEN,08298,082981,VIC,35,1,36
2022/2023,08057096,ESCOLA GUILLEM DE MONT-RODON,08298,082981,VIC,31,6,37
2022/2023,08057011,CFA CAN RULL,08187,081878,SABADELL,6,3,9
2022/2023,08057001,CFA LA CREU DE BARBERÀ,08187,081878,SABADELL,6,3,9
2022/2023,08056997,CFA LA CONCÒRDIA,08187,081878,SABADELL,10,7,17
2022/2023,08056985,INSTITUT RAMON BERENGUER IV,08245,082457,SANTA COLOMA DE GRAMENET,50,28,78
2022/2023,08056857,ZER GAVARRESA,08212,082129,SANT FELIU SASSERRA,5,0,5
2022/2023,08056833,ZER BAIX MONTSENY,08259,082592,SANTA MARIA DE PALAUTORDERA,4,1,5
2022/2023,08056811,ZER ALT BERGUEDÀ,08293,082938,VALLCEBRE,3,1,4
2022/2023,08056791,ZER VENT D'AVALL,08170,081705,ELS PRATS DE REI,4,2,6
2022/2023,08056781,ZER SERRA D'ANCOSA,08104,081043,LA LLACUNA,3,2,5
2022/2023,08056766,ZER SUBIRATS,08273,082732,SUBIRATS,4,0,4
2022/2023,08056742,ZER ALT LLUÇANÈS,08201,082016,SANT BOI DE LLUÇANÈS,2,2,4
2022/2023,08056729,ZER EL MOIANÈS PONENT,08034,080348,CALDERS,4,1,5
2022/2023,08056614,ESCOLA CIRERA,08121,081213,MATARÓ,22,1,23
2022/2023,08056584,CFA L'ALZINA DE CERDANYOLA,08266,082665,CERDANYOLA DEL VALLÈS,7,3,10
2022/2023,08056572,CFA TERRA BAIXA,08169,081691,EL PRAT DE LLOBREGAT,6,7,13
2022/2023,08056560,CFA BARBERÀ,08252,082520,BARBERÀ DEL VALLÈS,5,5,10
2022/2023,08056109,INSTITUT CAN VILUMARA,08101,081017,L'HOSPITALET DE LLOBREGAT,64,31,95
2022/2023,08055944,INSTITUT RUBIÓ I ORS,08101,081017,L'HOSPITALET DE LLOBREGAT,29,16,45
2022/2023,08055932,ESCOLA TORRENT DE CAN CARABASSA,08019,080193,BARCELONA,25,5,30
2022/2023,08055890,ESCOLA SOBIRANS,08007,080076,ARENYS DE MUNT,25,3,28
2022/2023,08055889,ESCOLA MIQUEL MARTÍ I POL,08187,081878,SABADELL,30,1,31
2022/2023,08055713,CFA SANT CUGAT DEL VALLÈS,08205,082055,SANT CUGAT DEL VALLÈS,7,1,8
2022/2023,08055695,CFA RAFAEL FARRÉ,08123,081234,MOLINS DE REI,3,4,7
2022/2023,08055683,CFA MANUEL SACRISTÁN,08019,080193,BARCELONA,6,6,12
2022/2023,08055440,CFA GARROSA,08263,082634,SANT VICENÇ DELS HORTS,7,4,11
2022/2023,08055439,CFA MESTRE ESTEVE,08211,082114,SANT FELIU DE LLOBREGAT,6,3,9
2022/2023,08055403,CFA SANT ROC,08015,080155,BADALONA,6,3,9
2022/2023,08055397,CFA JAUME TUSET,08180,081803,RIPOLLET,8,5,13
2022/2023,08055385,CFA MOLLET DEL VALLÈS,08124,081249,MOLLET DEL VALLÈS,6,4,10
2022/2023,08055105,ESCOLA ARRAONA,08187,081878,SABADELL,21,5,26
2022/2023,08055075,CFA TORRE ROMEU,08187,081878,SABADELL,5,1,6
2022/2023,08055063,CFA CANYELLES,08019,080193,BARCELONA,7,1,8
2022/2023,08055051,CFA CASTELLDEFELS,08056,080569,CASTELLDEFELS,6,3,9
2022/2023,08055041,CFA CANOVELLES,08041,080410,CANOVELLES,6,4,10
2022/2023,08055002,CFA BARRI GÒTIC,08019,080193,BARCELONA,6,2,8
2022/2023,08054903,ESCOLA MEDITERRÀNIA,08019,080193,BARCELONA,17,5,22
2022/2023,08054873,INSTITUT JOAQUIMA PLA I FARRERAS,08205,082055,SANT CUGAT DEL VALLÈS,46,15,61
2022/2023,08054824,ESCOLA MESTRE PLA,08051,080517,CASTELLAR DEL VALLÈS,14,2,16
2022/2023,08054411,ESCOLA VALLGORGUINA,08294,082943,VALLGORGUINA,12,3,15
2022/2023,08054401,INSTITUT EL SUI,08046,080462,CARDEDEU,38,21,59
2022/2023,08054368,CEE CA N'ORIOL,08184,081846,RUBÍ,23,2,25
2022/2023,08054344,EOI ESPLUGUES,08077,080771,ESPLUGUES DE LLOBREGAT,12,3,15
2022/2023,08054277,INSTITUT DE TONA,08283,082830,TONA,47,24,71
2022/2023,08054241,INSTITUT EUGENI XAMMAR,08005,080057,L'AMETLLA DEL VALLÈS,26,18,44
2022/2023,08054228,INSTITUT DOLORS ALEU,08019,080193,BARCELONA,33,15,48
2022/2023,08054198,INSTITUT ESTANY DE LA RICARDA,08169,081691,EL PRAT DE LLOBREGAT,29,18,47
2022/2023,08054186,INSTITUT CAN MAS,08180,081803,RIPOLLET,35,17,52
2022/2023,08054174,INSTITUT LA RIBERA,08125,081252,MONTCADA I REIXAC,28,16,44
2022/2023,08054113,ESCOLA ANXANETA,08121,081213,MATARÓ,29,5,34
2022/2023,08054061,ESCOLA MONTBAIG,08200,082009,SANT BOI DE LLOBREGAT,15,5,20
2022/2023,08054058,ESCOLA TORRE DE LA MIRANDA,08073,080734,CORNELLÀ DE LLOBREGAT,34,5,39
2022/2023,08054034,INSTITUT GALLECS,08124,081249,MOLLET DEL VALLÈS,85,44,129
2022/2023,08054022,ESCOLA MARINADA,08019,080193,BARCELONA,16,1,17
2022/2023,08053650,ESCOLA TURÓ DE GUIERA,08266,082665,CERDANYOLA DEL VALLÈS,24,7,31
2022/2023,08053601,ESCOLA LOLA ANGLADA,08114,081141,MARTORELL,30,2,32
2022/2023,08053583,ESCOLA MARIA OSSÓ,08270,082704,SITGES,29,4,33
2022/2023,08053571,INST-ESC ART. ORIOL MARTORELL,08019,080193,BARCELONA,98,49,147
2022/2023,08053522,ESCOLA LA GINESTA,08295,082956,VALLIRANA,16,1,17
2022/2023,08053510,ESCOLA PUIG D'AGULLES,08072,080728,CORBERA DE LLOBREGAT,15,4,19
2022/2023,08053492,ESCOLA TERESA CLARAMUNT,08187,081878,SABADELL,28,2,30
2022/2023,08053467,ESCOLA PALAU,08156,081568,PALAU-SOLITÀ I PLEGAMANS,26,4,30
2022/2023,08053455,ESCOLA LES AIGÜES,08046,080462,CARDEDEU,26,5,31
2022/2023,08053443,EOI SANTA COLOMA,08245,082457,SANTA COLOMA DE GRAMENET,9,4,13
2022/2023,08053431,ESCOLA EL ROURE,08168,081688,PONTONS,3,1,4
2022/2023,08053421,ESCOLA ALOC,08163,081635,PINEDA DE MAR,22,6,28
2022/2023,08053406,ESCOLA CAN BESORA,08124,081249,MOLLET DEL VALLÈS,26,3,29
2022/2023,08053391,ESCOLA LLEDONER,08096,080961,GRANOLLERS,23,10,33
2022/2023,08053364,INSTITUT JOSEP MESTRES I BUSQUETS,08301,083015,VILADECANS,38,20,58
2022/2023,08053352,INSTITUT MONTBUI,08250,082508,SANTA MARGARIDA DE MONTBUI,47,25,72
2022/2023,08053340,INSTITUT GABRIELA MISTRAL,08263,082634,SANT VICENÇ DELS HORTS,57,45,102
2022/2023,08053315,INSTITUT MONTSERRAT ROIG,08196,081960,SANT ANDREU DE LA BARCA,34,28,62
2022/2023,08053297,INSTITUT DE PALLEJÀ,08157,081574,PALLEJÀ,36,23,59
2022/2023,08053285,INSTITUT EL CASTELL,08076,080765,ESPARREGUERA,43,32,75
2022/2023,08053261,INSTITUT DE VILADECAVALLS,08300,083008,VILADECAVALLS,40,26,66
2022/2023,08053251,INSTITUT CAVALL BERNAT,08279,082798,TERRASSA,58,35,93
2022/2023,08053248,INSTITUT DE SENTMENAT,08267,082671,SENTMENAT,34,16,50
2022/2023,08053236,INSTITUT ROVIRA-FORNS,08260,082606,SANTA PERPÈTUA DE MOGODA,34,26,60
2022/2023,08053224,INSTITUT LES TERMES,08187,081878,SABADELL,32,18,50
2022/2023,08053212,INSTITUT JONQUERES,08187,081878,SABADELL,40,19,59
2022/2023,08053200,INSTITUT MIQUEL CRUSAFONT I PAIRÓ,08187,081878,SABADELL,31,17,48
2022/2023,08053194,EOI DE TERRASSA,08279,082798,TERRASSA,15,9,24
2022/2023,08053182,INSTITUT LA SERRETA,08184,081846,RUBÍ,68,34,102
2022/2023,08053170,INSTITUT POLINYÀ,08167,081672,POLINYÀ,38,25,63
2022/2023,08053169,INSTITUT MATADEPERA,08120,081206,MATADEPERA,40,21,61
2022/2023,08053157,INSTITUT GORGS,08266,082665,CERDANYOLA DEL VALLÈS,30,20,50
2022/2023,08053145,INSTITUT CASTELLBISBAL,08054,080543,CASTELLBISBAL,41,32,73
2022/2023,08053121,INSTITUT TARADELL,08278,082785,TARADELL,37,20,57
2022/2023,08053111,INSTITUT D'AURO,08192,081923,SANTPEDOR,36,14,50
2022/2023,08053108,INSTITUT REGUISSOL,08259,082592,SANTA MARIA DE PALAUTORDERA,32,13,45
2022/2023,08053091,INSTITUT EL FOIX,08251,082515,SANTA MARGARIDA I ELS MONJOS,47,23,70
2022/2023,08053078,INSTITUT NUMÀNCIA,08245,082457,SANTA COLOMA DE GRAMENET,39,21,60
2022/2023,08053054,INSTITUT GERBERT D'AURILLAC,08213,082135,SANT FRUITÓS DE BAGES,39,14,53
2022/2023,08053042,INSTITUT MIQUEL MARTÍ I POL,08183,081831,RODA DE TER,40,11,51
2022/2023,08053030,INSTITUT DE LA ROCA DEL VALLÈS,08181,081810,LA ROCA DEL VALLÈS,33,18,51
2022/2023,08053029,EOI BADALONA,08015,080155,BADALONA,8,3,11
2022/2023,08053017,INSTITUT VALERIÀ PUJOL I BOSCH,08230,082303,PREMIÀ DE DALT,25,15,40
2022/2023,08053005,INSTITUT CASTELL DE QUER,08171,081712,PRATS DE LLUÇANÈS,27,9,36
2022/2023,08052992,INSTITUT EUCLIDES,08163,081635,PINEDA DE MAR,38,19,57
2022/2023,08052980,INSTITUT MONTMELÓ,08135,081350,MONTMELÓ,40,18,58
2022/2023,08052979,INSTITUT JOSEP PUIG I CADAFALCH,08121,081213,MATARÓ,54,33,87
2022/2023,08052955,INSTITUT DE LLIÇÀ,08107,081075,LLIÇÀ D'AMUNT,48,36,84
2022/2023,08052931,EOI DEL MARESME,08121,081213,MATARÓ,11,2,13
2022/2023,08052921,INSTITUT EUGENI D'ORS,08101,081017,L'HOSPITALET DE LLOBREGAT,35,12,47
2022/2023,08052918,INSTITUT BISBE BERENGUER,08101,081017,L'HOSPITALET DE LLOBREGAT,32,19,51
2022/2023,08052906,INSTITUT LAURO,08086,080863,LES FRANQUESES DEL VALLÈS,54,28,82
2022/2023,08052891,INSTITUT L'ALT BERGUEDÀ,08016,080168,BAGÀ,26,16,42
2022/2023,08052888,INSTITUT JÚLIA MINGUELL,08015,080155,BADALONA,36,22,58
2022/2023,08052876,INSTITUT D'ARGENTONA,08009,080095,ARGENTONA,48,25,73
2022/2023,08052839,INSTITUT CONSELL DE CENT,08019,080193,BARCELONA,23,15,38
2022/2023,08052827,INSTITUT LLUÍS DOMÈNECH I MONTANER,08019,080193,BARCELONA,28,23,51
2022/2023,08052797,INSTITUT SALVADOR ESPRIU,08019,080193,BARCELONA,40,20,60
2022/2023,08052785,ESCOLA VILA OLÍMPICA,08019,080193,BARCELONA,29,3,32
2022/2023,08052724,INSTITUT FRANCISCO DE GOYA,08019,080193,BARCELONA,29,17,46
2022/2023,08052700,INSTITUT VALL D'HEBRON,08019,080193,BARCELONA,94,49,143
2022/2023,08052670,ESCOLA AURÓ,08019,080193,BARCELONA,34,2,36
2022/2023,08052669,ESCOLA FERRAN SUNYER,08019,080193,BARCELONA,32,3,35
2022/2023,08052657,ESCOLA FORT PIENC,08019,080193,BARCELONA,28,2,30
2022/2023,08052621,ESCOLA PAU ROMEVA,08019,080193,BARCELONA,28,3,31
2022/2023,08052608,INSTITUT PAU CLARIS,08019,080193,BARCELONA,19,18,37
2022/2023,08052581,INSTITUT MIQUEL TARRADELL,08019,080193,BARCELONA,55,14,69
2022/2023,08052207,INSTITUT DE PUIG-REIG,08175,081751,PUIG-REIG,24,15,39
2022/2023,08052165,ESCOLA OCTAVIO PAZ,08019,080193,BARCELONA,13,4,17
2022/2023,08051471,ESCOLA JOSEP MARIA FOLCH I TORRES,08101,081017,L'HOSPITALET DE LLOBREGAT,25,9,34
2022/2023,08051318,ESCOLA SANT LLORENÇ DEL MUNT,08279,082798,TERRASSA,27,5,32
2022/2023,08051306,ESCOLA ABAT MARCET,08279,082798,TERRASSA,26,4,30
2022/2023,08051264,INSTITUT EDUARD FONTSERÈ,08101,081017,L'HOSPITALET DE LLOBREGAT,26,21,47
2022/2023,08051240,ESCOLA MEDITERRÀNIA,08073,080734,CORNELLÀ DE LLOBREGAT,29,3,32
2022/2023,08047832,INSTITUT JOAN COROMINES,08163,081635,PINEDA DE MAR,69,30,99
2022/2023,08047820,INSTITUT GUINOVARDA,08161,081614,PIERA,55,21,76
2022/2023,08047583,INSTITUT SANT QUIRZE DEL VALLÈS,08238,082384,SANT QUIRZE DEL VALLÈS,50,26,76
2022/2023,08047509,INSTITUT ÍTACA,08200,082009,SANT BOI DE LLOBREGAT,33,23,56
2022/2023,08047492,INSTITUT RIBERA BAIXA,08169,081691,EL PRAT DE LLOBREGAT,31,22,53
2022/2023,08047480,INSTITUT MEDITERRÀNIA,08056,080569,CASTELLDEFELS,63,35,98
2022/2023,08047479,INSTITUT ALBA DEL VALLÈS,08209,082093,SANT FOST DE CAMPSENTELLES,44,26,70
2022/2023,08047467,INSTITUT ALEXANDRE GALÍ,08231,082310,SANT PERE DE RIBES,48,20,68
2022/2023,08047431,INSTITUT XXV OLIMPÍADA,08019,080193,BARCELONA,35,23,58
2022/2023,08047421,INSTITUT MONTSERRAT ROIG,08019,080193,BARCELONA,31,15,46
2022/2023,08047376,INSTITUT LLOBREGAT,08191,081918,SALLENT,28,16,44
2022/2023,08047364,INSTITUT JOAN MERCADER,08102,081022,IGUALADA,43,28,71
2022/2023,08046876,INSTITUT MIQUEL BOSCH I JOVER,08010,080109,ARTÉS,27,15,42
2022/2023,08046864,INSTITUT BELLULLA,08041,080410,CANOVELLES,41,22,63
2022/2023,08046852,INSTITUT LLAVANERES,08197,081976,SANT ANDREU DE LLAVANERES,35,22,57
2022/2023,08046840,INSTITUT CASTELLET,08262,082628,SANT VICENÇ DE CASTELLET,46,42,88
2022/2023,08046803,INSTITUT VILATZARA,08219,082191,VILASSAR DE MAR,38,32,70
2022/2023,08046797,INSTITUT LAIA L'ARQUERA,08121,081213,MATARÓ,40,26,66
2022/2023,08046785,INSTITUT D'ALELLA,08003,080039,ALELLA,34,28,62
2022/2023,08046761,INSTITUT GUILLEM CATÀ,08113,081136,MANRESA,93,49,142
2022/2023,08046751,INSTITUT VENTURA GASSOL,08015,080155,BADALONA,35,16,51
2022/2023,08046748,INSTITUT THOS I CODINA,08121,081213,MATARÓ,67,51,118
2022/2023,08046736,INSTITUT MILÀ I FONTANALS,08305,083054,VILAFRANCA DEL PENEDÈS,52,30,82
2022/2023,08046724,INSTITUT MONTSERRAT ROIG,08279,082798,TERRASSA,74,37,111
2022/2023,08046694,INSTITUT CENTRE D'ALT RENDIMENT ESPORTIU,08205,082055,SANT CUGAT DEL VALLÈS,23,35,58
2022/2023,08046682,INSTITUT DE CASTELLAR,08051,080517,CASTELLAR DEL VALLÈS,39,31,70
2022/2023,08046670,INSTITUT ANGELETA FERRER I SENSAT,08205,082055,SANT CUGAT DEL VALLÈS,45,26,71
2022/2023,08046669,INSTITUT RIBOT I SERRA,08187,081878,SABADELL,50,15,65
2022/2023,08046657,INSTITUT JOAQUIM BLUME,08077,080771,ESPLUGUES DE LLOBREGAT,12,16,28
2022/2023,08046645,INSTITUT MOLÍ DE LA VILA,08044,080446,CAPELLADES,34,20,54
2022/2023,08046608,INSTITUT PRÍNCEP DE VIANA,08019,080193,BARCELONA,30,19,49
2022/2023,08046581,INSTITUT LLUÍS VIVES,08019,080193,BARCELONA,29,13,42
2022/2023,08046293,ESCOLA CAVALL BERNAT,08019,080193,BARCELONA,15,4,19
2022/2023,08046281,ESCOLA ESTEL-GUINARDÓ,08019,080193,BARCELONA,12,4,16
2022/2023,08045860,INSTITUT MIRAMAR,08301,083015,VILADECANS,29,29,58
2022/2023,08045859,INSTITUT DE CORBERA DE LLOBREGAT,08072,080728,CORBERA DE LLOBREGAT,33,25,58
2022/2023,08045689,INSTITUT VOLTRERA,08001,080018,ABRERA,44,28,72
2022/2023,08045677,INSTITUT THALASSA,08126,081265,MONTGAT,26,20,46
2022/2023,08045665,INSTITUT RAMON TURRÓ I DARDER,08110,081108,MALGRAT DE MAR,47,23,70
2022/2023,08045653,INSTITUT DOLORS MALLAFRÈ I ROS,08307,083073,VILANOVA I LA GELTRÚ,41,20,61
2022/2023,08045641,INSTITUT LLUÍS DOMÈNECH I MONTANER,08040,080403,CANET DE MAR,53,24,77
2022/2023,08045628,INSTITUT CELESTÍ BELLERA,08096,080961,GRANOLLERS,45,15,60
2022/2023,08045604,INSTITUT ENRIC BORRÀS,08015,080155,BADALONA,54,30,84
2022/2023,08045598,ESCOLA MIL·LENARI,08046,080462,CARDEDEU,29,1,30
2022/2023,08045586,ESCOLA LES PRUNERES,08115,081154,MARTORELLES,15,1,16
2022/2023,08045574,ESCOLA SERRA DE MARINA,08245,082457,SANTA COLOMA DE GRAMENET,25,8,33
2022/2023,08045562,INSTITUT CAN PLANAS,08252,082520,BARBERÀ DEL VALLÈS,39,27,66
2022/2023,08045549,INSTITUT BANÚS,08266,082665,CERDANYOLA DEL VALLÈS,41,19,60
2022/2023,08045537,INSTITUT JOSEP LLUÍS SERT,08056,080569,CASTELLDEFELS,40,26,66
2022/2023,08045525,INSTITUT MANUEL CARRASCO I FORMIGUERA,08019,080193,BARCELONA,26,13,39
2022/2023,08045513,INSTITUT FLOS I CALCAT,08019,080193,BARCELONA,34,17,51
2022/2023,08045483,INSTITUT VILA DE GRÀCIA,08019,080193,BARCELONA,28,11,39
2022/2023,08045471,INSTITUT POMPEU FABRA,08015,080155,BADALONA,51,62,113
2022/2023,08045306,INSTITUT RAMON CASAS I CARBÓ,08156,081568,PALAU-SOLITÀ I PLEGAMANS,40,29,69
2022/2023,08045227,CEE LES AIGÜES,08121,081213,MATARÓ,45,2,47
2022/2023,08045203,INSTITUT OBERT DE CATALUNYA,08019,080193,BARCELONA,71,68,139
2022/2023,08045070,INSTITUT EUROPA,08101,081017,L'HOSPITALET DE LLOBREGAT,24,10,34
2022/2023,08045057,ESCOLA EL SAGRER,08019,080193,BARCELONA,33,1,34
2022/2023,08045045,ESCOLA MEDITERRÀNIA,08163,081635,PINEDA DE MAR,15,3,18
2022/2023,08045033,ESCOLA MONTPALAU,08163,081635,PINEDA DE MAR,14,5,19
2022/2023,08045021,INSTITUT ESTELA IBÈRICA,08260,082606,SANTA PERPÈTUA DE MOGODA,46,31,77
2022/2023,08045011,INSTITUT TORRE DEL PALAU,08279,082798,TERRASSA,52,21,73
2022/2023,08044995,INSTITUT BARRES I ONES,08015,080155,BADALONA,43,23,66
2022/2023,08044983,INSTITUT LLUÍS COMPANYS,08284,082845,TORDERA,37,25,62
2022/2023,08044971,INSTITUT PERE FONTDEVILA,08092,080924,GIRONELLA,29,12,41
2022/2023,08044961,ESCRBC DE CATALUNYA,08019,080193,BARCELONA,17,8,25
2022/2023,08044958,INSTITUT JOSEP PLA,08019,080193,BARCELONA,32,17,49
2022/2023,08044934,INSTITUT ESCOLA D'HOTELERIA I TURISME DE BARCELONA,08019,080193,BARCELONA,47,38,85
2022/2023,08044922,INSTITUT DR. PUIGVERT,08019,080193,BARCELONA,43,27,70
2022/2023,08044910,ESCOLA EL TURONET,08238,082384,SANT QUIRZE DEL VALLÈS,17,0,17
2022/2023,08044715,INSTITUT JAUME MIMÓ,08266,082665,CERDANYOLA DEL VALLÈS,55,42,97
2022/2023,08044648,ESCOLA LA RODA,08279,082798,TERRASSA,26,4,30
2022/2023,08044636,EOI DE SABADELL,08187,081878,SABADELL,18,6,24
2022/2023,08044624,INSTITUT SABADELL,08187,081878,SABADELL,54,49,103
2022/2023,08044612,INSTITUT TORRE DE MALLA,08159,081593,PARETS DEL VALLÈS,45,38,83
2022/2023,08044600,INSTITUT MOIANÈS,08138,081385,MOIÀ,29,24,53
2022/2023,08044594,INSTITUT GIOLA,08106,081069,LLINARS DEL VALLÈS,41,24,65
2022/2023,08044582,EOI DE L'HOSPITALET DE LLOBREGAT,08101,081017,L'HOSPITALET DE LLOBREGAT,19,8,27
2022/2023,08044570,INSTITUT VALL D'ARÚS,08295,082956,VALLIRANA,43,28,71
2022/2023,08044569,INSTITUT PERE BARNILS,08067,080673,CENTELLES,45,27,72
2022/2023,08044545,ESCOLA COLLBAIX,08218,082188,SANT JOAN DE VILATORRADA,12,4,16
2022/2023,08044533,INSTITUT LA FERRERIA,08125,081252,MONTCADA I REIXAC,72,57,129
2022/2023,08044521,ESCOLA ELS PINETONS,08088,080885,LA GARRIGA,26,4,30
2022/2023,08044511,EOI BARCELONA-VALL D'HEBRON,08019,080193,BARCELONA,34,6,40
2022/2023,08044508,ESCOLA ÍTACA,08015,080155,BADALONA,22,0,22
2022/2023,08044454,ESCOLA PILARÍN BAYÉS,08238,082384,SANT QUIRZE DEL VALLÈS,28,2,30
2022/2023,08044430,ESCOLA LA GARALDA,08157,081574,PALLEJÀ,32,2,34
2022/2023,08044314,ESCOLA ANDREU CASTELLS,08187,081878,SABADELL,27,6,33
2022/2023,08044302,ESCOLA JOAN ABELLÓ,08124,081249,MOLLET DEL VALLÈS,27,3,30
2022/2023,08060228,CFA EL CLOT,08019,080193,BARCELONA,5,6,11
2022/2023,08044296,ESCOLA SALVADOR ESPRIU,08015,080155,BADALONA,25,4,29
2022/2023,08044247,ESCOLA ESTEL,08123,081234,MOLINS DE REI,15,1,16
2022/2023,08044223,CEE L'ESTEL- CAN BORI,08101,081017,L'HOSPITALET DE LLOBREGAT,31,5,36
2022/2023,08044201,ESCOLA DOVELLA,08019,080193,BARCELONA,16,0,16
2022/2023,08044168,INSTITUT PLA DE LES MORERES,08302,083020,VILANOVA DEL CAMÍ,48,25,73
2022/2023,08044156,EA DEIÀ,08019,080193,BARCELONA,28,20,48
2022/2023,08044120,CFA FREIRE,08019,080193,BARCELONA,5,4,9
2022/2023,08044077,EA JOSEP SERRA I ABELLA,08101,081017,L'HOSPITALET DE LLOBREGAT,33,19,52
2022/2023,08044053,INSTITUT SALVADOR SEGUÍ,08019,080193,BARCELONA,115,30,145
2022/2023,08044028,CEE HORITZÓ,08163,081635,PINEDA DE MAR,24,7,31
2022/2023,08044016,ESCOLA FLAMA,08213,082135,SANT FRUITÓS DE BAGES,28,4,32
2022/2023,08043981,INSTITUT JOAN RAMON BENAPRÈS,08270,082704,SITGES,49,37,86
2022/2023,08043978,INSTITUT DANIEL BLANXART I PEDRALS,08147,081477,OLESA DE MONTSERRAT,57,57,114
2022/2023,08043966,ESCOLA HEURA,08019,080193,BARCELONA,14,2,16
2022/2023,08043954,ESCOLA RIBATALLADA,08187,081878,SABADELL,16,2,18
2022/2023,08043942,ESCOLA MONTBUI,08033,080333,CALDES DE MONTBUI,26,3,29
2022/2023,08043930,ESCOLA MARINADA,08118,081189,EL MASNOU,14,2,16
2022/2023,08043929,ESCOLA LLEBETX,08307,083073,VILANOVA I LA GELTRÚ,18,3,21
2022/2023,08043917,ESCOLA COSSETÀNIA,08307,083073,VILANOVA I LA GELTRÚ,14,2,16
2022/2023,08043905,ESCOLA EL DOFÍ,08172,081727,PREMIÀ DE MAR,15,1,16
2022/2023,08043899,ESCOLA TÀBER,08019,080193,BARCELONA,29,3,32
2022/2023,08043887,ESCOLA SAGRADA FAMÍLIA,08019,080193,BARCELONA,29,3,32
2022/2023,08043875,ESCOLA PIT-ROIG,08019,080193,BARCELONA,12,4,16
2022/2023,08043863,ESCOLA ORLANDAI,08019,080193,BARCELONA,16,0,16
2022/2023,08043851,ESCOLA NABÍ,08019,080193,BARCELONA,12,4,16
2022/2023,08043841,ESCOLA LAVÍNIA,08019,080193,BARCELONA,14,2,16
2022/2023,08043838,ESCOLA TURÓ DEL CARGOL,08019,080193,BARCELONA,17,1,18
2022/2023,08043814,ESCOLA CARLIT,08019,080193,BARCELONA,15,2,17
2022/2023,08043796,ESCOLA BARRUFET,08019,080193,BARCELONA,26,4,30
2022/2023,08043784,ESCOLA ÀNGELS GARRIGA,08019,080193,BARCELONA,13,3,16
2022/2023,08043760,ESCOLA COLÒNIA GÜELL,08244,082444,SANTA COLOMA DE CERVELLÓ,26,4,30
2022/2023,08043747,ESCOLA BALOO,08019,080193,BARCELONA,14,2,16
2022/2023,08043693,INSTITUT JOAQUIM MIR,08307,083073,VILANOVA I LA GELTRÚ,61,50,111
2022/2023,08043681,INSTITUT MARIANAO,08200,082009,SANT BOI DE LLOBREGAT,51,43,94
2022/2023,08043671,INSTITUT EL PALAU,08196,081960,SANT ANDREU DE LA BARCA,56,55,111
2022/2023,08043668,INSTITUT L'ESTATUT,08184,081846,RUBÍ,45,39,84
2022/2023,08043656,INSTITUT MARINA,08105,081056,LA LLAGOSTA,47,48,95
2022/2023,08043644,INSTITUT CARLES VALLBONA,08096,080961,GRANOLLERS,62,57,119
2022/2023,08043589,INSTITUT SALVADOR DALÍ,08169,081691,EL PRAT DE LLOBREGAT,43,23,66
2022/2023,08043516,INSTITUT SANTA EULÀLIA,08279,082798,TERRASSA,54,75,129
2022/2023,08043504,INSTITUT PERE CALDERS,08266,082665,CERDANYOLA DEL VALLÈS,22,19,41
2022/2023,08043486,INSTITUT MANOLO HUGUÉ,08033,080333,CALDES DE MONTBUI,49,33,82
2022/2023,08043474,ESCOLA L'ESTEL,08019,080193,BARCELONA,17,2,19
2022/2023,08043462,INSTITUT ERNEST LLUCH,08019,080193,BARCELONA,42,28,70
2022/2023,08043437,ESCOLA FONT DE L'ALBA,08279,082798,TERRASSA,21,4,25
2022/2023,08043401,ESCOLA BARRUFET,08200,082009,SANT BOI DE LLOBREGAT,16,8,24
2022/2023,08043395,INSTITUT ALEXANDRE DE RIQUER,08031,080312,CALAF,22,11,33
2022/2023,08043383,ESCOLA NOSTRA LLAR,08187,081878,SABADELL,27,5,32
2022/2023,08043371,ESCOLA LA LIÓ,08172,081727,PREMIÀ DE MAR,12,4,16
2022/2023,08043361,ESCOLA EL TURÓ,08125,081252,MONTCADA I REIXAC,15,2,17
2022/2023,08043346,ESCOLA MONTSERRAT,08076,080765,ESPARREGUERA,15,2,17
2022/2023,08043334,ESCOLA ALEXANDRE GALÍ,08073,080734,CORNELLÀ DE LLOBREGAT,15,2,17
2022/2023,08043310,ESCOLA EDUMAR,08056,080569,CASTELLDEFELS,28,5,33
2022/2023,08043292,ESCOLA TABOR,08019,080193,BARCELONA,27,6,33
2022/2023,08043279,ESCOLA POMPEU FABRA,08019,080193,BARCELONA,13,4,17
2022/2023,08043267,ESCOLA PAU CASALS-GRÀCIA,08019,080193,BARCELONA,25,5,30
2022/2023,08043115,ESCOLA PROVENÇALS,08019,080193,BARCELONA,25,5,30
2022/2023,08043103,ESCOLA ANTONI BALMANYA,08019,080193,BARCELONA,25,6,31
2022/2023,08042895,ESCOLA SCHOLA,08184,081846,RUBÍ,16,0,16
2022/2023,08042883,ESCOLA SANT JOSEP - EL PI,08101,081017,L'HOSPITALET DE LLOBREGAT,14,2,16
2022/2023,08042871,ESCOLA PATUFET SANT JORDI-FRANCESC BATALLÉ I ARA,08101,081017,L'HOSPITALET DE LLOBREGAT,31,2,33
2022/2023,08042861,ESCOLA LOLA ANGLADA,08077,080771,ESPLUGUES DE LLOBREGAT,15,1,16
2022/2023,08042858,CFA ELS TARONGERS,08121,081213,MATARÓ,8,3,11
2022/2023,08042846,CFA CORNELLÀ DE LLOBREGAT,08073,080734,CORNELLÀ DE LLOBREGAT,11,4,15
2022/2023,08042834,ESCOLA CAN PALMER,08301,083015,VILADECANS,21,2,23
2022/2023,08042810,ESCOLA CHARLES DARWIN,08169,081691,EL PRAT DE LLOBREGAT,30,4,34
2022/2023,08042809,ESCOLA GALILEO GALILEI,08169,081691,EL PRAT DE LLOBREGAT,28,2,30
2022/2023,08042792,ESCOLA DAMIÀ MATEU,08106,081069,LLINARS DEL VALLÈS,16,2,18
2022/2023,08042780,ESCOLA JOSEP MARIA JUJOL,08019,080193,BARCELONA,25,6,31
2022/2023,08042342,INSTITUT DE BADIA DEL VALLÈS,08904,089045,BADIA DEL VALLÈS,36,45,81
2022/2023,08042330,INSTITUT SANT RAMON,08047,080478,CARDONA,11,9,20
2022/2023,08042329,ESCOLA ELS XIPRERS,08019,080193,BARCELONA,11,5,16
2022/2023,08042305,ESCOLA JOAN MIRÓ,08019,080193,BARCELONA,28,2,30
2022/2023,08042299,ESCOLA SANT MIQUEL,08073,080734,CORNELLÀ DE LLOBREGAT,27,4,31
2022/2023,08042287,ESCOLA SALVADOR ESPRIU,08096,080961,GRANOLLERS,29,3,32
2022/2023,08042101,INSTITUT MANUEL VÁZQUEZ MONTALBÁN,08194,081944,SANT ADRIÀ DE BESÒS,40,22,62
2022/2023,08042093,INSTITUT VINYES VELLES,08136,081363,MONTORNÈS DEL VALLÈS,35,24,59
2022/2023,08042056,INSTITUT CAN PUIG,08231,082310,SANT PERE DE RIBES,43,30,73
2022/2023,08042044,INSTITUT MIG-MÓN,08274,082747,SÚRIA,35,17,52
2022/2023,08042020,INSTITUT VALLÈS,08187,081878,SABADELL,44,23,67
2022/2023,08042019,INSTITUT BADALONA VII,08015,080155,BADALONA,41,38,79
2022/2023,08041866,INSTITUT EL CALAMOT,08089,080898,GAVÀ,67,50,117
2022/2023,08041751,ESCOLA LA CAIXA,08019,080193,BARCELONA,16,3,19
2022/2023,08041726,ESCOLA ROC BLANC,08300,083008,VILADECAVALLS,19,2,21
2022/2023,08041714,ESCOLA LES BASSEROLES,08269,082690,SEVA,13,3,16
2022/2023,08041696,ESCOLA VAIXELL BURRIAC,08219,082191,VILASSAR DE MAR,27,4,31
2022/2023,08041684,ESCOLA ESPAI 3,08217,082172,SANT JOAN DESPÍ,29,1,30
2022/2023,08041672,ESCOLA CREU ALTA,08187,081878,SABADELL,13,4,17
2022/2023,08041660,ESCOLA PONT DE LA CADENA,08123,081234,MOLINS DE REI,16,1,17
2022/2023,08041659,ESCOLA MESTRES MONTAÑA,08096,080961,GRANOLLERS,29,3,32
2022/2023,08041647,ESCOLA PONENT,08096,080961,GRANOLLERS,30,7,37
2022/2023,08041611,ESCOLA JOANOT ALISANDA,08187,081878,SABADELL,33,1,34
2022/2023,08041601,ESCOLA TORRE DE LA LLEBRE,08184,081846,RUBÍ,17,2,19
2022/2023,08041581,ESCOLA GITANJALI,08015,080155,BADALONA,14,2,16
2022/2023,08041571,ESCOLA ARTUR MARTORELL,08015,080155,BADALONA,16,2,18
2022/2023,08041568,ESCOLA JUNGFRAU,08015,080155,BADALONA,28,6,34
2022/2023,08041556,ESCOLA MONTSENY,08221,082212,SANT JUST DESVERN,19,0,19
2022/2023,08041519,INSTITUT MARTÍ DOT,08211,082114,SANT FELIU DE LLOBREGAT,55,44,99
2022/2023,08041374,INSTITUT LA MALLOLA,08077,080771,ESPLUGUES DE LLOBREGAT,37,17,54
2022/2023,08041246,ESCOLA FRANCESC ALDEA I PÉREZ,08279,082798,TERRASSA,16,2,18
2022/2023,08041234,ESCOLA COLLSEROLA,08205,082055,SANT CUGAT DEL VALLÈS,26,5,31
2022/2023,08041222,ESCOLA CAN CLADELLAS,08156,081568,PALAU-SOLITÀ I PLEGAMANS,29,2,31
2022/2023,08041210,ESCOLA DEL BOSC,08252,082520,BARBERÀ DEL VALLÈS,27,3,30
2022/2023,08041180,ESCOLA ROSSELLÓ PÒRCEL,08245,082457,SANTA COLOMA DE GRAMENET,14,3,17
2022/2023,08041179,ESCOLA MESTRE ENRIC GIBERT I CAMINS,08019,080193,BARCELONA,28,5,33
2022/2023,08041167,ESCOLA JOSEP CARNER,08015,080155,BADALONA,31,4,35
2022/2023,08041131,ESCOLA SANT ANTONI,08263,082634,SANT VICENÇ DELS HORTS,15,2,17
2022/2023,08040849,INSTITUT FORT PIUS,08019,080193,BARCELONA,26,19,45
2022/2023,08040618,ESCOLA CAN VIDALET,08077,080771,ESPLUGUES DE LLOBREGAT,14,2,16
2022/2023,08040564,INSTITUT JAUME ALMERA,08214,082140,VILASSAR DE DALT,32,16,48
2022/2023,08040552,INSTITUT ANTONI POUS I ARGILA,08112,081120,MANLLEU,67,30,97
2022/2023,08040540,INSTITUT EL CAIRAT,08076,080765,ESPARREGUERA,48,18,66
2022/2023,08040539,INSTITUT LES MARINES,08056,080569,CASTELLDEFELS,40,17,57
2022/2023,08040527,INSTITUT LA LLAUNA,08015,080155,BADALONA,35,27,62
2022/2023,08040412,ESCOLA EL MARGALLÓ,08307,083073,VILANOVA I LA GELTRÚ,22,2,24
2022/2023,08040400,ESCOLA AMADEU VIVES,08187,081878,SABADELL,26,7,33
2022/2023,08040382,ESCOLA MERCÈ RODOREDA,08245,082457,SANTA COLOMA DE GRAMENET,32,6,38
2022/2023,08040357,CEE FOLCH I CAMARASA,08019,080193,BARCELONA,10,0,10
2022/2023,08040345,ESCOLA MERCÈ RODOREDA,08015,080155,BADALONA,15,1,16
2022/2023,08040333,ESCOLA BERNAT METGE,08169,081691,EL PRAT DE LLOBREGAT,14,3,17
2022/2023,08040141,INSTITUT ICÀRIA,08019,080193,BARCELONA,48,22,70
2022/2023,08040138,INSTITUT LA SEDETA,08019,080193,BARCELONA,21,15,36
2022/2023,08040060,ESCOLA DEL MAR,08219,082191,VILASSAR DE MAR,27,4,31
2022/2023,08040059,ESCOLA JOAN SALVAT I PAPASSEIT,08245,082457,SANTA COLOMA DE GRAMENET,30,3,33
2022/2023,08040047,CEE JOSEP SOL I RODRÍGUEZ,08245,082457,SANTA COLOMA DE GRAMENET,34,8,42
2022/2023,08039896,ESCOLA BELLATERRA,08266,082665,CERDANYOLA DEL VALLÈS,29,4,33
2022/2023,08039835,ESCOLA DE LES AIGÜES,08019,080193,BARCELONA,31,3,34
2022/2023,08039744,ESCOLA DEL PONT TRENCAT - ZER BAIX MONTSENY,08259,082592,SANTA MARIA DE PALAUTORDERA,5,0,5
2022/2023,08039719,ESCOLA LES PLANES,08105,081056,LA LLAGOSTA,24,3,27
2022/2023,08039707,ESCOLA TAGAMANENT,08088,080885,LA GARRIGA,13,3,16
2022/2023,08039690,ESCOLA GERMANS CORBELLA,08046,080462,CARDEDEU,28,3,31
2022/2023,08039677,ESCOLA CONGOST,08041,080410,CANOVELLES,32,5,37
2022/2023,08039665,ESCOLA LANASPA-GIRALT,08279,082798,TERRASSA,15,2,17
2022/2023,08039653,ESCOLA AGUSTÍ BARTRA,08279,082798,TERRASSA,29,5,34
2022/2023,08039641,ESCOLA PABLO PICASSO,08252,082520,BARBERÀ DEL VALLÈS,22,3,25
2022/2023,08039631,ESCOLA L'AGULLOLA,08901,089019,RUPIT I PRUIT,4,0,4
2022/2023,08039628,ESCOLA POMPEU FABRA,08112,081120,MANLLEU,32,4,36
2022/2023,08039616,ESCOLA CAMÍ DEL CROS,08121,081213,MATARÓ,29,3,32
2022/2023,08039604,ESCOLA FRANCESC FERRER I GUÀRDIA,08118,081189,EL MASNOU,14,3,17
2022/2023,08039598,ESCOLA SANT MIQUEL DEL CROS,08009,080095,ARGENTONA,11,1,12
2022/2023,08039586,ESCOLA L'ARJAU,08307,083073,VILANOVA I LA GELTRÚ,25,4,29
2022/2023,08039574,ESCOLA PAU SANS,08101,081017,L'HOSPITALET DE LLOBREGAT,15,1,16
2022/2023,08039562,ESCOLA PRAT DE LA MANTA,08101,081017,L'HOSPITALET DE LLOBREGAT,14,3,17
2022/2023,08039537,ESCOLA TORRENT D'EN MELIS,08019,080193,BARCELONA,25,5,30
2022/2023,08039525,ESCOLA LA SEDETA,08019,080193,BARCELONA,13,3,16
2022/2023,08039495,ESCOLA LA PALMERA,08019,080193,BARCELONA,27,4,31
2022/2023,08039483,ESCOLA ELS HORTS,08019,080193,BARCELONA,18,0,18
2022/2023,08039471,ESCOLA MERCÈ RODOREDA,08019,080193,BARCELONA,28,3,31
2022/2023,08039434,ESCOLA DOCTOR FERRAN I CLUA,08019,080193,BARCELONA,29,3,32
2022/2023,08039380,ESCOLA GERMANS AMAT I TARGA,08301,083015,VILADECANS,24,4,28
2022/2023,08039379,ESCOLA RAFAEL CASANOVA,08200,082009,SANT BOI DE LLOBREGAT,22,4,26
2022/2023,08039367,ESCOLA JOSEP PLA,08196,081960,SANT ANDREU DE LA BARCA,25,6,31
2022/2023,08039355,ESCOLA RAMON LLULL,08169,081691,EL PRAT DE LLOBREGAT,26,4,30
2022/2023,08039343,ESCOLA JOSEP FERRÀ I ESTEVA,08147,081477,OLESA DE MONTSERRAT,29,5,34
2022/2023,08039318,ESCOLA PUIGBERENGUER,08113,081136,MANRESA,31,3,34
2022/2023,08039306,ESCOLA ELS PINS - ZER EL MOIANÈS PONENT,08191,081918,SALLENT,5,1,6
2022/2023,08039291,ESCOLA CRISTÒFOR MESTRE,08305,083054,VILAFRANCA DEL PENEDÈS,29,6,35
2022/2023,08039288,ESCOLA RENAIXENÇA,08122,081228,MEDIONA,9,1,10
2022/2023,08039264,ESCOLA MESTRES MUNGUET-CORTÉS,08902,089024,VILANOVA DEL VALLÈS,25,1,26
2022/2023,08039203,INSTITUT AGUSTÍ SERRA I FONTANET,08187,081878,SABADELL,76,76,152
2022/2023,08039069,INSTITUT MARGARIDA XIRGU,08101,081017,L'HOSPITALET DE LLOBREGAT,39,21,60
2022/2023,08039057,INSTITUT L'ALZINA,08019,080193,BARCELONA,40,13,53
2022/2023,08038582,ESCOLA CATALUNYA,08187,081878,SABADELL,35,1,36
2022/2023,08038570,EOI DE BARCELONA,08019,080193,BARCELONA,76,23,99
2022/2023,08038351,ESCOLA XARAU,08266,082665,CERDANYOLA DEL VALLÈS,15,3,18
2022/2023,08038326,ESCOLA EL VALLÈS,08279,082798,TERRASSA,19,3,22
2022/2023,08043255,ESCOLA ÍTACA,08019,080193,BARCELONA,27,4,31
2022/2023,08038314,ESCOLA MARE DE DÉU DE MONTSERRAT,08279,082798,TERRASSA,17,4,21
2022/2023,08038284,ESCOLA LA GUÀRDIA,08263,082634,SANT VICENÇ DELS HORTS,14,3,17
2022/2023,08038272,ESCOLA GARCÍA LORCA,08250,082508,SANTA MARGARIDA DE MONTBUI,32,4,36
2022/2023,08038260,ESCOLA JOAN MARAGALL,08205,082055,SANT CUGAT DEL VALLÈS,31,2,33
2022/2023,08038259,ESCOLA ANTONI TÀPIES,08200,082009,SANT BOI DE LLOBREGAT,25,4,29
2022/2023,08038247,ESCOLA POMPEU FABRA,08302,083020,VILANOVA DEL CAMÍ,25,4,29
2022/2023,08038223,ESCOLA BENVIURE,08200,082009,SANT BOI DE LLOBREGAT,24,6,30
2022/2023,08038211,ESCOLA JOSÉ JUAN ORTIZ,08196,081960,SANT ANDREU DE LA BARCA,23,4,27
2022/2023,08038201,ESCOLA LA BAUMETA - ZER ELS CASTELLS,08253,082536,SANTA MARIA DE BESORA,2,0,2
2022/2023,08038181,ESCOLA SERRA I HÚNTER,08113,081136,MANRESA,27,6,33
2022/2023,08038171,ESCOLA MONTESSORI,08184,081846,RUBÍ,29,3,32
2022/2023,08038168,ESCOLA LA TORRETA,08181,081810,LA ROCA DEL VALLÈS,13,5,18
2022/2023,08038156,ESCOLA ESCURSELL I BARTALOT,08180,081803,RIPOLLET,30,2,32
2022/2023,08038090,ESCOLA SANT JAUME,08169,081691,EL PRAT DE LLOBREGAT,27,6,33
2022/2023,08038089,ESCOLA SANT ESTEVE - ZER EL CARDENER,08229,082299,SANT MATEU DE BAGES,5,1,6
2022/2023,08038077,ESCOLA CAN PARERA,08136,081363,MONTORNÈS DEL VALLÈS,21,3,24
2022/2023,08038065,ESCOLA MONTSENY,08124,081249,MOLLET DEL VALLÈS,25,4,29
2022/2023,08038041,ESCOLA FEDERICO GARCÍA LORCA,08124,081249,MOLLET DEL VALLÈS,9,2,11
2022/2023,08038031,ESCOLA ROSA SENSAT,08118,081189,EL MASNOU,14,3,17
2022/2023,08038004,ESCOLA JOSEP JANÉS,08101,081017,L'HOSPITALET DE LLOBREGAT,26,7,33
2022/2023,08037991,ESCOLA MARCEL·LÍ MORAGAS,08089,080898,GAVÀ,24,3,27
2022/2023,08037981,ESCOLA DE L'ESTANY - ZER EL MOIANÈS LLEVANT,08079,080790,L'ESTANY,2,3,5
2022/2023,08037978,ESCOLA SURIS,08073,080734,CORNELLÀ DE LLOBREGAT,24,4,28
2022/2023,08037966,ESCOLA IGNASI IGLÉSIAS,08073,080734,CORNELLÀ DE LLOBREGAT,28,5,33
2022/2023,08037930,ESCOLA MARGALLÓ,08056,080569,CASTELLDEFELS,21,4,25
2022/2023,08037929,ESCOLA TORRE BARONA,08056,080569,CASTELLDEFELS,24,4,28
2022/2023,08037917,ESCOLA JOAN MIRÓ,08041,080410,CANOVELLES,14,5,19
2022/2023,08037899,ESCOLA FOLCH I TORRES,08015,080155,BADALONA,17,4,21
2022/2023,08037887,ESCOLA BALDIRI REIXAC,08015,080155,BADALONA,19,4,23
2022/2023,08037875,ESCOLA RAFAEL CASANOVA,08015,080155,BADALONA,30,3,33
2022/2023,08037863,ESCOLA SEAT,08019,080193,BARCELONA,30,4,34
2022/2023,08037841,ESCOLA SPLAI,08019,080193,BARCELONA,15,2,17
2022/2023,08037814,ESCOLA ALEXANDRE GALÍ,08019,080193,BARCELONA,29,4,33
2022/2023,08037528,ESCOLA SANT DOMÈNEC,08251,082515,SANTA MARGARIDA I ELS MONJOS,15,1,16
2022/2023,08037504,ESCOLA MONTNEGRE,08202,082021,SANT CELONI,14,1,15
2022/2023,08037292,CEE CENTRE DE FORMACIÓ I TREBALL FLOR DE MAIG,08266,082665,CERDANYOLA DEL VALLÈS,17,10,27
2022/2023,08037206,INSTITUT LLUÍS COMPANYS,08180,081803,RIPOLLET,44,30,74
2022/2023,08037176,INSTITUT LA BASTIDA,08245,082457,SANTA COLOMA DE GRAMENET,64,33,97
2022/2023,08037152,INSTITUT JOAN ORÓ,08114,081141,MARTORELL,82,51,133
2022/2023,08036411,ESCOLA SALTELLS,08266,082665,CERDANYOLA DEL VALLÈS,22,3,25
2022/2023,08036391,INSTITUT ARQUITECTE MANUEL RASPALL,08046,080462,CARDEDEU,35,19,54
2022/2023,08036378,ESCOLA CHARLIE RIVEL,08101,081017,L'HOSPITALET DE LLOBREGAT,16,6,22
2022/2023,08036366,ESCOLA LOLA ANGLADA,08101,081017,L'HOSPITALET DE LLOBREGAT,18,4,22
2022/2023,08036342,ESCOLA JOAN LLONGUERAS,08015,080155,BADALONA,16,4,20
2022/2023,08036330,INSTITUT J.V. FOIX,08184,081846,RUBÍ,31,38,69
2022/2023,08036147,ESCOLA PAU PICASSO,08015,080155,BADALONA,19,7,26
2022/2023,08036135,ESCOLA JOAN CORET,08015,080155,BADALONA,25,3,28
2022/2023,08036111,ESCOLA MAS I PERERA,08305,083054,VILAFRANCA DEL PENEDÈS,29,4,33
2022/2023,08036101,ESCOLA SAGRADA FAMÍLIA,08245,082457,SANTA COLOMA DE GRAMENET,29,2,31
2022/2023,08036056,ESCOLA FOLCH I TORRES,08077,080771,ESPLUGUES DE LLOBREGAT,28,2,30
2022/2023,08036044,ESCOLA PAU VILA,08076,080765,ESPARREGUERA,27,4,31
2022/2023,08036007,ESCOLA PAU VILA,08211,082114,SANT FELIU DE LLOBREGAT,16,2,18
2022/2023,08035994,ESCOLA SALVADOR ESPRIU,08211,082114,SANT FELIU DE LLOBREGAT,24,5,29
2022/2023,08035969,ESCOLA JOAQUIM BLUME,08187,081878,SABADELL,21,7,28
2022/2023,08035945,ESCOLA LA CARPA,08101,081017,L'HOSPITALET DE LLOBREGAT,41,10,51
2022/2023,08035881,ESCOLA L'ARENY,08073,080734,CORNELLÀ DE LLOBREGAT,31,2,33
2022/2023,08035878,ESCOLA PERE DE TERA,08015,080155,BADALONA,25,6,31
2022/2023,08035854,ESCOLA LLORENS I ARTIGAS,08015,080155,BADALONA,29,2,31
2022/2023,08035696,ESCOLA SANT JULIÀ,08187,081878,SABADELL,20,1,21
2022/2023,08035684,ESCOLA MARIÀ MANENT,08230,082303,PREMIÀ DE DALT,29,2,31
2022/2023,08035623,CEE JERONI DE MORAGAS,08266,082665,CERDANYOLA DEL VALLÈS,17,1,18
2022/2023,08035544,CEE JOSEP PLA,08019,080193,BARCELONA,11,4,15
2022/2023,08035519,ESCOLA ANTONI GAUDÍ,08245,082457,SANTA COLOMA DE GRAMENET,34,3,37
2022/2023,08035477,ESCOLA SANTIAGO RUSIÑOL,08019,080193,BARCELONA,31,2,33
2022/2023,08035465,ESCOLA MARE NOSTRUM,08019,080193,BARCELONA,28,3,31
2022/2023,08035453,ESCOLA TOMÀS MORO,08019,080193,BARCELONA,18,0,18
2022/2023,08035441,ESCOLA CATALÒNIA,08019,080193,BARCELONA,27,4,31
2022/2023,08000153,ESCOLA JOAN MARAGALL,08006,080060,ARENYS DE MAR,35,5,40
2022/2023,08035431,ESCOLA BOGATELL,08019,080193,BARCELONA,26,4,30
2022/2023,08035428,ESCOLA LA FARIGOLA DEL CLOT,08019,080193,BARCELONA,25,8,33
2022/2023,08035416,ESCOLA JOSEP BOADA,08015,080155,BADALONA,29,5,34
2022/2023,08035404,ESCOLA JOAN MIRÓ,08015,080155,BADALONA,14,3,17
2022/2023,08035398,ESCOLA MIGUEL HERNÁNDEZ,08015,080155,BADALONA,17,3,20
2022/2023,08035362,INSTITUT ALT PENEDÈS,08305,083054,VILAFRANCA DEL PENEDÈS,55,38,93
2022/2023,08035350,ESCOLA SANT JOSEP,08263,082634,SANT VICENÇ DELS HORTS,26,3,29
2022/2023,08035349,INSTITUT LA ROMÀNICA,08252,082520,BARBERÀ DEL VALLÈS,67,31,98
2022/2023,08035325,INSTITUT TORRENT DE LES BRUIXES,08245,082457,SANTA COLOMA DE GRAMENET,39,18,57
2022/2023,08035313,INSTITUT QUERCUS,08218,082188,SANT JOAN DE VILATORRADA,45,28,73
2022/2023,08035301,INSTITUT DUC DE MONTBLANC,08184,081846,RUBÍ,49,31,80
2022/2023,08035295,INSTITUT PALAU AUSIT,08180,081803,RIPOLLET,35,54,89
2022/2023,08035283,ESCOLA REIXAC,08125,081252,MONTCADA I REIXAC,29,5,34
2022/2023,08035258,INSTITUT APEL·LES MESTRES,08101,081017,L'HOSPITALET DE LLOBREGAT,41,28,69
2022/2023,08035246,INSTITUT GELIDA,08091,080919,GELIDA,21,21,42
2022/2023,08035234,INSTITUT VIL·LA ROMANA,08088,080885,LA GARRIGA,38,25,63
2022/2023,08035222,INSTITUT MANUEL BLANCAFORT,08088,080885,LA GARRIGA,40,15,55
2022/2023,08035209,INSTITUT PABLO R. PICASSO,08019,080193,BARCELONA,30,21,51
2022/2023,08035167,INSTITUT BARCELONA-CONGRÉS,08019,080193,BARCELONA,32,19,51
2022/2023,08035155,INSTITUT ELS TRES TURONS,08006,080060,ARENYS DE MAR,43,23,66
2022/2023,08035143,INSTITUT MIQUEL MARTÍ I POL,08073,080734,CORNELLÀ DE LLOBREGAT,71,43,114
2022/2023,08035003,EA DE VIC,08298,082981,VIC,28,23,51
2022/2023,08034990,ESCOLA PARELLADA,08200,082009,SANT BOI DE LLOBREGAT,22,6,28
2022/2023,08034989,ESCOLA CATALUNYA,08194,081944,SANT ADRIÀ DE BESÒS,29,4,33
2022/2023,08034965,ESCOLA MARGARIDA XIRGU,08015,080155,BADALONA,32,6,38
2022/2023,08034904,ESCOLA EMILI CARLES I TOLRÀ,08051,080517,CASTELLAR DEL VALLÈS,15,1,16
2022/2023,08034862,ESCOLA AUSIÀS MARCH,08101,081017,L'HOSPITALET DE LLOBREGAT,18,1,19
2022/2023,08034850,ESCOLA PAU CASALS,08101,081017,L'HOSPITALET DE LLOBREGAT,36,9,45
2022/2023,08034837,ESCOLA BERNAT DESCLOT,08101,081017,L'HOSPITALET DE LLOBREGAT,18,0,18
2022/2023,08034795,ESCOLA HEUROM - ZER ALT LLUÇANÈS,08160,081607,PERAFITA,5,0,5
2022/2023,08034783,ESCOLA ELVIRA CUYÀS,08125,081252,MONTCADA I REIXAC,28,4,32
2022/2023,08034746,ESCOLA ROCAFONDA,08121,081213,MATARÓ,36,1,37
2022/2023,08034734,ESCOLA CAMÍ DEL MIG,08121,081213,MATARÓ,30,4,34
2022/2023,08034667,ESCOLA ESTEVE BARRACHINA,08270,082704,SITGES,29,5,34
2022/2023,08034643,INSTITUT LES VINYES,08245,082457,SANTA COLOMA DE GRAMENET,61,41,102
2022/2023,08034621,INSTITUT DE SALES,08301,083015,VILADECANS,62,33,95
2022/2023,08034606,INSTITUT BAIX MONTSENY,08202,082021,SANT CELONI,54,33,87
2022/2023,08034591,INSTITUT JOAN OLIVER,08187,081878,SABADELL,39,16,55
2022/2023,08034576,INSTITUT JOAN SALVAT I PAPASSEIT,08019,080193,BARCELONA,26,18,44
2022/2023,08034564,INSTITUT LES CORTS,08019,080193,BARCELONA,38,24,62
2022/2023,08034527,ESCOLA RAMON MUNTANER,08101,081017,L'HOSPITALET DE LLOBREGAT,15,1,16
2022/2023,08034497,ESCOLA L'ARAGAI,08307,083073,VILANOVA I LA GELTRÚ,18,3,21
2022/2023,08034485,ESCOLA JOAN MARQUÈS I CASALS,08279,082798,TERRASSA,26,5,31
2022/2023,08034461,ESCOLA BERNAT DE MOGODA,08260,082606,SANTA PERPÈTUA DE MOGODA,19,5,24
2022/2023,08034448,ESCOLA SANTA EULÀLIA,08231,082310,SANT PERE DE RIBES,22,7,29
2022/2023,08034412,ESCOLA CAN MASSALLERA,08200,082009,SANT BOI DE LLOBREGAT,13,4,17
2022/2023,08034400,ESCOLA ANTONI GAUDÍ,08200,082009,SANT BOI DE LLOBREGAT,16,0,16
2022/2023,08034382,ESCOLA RAMON LLULL,08184,081846,RUBÍ,24,5,29
2022/2023,08034357,ESCOLA VISTA ALEGRE,08121,081213,MATARÓ,14,2,16
2022/2023,08034333,ESCOLA LA LLÀNTIA,08121,081213,MATARÓ,27,5,32
2022/2023,08034321,ESCOLA TORRE LLAUDER,08121,081213,MATARÓ,19,2,21
2022/2023,08034278,ESCOLA VICENTE ALEIXANDRE,08114,081141,MARTORELL,24,2,26
2022/2023,08034266,ESCOLA JOAN MARAGALL,08101,081017,L'HOSPITALET DE LLOBREGAT,15,2,17
2022/2023,08034242,ESCOLA PABLO NERUDA,08101,081017,L'HOSPITALET DE LLOBREGAT,16,2,18
2022/2023,08034229,ESCOLA BONAVISTA,08051,080517,CASTELLAR DEL VALLÈS,12,4,16
2022/2023,08034217,INSTITUT BERNAT EL FERRER,08123,081234,MOLINS DE REI,74,48,122
2022/2023,08034205,INSTITUT LA GUINEUETA,08019,080193,BARCELONA,68,77,145
2022/2023,08034187,INSTITUT DOMÈNEC PERRAMON,08007,080076,ARENYS DE MUNT,42,11,53
2022/2023,08034138,INSTITUT POBLENOU,08019,080193,BARCELONA,52,34,86
2022/2023,08034126,ESCOLA PAU BOADA,08305,083054,VILAFRANCA DEL PENEDÈS,17,6,23
2022/2023,08034102,ESCOLA JOSEP MARIA MADORELL,08123,081234,MOLINS DE REI,16,2,18
2022/2023,08034096,ESCOLA ANTONI GAUDÍ,08056,080569,CASTELLDEFELS,26,6,32
2022/2023,08034084,ESCOLA CAN ROCA,08056,080569,CASTELLDEFELS,28,3,31
2022/2023,08034060,ESCOLA MOSSÈN CINTO VERDAGUER,08184,081846,RUBÍ,29,6,35
2022/2023,08034059,INSTITUT NICOLAU COPÈRNIC,08279,082798,TERRASSA,36,51,87
2022/2023,08034035,INSTITUT FEDERICA MONTSENY,08904,089045,BADIA DEL VALLÈS,32,21,53
2022/2023,08034011,INSTITUT FREDERIC MOMPOU,08263,082634,SANT VICENÇ DELS HORTS,42,19,61
2022/2023,08034001,INSTITUT TERRA ROJA,08245,082457,SANTA COLOMA DE GRAMENET,51,15,66
2022/2023,08033997,ESCOLA PRIMAVERA,08245,082457,SANTA COLOMA DE GRAMENET,14,3,17
2022/2023,08033985,INSTITUT DE SANT JUST DESVERN,08221,082212,SANT JUST DESVERN,36,24,60
2022/2023,08033973,INSTITUT JAUME SALVADOR I PEDROL,08217,082172,SANT JOAN DESPÍ,38,25,63
2022/2023,08033961,INSTITUT RAFAEL CASANOVA,08200,082009,SANT BOI DE LLOBREGAT,47,25,72
2022/2023,08033948,ESCOLA ENRIC TATCHÉ I POL,08180,081803,RIPOLLET,27,5,32
2022/2023,08033924,INSTITUT PIUS FONT I QUER,08113,081136,MANRESA,40,28,68
2022/2023,08033912,INSTITUT MERCÈ RODOREDA,08101,081017,L'HOSPITALET DE LLOBREGAT,45,32,77
2022/2023,08033900,INSTITUT JOAN MIRÓ,08073,080734,CORNELLÀ DE LLOBREGAT,43,18,61
2022/2023,08033894,INSTITUT TERESA PÀMIES,08019,080193,BARCELONA,34,17,51
2022/2023,08033869,INSTITUT PAU CASALS,08015,080155,BADALONA,34,27,61
2022/2023,08033602,ESCOLA CAN SERRA,08252,082520,BARBERÀ DEL VALLÈS,24,5,29
2022/2023,08033560,ESCOLA MÀRIUS TORRES,08101,081017,L'HOSPITALET DE LLOBREGAT,32,9,41
2022/2023,08033535,ESCOLA JOAN MARAGALL,08077,080771,ESPLUGUES DE LLOBREGAT,31,1,32
2022/2023,08033523,ESCOLA LA MUNTANYETA,08019,080193,BARCELONA,14,3,17
2022/2023,08033501,ESCOLA ANTONI BRUSI,08019,080193,BARCELONA,26,7,33
2022/2023,08033468,ESCOLA LA SALUT,08069,080692,COLLBATÓ,15,4,19
2022/2023,08033407,ESCOLA PURIFICACIÓ SALAS I XANDRI,08238,082384,SANT QUIRZE DEL VALLÈS,15,2,17
2022/2023,08033341,ESCOLA BANÚS,08245,082457,SANTA COLOMA DE GRAMENET,12,5,17
2022/2023,08032762,ESCOLA DOCTOR TRUETA,08301,083015,VILADECANS,30,1,31
2022/2023,08032750,ESCOLA PAU CASALS,08301,083015,VILADECANS,28,2,30
2022/2023,08032737,ESCOLA CAN RULL,08187,081878,SABADELL,27,6,33
2022/2023,08032725,ESCOLA HONORABLE JOSEP TARRADELLAS,08169,081691,EL PRAT DE LLOBREGAT,30,4,34
2022/2023,08032713,ESCOLA SANT JORDI,08124,081249,MOLLET DEL VALLÈS,22,5,27
2022/2023,08032658,ESCOLA L'ERAMPRUNYÀ,08089,080898,GAVÀ,30,4,34
2022/2023,08032634,ESCOLA FERRER I GUÀRDIA,08019,080193,BARCELONA,30,8,38
2022/2023,08032592,ESCOLA SANT JORDI,08264,082649,SANT VICENÇ DE MONTALT,16,1,17
2022/2023,08032580,ESCOLA CANIGÓ,08221,082212,SANT JUST DESVERN,27,6,33
2022/2023,08032521,ESCOLA VALL DE PALAU,08196,081960,SANT ANDREU DE LA BARCA,26,4,30
2022/2023,08032491,ESCOLA SANT VICENÇ,08124,081249,MOLLET DEL VALLÈS,27,3,30
2022/2023,08032476,ESCOLA PRAT DE LA RIBA,08077,080771,ESPLUGUES DE LLOBREGAT,14,3,17
2022/2023,08032351,ESCOLA PAU CASALS,08184,081846,RUBÍ,28,6,34
2022/2023,08032348,ESCOLA 25 DE SETEMBRE,08184,081846,RUBÍ,36,11,47
2022/2023,08032312,ESCOLA MIGUEL DE UNAMUNO,08245,082457,SANTA COLOMA DE GRAMENET,30,5,35
2022/2023,08032300,ESCOLA FRAY LUIS DE LEÓN,08245,082457,SANTA COLOMA DE GRAMENET,29,5,34
2022/2023,08031873,INSTITUT ARNAU CADELL,08205,082055,SANT CUGAT DEL VALLÈS,45,23,68
2022/2023,08031861,INSTITUT LEONARDO DA VINCI,08205,082055,SANT CUGAT DEL VALLÈS,50,23,73
2022/2023,08031836,INSTITUT ILLA DELS BANYOLS,08169,081691,EL PRAT DE LLOBREGAT,13,56,69
2022/2023,08031812,INSTITUT VALLDEMOSSA,08019,080193,BARCELONA,29,19,48
2022/2023,08031800,ESCOLA PAU CASALS,08019,080193,BARCELONA,15,4,19
2022/2023,08031794,ESCOLA PALMA DE MALLORCA,08019,080193,BARCELONA,19,2,21
2022/2023,08031770,INSTITUT CAN JOFRESA,08279,082798,TERRASSA,43,25,68
2022/2023,08031757,INSTITUT FORAT DEL VENT,08266,082665,CERDANYOLA DEL VALLÈS,41,28,69
2022/2023,08031711,INSTITUT MANUEL DE CABANYES,08307,083073,VILANOVA I LA GELTRÚ,52,34,86
2022/2023,08031681,INSTITUT FRANCESC XAVIER LLUCH I RAFECAS,08307,083073,VILANOVA I LA GELTRÚ,55,49,104
2022/2023,08031666,ESCOLA CANIGÓ,08307,083073,VILANOVA I LA GELTRÚ,23,7,30
2022/2023,08031484,ESCOLA GINESTA,08307,083073,VILANOVA I LA GELTRÚ,25,7,32
2022/2023,08031472,ESCOLA POMPEU FABRA,08307,083073,VILANOVA I LA GELTRÚ,24,6,30
2022/2023,08031460,ESCOLA TRENTAPASSES,08306,083067,VILALBA SASSERRA,15,1,16
2022/2023,08031459,INSTITUT EUGENI D'ORS,08305,083054,VILAFRANCA DEL PENEDÈS,62,44,106
2022/2023,08031332,ESCOLA JOSEP BALTÀ I ELIAS,08305,083054,VILAFRANCA DEL PENEDÈS,25,8,33
2022/2023,08031320,ESCOLA ESTALELLA I GRAELLS,08305,083054,VILAFRANCA DEL PENEDÈS,30,3,33
2022/2023,08031319,ESCOLA LLEBEIG,08304,083041,VILOBÍ DEL PENEDÈS,15,0,15
2022/2023,08031290,ESCOLA LES ROQUES,08303,083036,VILANOVA DE SAU,3,1,4
2022/2023,08031277,ESCOLA JOAN MARAGALL,08302,083020,VILANOVA DEL CAMÍ,31,3,34
2022/2023,08031228,INSTITUT TORRE ROJA,08301,083015,VILADECANS,66,44,110
2022/2023,08031204,ESCOLA EL GARROFER,08301,083015,VILADECANS,29,4,33
2022/2023,08031101,ESCOLA MONTSERRATINA,08301,083015,VILADECANS,27,3,30
2022/2023,08031083,ESCOLA ÀNGELA ROCA,08301,083015,VILADECANS,20,3,23
2022/2023,08031061,ESCOLA ROSELLA,08300,083008,VILADECAVALLS,30,3,33
2022/2023,08031046,ESCOLA SERRA DE PICAMILL - ZER BERGUEDÀ CENTRE,08299,082994,VILADA,4,0,4
2022/2023,08031034,INSTITUT JAUME CALLÍS,08298,082981,VIC,43,23,66
2022/2023,08031022,INSTITUT DE VIC,08298,082981,VIC,107,76,183
2022/2023,08031009,ESCOLA DOCTOR JOAQUIM SALARICH,08298,082981,VIC,33,4,37
2022/2023,08030819,ESCOLA SENTFORES,08298,082981,VIC,19,2,21
2022/2023,08030789,ESCOLA POMPEU FABRA,08295,082956,VALLIRANA,17,0,17
2022/2023,08030728,ESCOLA SERRAT VOLTOR - ZER ALT BERGUEDÀ,08293,082938,VALLCEBRE,3,0,3
2022/2023,08030698,ESCOLA JOSEP MASCLANS,08292,082922,VALLBONA D'ANOIA,10,3,13
2022/2023,08030686,ESCOLA PAU CASALS,08291,082917,VACARISSES,24,4,28
2022/2023,08030662,ESCOLA SERRALAVELLA,08290,082900,ULLASTRELL,18,5,23
2022/2023,08030637,ESCOLA GUERAU DE PEGUERA,08288,082883,TORRELLES DE FOIX,15,2,17
2022/2023,08030613,ESCOLA J.J. RÀFOLS,08287,082877,TORRELAVIT,11,3,14
2022/2023,08030595,ESCOLA TORRESCASANA,08286,082861,LA TORRE DE CLARAMUNT,11,5,16
2022/2023,08030583,ESCOLA LA TORRE,08286,082861,LA TORRE DE CLARAMUNT,15,1,16
2022/2023,08030522,ESCOLA VALL DEL GES,08285,082858,TORELLÓ,17,0,17
2022/2023,08030510,ESCOLA DOCTOR FORTIÀ I SOLÀ,08285,082858,TORELLÓ,29,3,32
2022/2023,08030467,ESCOLA IGNASI IGLESIAS,08284,082845,TORDERA,32,5,37
2022/2023,08030421,ESCOLA L'ERA DE DALT,08283,082830,TONA,26,4,30
2022/2023,08030388,ESCOLA LOLA ANGLADA,08282,082824,TIANA,24,5,29
2022/2023,08030364,ESCOLA EL CIM,08281,082819,TEIÀ,29,5,34
2022/2023,08030340,INSTITUT INVESTIGADOR BLANXART,08279,082798,TERRASSA,63,25,88
2022/2023,08030339,INSTITUT DE TERRASSA,08279,082798,TERRASSA,98,59,157
2022/2023,08030315,ESCOLA JOAN XXIII,08279,082798,TERRASSA,30,4,34
2022/2023,08030297,ESCOLA SALVADOR VINYALS I GALÍ,08279,082798,TERRASSA,19,2,21
2022/2023,08030248,ESCOLA PAU VILA I DINARÈS,08279,082798,TERRASSA,33,4,37
2022/2023,08030212,ESCOLA JOSEP VENTALLÓ I VINTRÓ,08279,082798,TERRASSA,18,2,20
2022/2023,08030200,ESCOLA MARIÀ GALÍ GUIX,08279,082798,TERRASSA,19,1,20
2022/2023,08029507,ESCOLA ISAAC PERAL,08279,082798,TERRASSA,17,1,18
2022/2023,08029386,ESCOLA RAMÓN Y CAJAL,08279,082798,TERRASSA,29,5,34
2022/2023,08029374,ESCOLA BISBAT D'EGARA,08279,082798,TERRASSA,43,4,47
2022/2023,08029350,ESCOLA FRANÇA,08279,082798,TERRASSA,31,3,34
2022/2023,08029301,ESCOLA LES PINEDIQUES,08278,082785,TARADELL,26,5,31
2022/2023,08029283,ESCOLA EL GURRI - ZER GUILLERIES,08278,082785,TARADELL,4,0,4
2022/2023,08029222,ESCOLA FRANCESC MACIÀ,08274,082747,SÚRIA,16,1,17
2022/2023,08029209,ESCOLA SALIPOTA,08274,082747,SÚRIA,13,2,15
2022/2023,08029192,ESCOLA SANT JORDI,08273,082732,SUBIRATS,13,2,15
2022/2023,08029155,ESCOLA EL MONTCAU - ZER SUBIRATS,08273,082732,SUBIRATS,7,1,8
2022/2023,08029143,ESCOLA SUBIRATS - ZER SUBIRATS,08273,082732,SUBIRATS,7,0,7
2022/2023,08029088,ESCOLA MIQUEL UTRILLO,08270,082704,SITGES,27,7,34
2022/2023,08029027,ESCOLA FARIGOLA,08269,082690,SEVA,15,0,15
2022/2023,08029015,ESCOLA SANT SALVADOR,08268,082687,CERCS,8,3,11
2022/2023,08028990,ESCOLA CAN SORTS,08267,082671,SENTMENAT,36,6,42
2022/2023,08028941,ESCOLA LA SARDANA,08904,089045,BADIA DEL VALLÈS,20,2,22
2022/2023,08028928,ESCOLA LA JOTA,08904,089045,BADIA DEL VALLÈS,25,7,32
2022/2023,08028916,ESCOLA LAS SEGUIDILLAS,08904,089045,BADIA DEL VALLÈS,25,2,27
2022/2023,08028904,ESCOLA CARLES BUÏGAS,08266,082665,CERDANYOLA DEL VALLÈS,18,1,19
2022/2023,08028783,ESCOLA SERRAPARERA,08266,082665,CERDANYOLA DEL VALLÈS,24,4,28
2022/2023,08028758,ESCOLA LES FONTETES,08266,082665,CERDANYOLA DEL VALLÈS,11,5,16
2022/2023,08028746,ESCOLA SANT MARTÍ,08266,082665,CERDANYOLA DEL VALLÈS,17,2,19
2022/2023,08028709,ESCOLA LLORIANA,08265,082652,SANT VICENÇ DE TORELLÓ,15,0,15
2022/2023,08028667,ESCOLA JOAN JUNCADELLA,08263,082634,SANT VICENÇ DELS HORTS,27,1,28
2022/2023,08028591,ESCOLA LA VINYALA,08263,082634,SANT VICENÇ DELS HORTS,18,3,21
2022/2023,08028588,ESCOLA SANT JORDI,08263,082634,SANT VICENÇ DELS HORTS,15,2,17
2022/2023,08028576,ESCOLA SANT VICENÇ,08262,082628,SANT VICENÇ DE CASTELLET,31,4,35
2022/2023,08028515,ESCOLA SANTA SUSANNA,08261,082613,SANTA SUSANNA,14,5,19
2022/2023,08028497,ESCOLA SANTA PERPÈTUA,08260,082606,SANTA PERPÈTUA DE MOGODA,21,5,26
2022/2023,08028436,ESCOLA LA FLORIDA,08260,082606,SANTA PERPÈTUA DE MOGODA,26,3,29
2022/2023,08028424,ESCOLA FONTMARTINA,08259,082592,SANTA MARIA DE PALAUTORDERA,22,4,26
2022/2023,08028382,ESCOLA SESMON D'OLÓ,08258,082589,SANTA MARIA D'OLÓ,11,0,11
2022/2023,08028345,ESCOLA LES MIMOSES,08256,082567,SANTA MARIA DE MARTORELLES,11,2,13
2022/2023,08028333,ESCOLA EL CABRERÈS,08254,082541,L'ESQUIROL,13,4,17
2022/2023,08028229,ESCOLA ELISA BADIA,08252,082520,BARBERÀ DEL VALLÈS,27,2,29
2022/2023,08028217,ESCOLA DOCTOR SAMARANCH I FINA,08251,082515,SANTA MARGARIDA I ELS MONJOS,27,5,32
2022/2023,08028163,ESCOLA MONTBOU,08250,082508,SANTA MARGARIDA DE MONTBUI,13,4,17
2022/2023,08028151,ESCOLA LES MORERES - ZER CEP DE SIS,08249,082495,SANTA FE DEL PENEDÈS,5,0,5
2022/2023,08028102,ESCOLA RONÇANA,08248,082482,SANTA EULÀLIA DE RONÇANA,19,0,19
2022/2023,08028072,ESCOLA EL ROURE GROS,08247,082476,SANTA EULÀLIA DE RIUPRIMER,15,0,15
2022/2023,08028059,ESCOLA JACINT VERDAGUER,08246,082460,SANTA EUGÈNIA DE BERGA,14,2,16
2022/2023,08028047,INSTITUT PUIG CASTELLAR,08245,082457,SANTA COLOMA DE GRAMENET,50,50,100
2022/2023,08028035,ESCOLA AUSIÀS MARCH,08245,082457,SANTA COLOMA DE GRAMENET,16,4,20
2022/2023,08027985,ESCOLA JAUME SALVATELLA,08245,082457,SANTA COLOMA DE GRAMENET,28,5,33
2022/2023,08027973,ESCOLA BEETHOVEN,08245,082457,SANTA COLOMA DE GRAMENET,18,3,21
2022/2023,08027870,ESCOLA LES PALMERES,08245,082457,SANTA COLOMA DE GRAMENET,27,5,32
2022/2023,08027511,ESCOLA TORRE BALLDOVINA,08245,082457,SANTA COLOMA DE GRAMENET,30,3,33
2022/2023,08027471,ESCOLA SANT JUST,08245,082457,SANTA COLOMA DE GRAMENET,27,3,30
2022/2023,08027456,ESCOLA FERRAN DE SAGARRA,08245,082457,SANTA COLOMA DE GRAMENET,31,5,36
2022/2023,08027432,ESCOLA WAGNER,08245,082457,SANTA COLOMA DE GRAMENET,18,3,21
2022/2023,08027249,ESCOLA SEGIMON COMAS,08237,082378,SANT QUIRZE DE BESORA,18,1,19
2022/2023,08027225,ESCOLA SANT PAU,08235,082359,SANT POL DE MAR,32,3,35
2022/2023,08027183,ESCOLA TORRE ROJA,08234,082346,SANT PERE DE VILAMAJOR,25,5,30
2022/2023,08027146,ESCOLA SANT JERONI,08232,082325,SANT PERE DE RIUDEBITLLES,15,2,17
2022/2023,08027134,ESCOLA LES ROQUETES,08231,082310,SANT PERE DE RIBES,22,4,26
2022/2023,08027110,ESCOLA EL PI,08231,082310,SANT PERE DE RIBES,14,2,16
2022/2023,08027021,ESCOLA FONT DE L'ANOIA - ZER VENT D'AVALL,08228,082286,SANT MARTÍ SESGUEIOLES,2,1,3
2022/2023,08027018,ESCOLA JAUME BALMES,08227,082270,SANT MARTÍ SARROCA,19,3,22
2022/2023,08026956,ESCOLA CÉRVOLA BLANCA,08226,082264,SANT MARTÍ DE TOUS,13,2,15
2022/2023,08026919,ESCOLA JOSEP GRAS,08223,082233,SANT LLORENÇ SAVALL,12,3,15
2022/2023,08026907,ESCOLA PAU CASALS,08222,082227,SANT LLORENÇ D'HORTONS,12,4,16
2022/2023,08026889,ESCOLA VINYES VERDES,08119,081192,MASQUEFA,13,3,16
2022/2023,08026816,ESCOLA MONTSERRAT,08221,082212,SANT JUST DESVERN,26,8,34
2022/2023,08026786,ESCOLA BELLPUIG,08220,082205,SANT JULIÀ DE VILATORTA,16,1,17
2022/2023,08026749,ESCOLA PÉREZ SALA,08219,082191,VILASSAR DE MAR,20,5,25
2022/2023,08026725,ESCOLA JONCADELLA,08218,082188,SANT JOAN DE VILATORRADA,27,2,29
2022/2023,08026683,INSTITUT FRANCESC FERRER I GUÀRDIA,08217,082172,SANT JOAN DESPÍ,70,30,100
2022/2023,08026671,ESCOLA JOAN PERICH I VALLS,08217,082172,SANT JOAN DESPÍ,16,1,17
2022/2023,08026661,ESCOLA PAU CASALS,08217,082172,SANT JOAN DESPÍ,30,1,31
2022/2023,08026567,ESCOLA SANT FRANCESC D'ASSÍS,08217,082172,SANT JOAN DESPÍ,29,2,31
2022/2023,08026476,ESCOLA FRANCESC MACIÀ,08214,082140,VILASSAR DE DALT,24,7,31
2022/2023,08026464,ESCOLA MONSENYOR GIBERT,08213,082135,SANT FRUITÓS DE BAGES,26,5,31
2022/2023,08026415,ESCOLA ELS ROURES - ZER GAVARRESA,08212,082129,SANT FELIU SASSERRA,7,0,7
2022/2023,08026397,INSTITUT OLORDA,08211,082114,SANT FELIU DE LLOBREGAT,50,17,67
2022/2023,08026385,ESCOLA ARQUITECTE GAUDÍ,08211,082114,SANT FELIU DE LLOBREGAT,20,1,21
2022/2023,08026373,ESCOLA JOSEP MONMANY AMAT,08211,082114,SANT FELIU DE LLOBREGAT,19,1,20
2022/2023,08026221,ESCOLA FALGUERA,08211,082114,SANT FELIU DE LLOBREGAT,12,5,17
2022/2023,08026211,ESCOLA NADAL,08211,082114,SANT FELIU DE LLOBREGAT,25,4,29
2022/2023,08026208,ESCOLA JAUME BALMES,08210,082107,SANT FELIU DE CODINES,20,7,27
2022/2023,08026154,ESCOLA JOAQUIM ABRIL,08209,082093,SANT FOST DE CAMPSENTELLES,25,2,27
2022/2023,08026130,ESCOLA LA ROUREDA,08208,082080,SANT ESTEVE SESROVIRES,23,4,27
2022/2023,08026117,ESCOLA VALLMANYA,08207,082074,SANT ESTEVE DE PALAUTORDERA,23,3,26
2022/2023,08026099,ESCOLA LES VINYES,08206,082068,SANT CUGAT SESGARRIGUES,12,1,13
2022/2023,08026087,ESCOLA JAUME FERRAN I CLUA,08205,082055,SANT CUGAT DEL VALLÈS,29,2,31
2022/2023,08026026,ESCOLA PINS DEL VALLÈS,08205,082055,SANT CUGAT DEL VALLÈS,26,5,31
2022/2023,08025927,ESCOLA PI D'EN XANDRI,08205,082055,SANT CUGAT DEL VALLÈS,25,5,30
2022/2023,08025824,ESCOLA LA FLORESTA,08205,082055,SANT CUGAT DEL VALLÈS,17,1,18
2022/2023,08025812,ESCOLA SANT CLIMENT,08204,082042,SANT CLIMENT DE LLOBREGAT,27,5,32
2022/2023,08025666,ESCOLA AURORA - ZER ALT LLUÇANÈS,08201,082016,SANT BOI DE LLUÇANÈS,2,3,5
2022/2023,08025654,INSTITUT JOAQUIM RUBIÓ I ORS,08200,082009,SANT BOI DE LLOBREGAT,41,29,70
2022/2023,08025642,ESCOLA JOSEP MARIA CIURANA,08200,082009,SANT BOI DE LLOBREGAT,25,2,27
2022/2023,08025605,INSTITUT CAMPS BLANCS,08200,082009,SANT BOI DE LLOBREGAT,85,59,144
2022/2023,08025599,ESCOLA MARIANAO,08200,082009,SANT BOI DE LLOBREGAT,16,3,19
2022/2023,08025587,ESCOLA CASABLANCA,08200,082009,SANT BOI DE LLOBREGAT,30,4,34
2022/2023,08025526,ESCOLA CIUTAT COOPERATIVA,08200,082009,SANT BOI DE LLOBREGAT,17,2,19
2022/2023,08025344,ESCOLA AMAT VERDÚ,08200,082009,SANT BOI DE LLOBREGAT,18,2,20
2022/2023,08025320,ESCOLA LA MONJOIA,08199,081995,SANT BARTOMEU DEL GRAU,13,1,14
2022/2023,08025319,ESCOLA JOAN CASAS,08198,081982,SANT ANTONI DE VILAMAJOR,24,2,26
2022/2023,08025265,ESCOLA ÀNGEL GUIMERÀ,08196,081960,SANT ANDREU DE LA BARCA,26,4,30
2022/2023,08025241,ESCOLA JOAN MARAGALL,08196,081960,SANT ANDREU DE LA BARCA,13,5,18
2022/2023,08025083,ESCOLA POMPEU FABRA,08194,081944,SANT ADRIÀ DE BESÒS,25,9,34
2022/2023,08025071,ESCOLA DONES D'AIGUA,08193,081939,SANT ISCLE DE VALLALTA,9,4,13
2022/2023,08025058,ESCOLA RIU D'OR,08192,081923,SANTPEDOR,25,3,28
2022/2023,08024972,ESCOLA TORRES AMAT,08191,081918,SALLENT,25,3,28
2022/2023,08024893,INSTITUT CASTELLARNAU,08187,081878,SABADELL,63,53,116
2022/2023,08024881,INSTITUT FERRAN CASABLANCAS,08187,081878,SABADELL,50,45,95
2022/2023,08024871,INSTITUT PAU VILA,08187,081878,SABADELL,55,27,82
2022/2023,08024856,ESCOLA FONT ROSELLA,08187,081878,SABADELL,27,4,31
2022/2023,08024844,ESCOLA TORREGUITART,08187,081878,SABADELL,14,4,18
2022/2023,08024832,ESCOLA FLORESTA,08187,081878,SABADELL,12,5,17
2022/2023,08024820,ESCOLA PAU CASALS,08187,081878,SABADELL,28,5,33
2022/2023,08024819,ESCOLA CALVET D'ESTRELLA,08187,081878,SABADELL,15,2,17
2022/2023,08024807,ESCOLA AGNÈS ARMENGOL,08187,081878,SABADELL,17,3,20
2022/2023,08024790,ESCOLA ROUREDA,08187,081878,SABADELL,32,1,33
2022/2023,08024789,CEE FRANCESC BELLAPART,08187,081878,SABADELL,43,3,46
2022/2023,08024777,INSTITUT EGARA,08279,082798,TERRASSA,35,22,57
2022/2023,08024765,INSTITUT ARRAONA,08187,081878,SABADELL,35,25,60
2022/2023,08024741,INSTITUT ESCOLA INDUSTRIAL,08187,081878,SABADELL,60,69,129
2022/2023,08024066,ESCOLA TARLATANA,08187,081878,SABADELL,16,3,19
2022/2023,08024042,ESCOLA LA ROMÀNICA,08187,081878,SABADELL,28,6,34
2022/2023,08024030,ESCOLA SAMUNTADA,08187,081878,SABADELL,17,2,19
2022/2023,08024017,ESCOLA MIQUEL CARRERAS,08187,081878,SABADELL,15,4,19
2022/2023,08024005,ESCOLA JOAN MARAGALL,08187,081878,SABADELL,22,1,23
2022/2023,08023980,ESCOLA JUAN RAMÓN JIMÉNEZ,08187,081878,SABADELL,15,3,18
2022/2023,08023979,ESCOLA JOAN MONTLLOR,08187,081878,SABADELL,16,4,20
2022/2023,08023955,ESCOLA CIFUENTES,08187,081878,SABADELL,27,5,32
2022/2023,08023943,ESCOLA GAUDÍ,08187,081878,SABADELL,18,1,19
2022/2023,08023931,ESCOLA ENRIC CASASSAS,08187,081878,SABADELL,14,3,17
2022/2023,08023921,ESCOLA ESPRONCEDA,08187,081878,SABADELL,28,7,35
2022/2023,08023918,ESCOLA CONCÒRDIA,08187,081878,SABADELL,29,1,30
2022/2023,08023852,ESCOLA JOAN MARAGALL,08184,081846,RUBÍ,23,1,24
2022/2023,08023669,ESCOLA MARE DE DÉU DEL SÒL DEL PONT,08183,081831,RODA DE TER,28,2,30
2022/2023,08023591,ESCOLA PILAR MESTRES-JAUME TORRENS,08181,081810,LA ROCA DEL VALLÈS,13,4,17
2022/2023,08023566,ESCOLA ANSELM CLAVÉ,08180,081803,RIPOLLET,27,3,30
2022/2023,08023554,ESCOLA JOSEP MARIA GINESTA,08180,081803,RIPOLLET,31,0,31
2022/2023,08023542,ESCOLA TIANA DE LA RIBA,08180,081803,RIPOLLET,14,3,17
2022/2023,08023426,ESCOLA GASSÓ I VIDAL,08180,081803,RIPOLLET,16,1,17
2022/2023,08023372,ESCOLA ALFRED MATA,08175,081751,PUIG-REIG,16,1,17
2022/2023,08023359,ESCOLA VIROLAI - ZER CEP DE SIS,08174,081748,PUIGDÀLBER,4,0,4
2022/2023,08023335,ESCOLA MONTSERRAT,08172,081727,PREMIÀ DE MAR,21,8,29
2022/2023,08023232,ESCOLA SANT CRISTÒFOL,08172,081727,PREMIÀ DE MAR,22,2,24
2022/2023,08023207,ESCOLA LLUÇANÈS,08171,081712,PRATS DE LLUÇANÈS,15,2,17
2022/2023,08023141,ESCOLA MARE DE DÉU DEL PORTAL - ZER VENT D'AVALL,08170,081705,ELS PRATS DE REI,6,1,7
2022/2023,08023131,INSTITUT BALDIRI GUILERA,08169,081691,EL PRAT DE LLOBREGAT,49,14,63
2022/2023,08022938,ESCOLA JACINT VERDAGUER,08169,081691,EL PRAT DE LLOBREGAT,28,3,31
2022/2023,08022926,CEE CAN RIGOL,08169,081691,EL PRAT DE LLOBREGAT,29,5,34
2022/2023,08022914,ESCOLA JAUME BALMES,08169,081691,EL PRAT DE LLOBREGAT,27,4,31
2022/2023,08022902,ESCOLA DEL PARC,08169,081691,EL PRAT DE LLOBREGAT,31,1,32
2022/2023,08022884,ESCOLA JOAN MARAGALL,08169,081691,EL PRAT DE LLOBREGAT,14,3,17
2022/2023,08022860,ESCOLA LILLET A GÜELL,08166,081666,LA POBLA DE LILLET,9,2,11
2022/2023,08022859,ESCOLA MARIA BORÉS,08165,081653,LA POBLA DE CLARAMUNT,12,4,16
2022/2023,08022847,ESCOLA SANTS ABDÓ I SENÉN,08164,081640,EL PLA DEL PENEDÈS,10,4,14
2022/2023,08022835,ESCOLA JAUME I,08163,081635,PINEDA DE MAR,26,4,30
2022/2023,08022801,ESCOLA ANTONI DOLTRA,08163,081635,PINEDA DE MAR,19,3,22
2022/2023,08022768,ESCOLA HEROIS DEL BRUC,08161,081614,PIERA,32,2,34
2022/2023,08022707,ESCOLA POMPEU FABRA,08159,081593,PARETS DEL VALLÈS,16,1,17
2022/2023,08022690,ESCOLA LLUÍS PIQUER,08159,081593,PARETS DEL VALLÈS,30,2,32
2022/2023,08022689,ESCOLA PAU VILA,08158,081580,EL PAPIOL,26,3,29
2022/2023,08022677,ESCOLA JACINT VERDAGUER,08157,081574,PALLEJÀ,15,2,17
2022/2023,08022665,ESCOLA ÀNGEL GUIMERÀ,08157,081574,PALLEJÀ,13,4,17
2022/2023,08022616,ESCOLA JOSEP MARIA FOLCH I TORRES,08156,081568,PALAU-SOLITÀ I PLEGAMANS,17,2,19
2022/2023,08022598,ESCOLA LES FERRERIES DE PALAFOLLS,08155,081555,PALAFOLLS,28,3,31
2022/2023,08022586,ESCOLA EL DRAC,08154,081542,PACS DEL PENEDÈS,11,2,13
2022/2023,08022574,ESCOLA ÒRRIUS,08153,081537,ÒRRIUS,13,1,14
2022/2023,08022549,ESCOLA LLEVANT - ZER GAVARRESA,08151,081516,ORISTÀ,3,0,3
2022/2023,08022495,ESCOLA TERRA NOSTRA,08149,081496,OLOST,11,2,13
2022/2023,08022461,ESCOLA SANT BERNAT,08147,081477,OLESA DE MONTSERRAT,23,7,30
2022/2023,08022380,ESCOLA MARE DE DÉU DE MONTSERRAT,08147,081477,OLESA DE MONTSERRAT,19,2,21
2022/2023,08022379,ESCOLA PONT DE L'ARCADA,08146,081461,OLESA DE BONESVALLS,12,2,14
2022/2023,08022367,ESCOLA ROSSEND MONTANÉ,08145,081458,OLÈRDOLA,15,1,16
2022/2023,08022343,ESCOLA CIRCELL,08145,081458,OLÈRDOLA,13,3,16
2022/2023,08022331,ESCOLA D'OLVAN - ZER BAIX BERGUEDÀ,08144,081445,OLVAN,7,0,7
2022/2023,08022197,ESCOLA CATALUNYA,08140,081402,NAVARCLES,30,4,34
2022/2023,08022094,ESCOLA JOSEP ORRIOLS I ROCA,08138,081385,MOIÀ,27,4,31
2022/2023,08022082,ESCOLA PUIG DRAU - ZER BAIX MONTSENY,08137,081379,MONTSENY,4,0,4
2022/2023,08022070,ESCOLA MARINADA,08136,081363,MONTORNÈS DEL VALLÈS,30,2,32
2022/2023,08022057,ESCOLA SANT SADURNÍ,08136,081363,MONTORNÈS DEL VALLÈS,13,3,16
2022/2023,08022045,ESCOLA SANT JORDI,08135,081350,MONTMELÓ,26,3,29
2022/2023,08022011,ESCOLA PAU CASALS,08135,081350,MONTMELÓ,21,2,23
2022/2023,08022008,ESCOLA MONTMANY,08134,081347,FIGARÓ-MONTMANY,7,2,9
2022/2023,08021983,ESCOLA GIRA-SOL - ZER BAIX BERGUEDÀ,08132,081326,MONTMAJOR,6,0,6
2022/2023,08021961,ESCOLA EL ROCAL,08131,081311,MONTESQUIU,11,4,15
2022/2023,08021934,ESCOLA L'ESQUEIX - ZER EL MOIANÈS PONENT,08128,081287,MONISTROL DE CALDERS,5,1,6
2022/2023,08021892,ESCOLA SANT PERE,08127,081271,MONISTROL DE MONTSERRAT,19,1,20
2022/2023,08021880,ESCOLA SALVADOR ESPRIU,08126,081265,MONTGAT,23,2,25
2022/2023,08021788,INSTITUT MONTSERRAT MIRÓ I VILA,08125,081252,MONTCADA I REIXAC,35,14,49
2022/2023,08021764,ESCOLA MITJA COSTA,08125,081252,MONTCADA I REIXAC,14,2,16
2022/2023,08021685,ESCOLA FONT FREDA,08125,081252,MONTCADA I REIXAC,23,2,25
2022/2023,08021600,INSTITUT VICENÇ PLANTADA,08124,081249,MOLLET DEL VALLÈS,46,32,78
2022/2023,08021594,INSTITUT DE MOLLET DEL VALLÈS,08124,081249,MOLLET DEL VALLÈS,50,85,135
2022/2023,08021582,ESCOLA JOAN SALVAT PAPASSEIT,08124,081249,MOLLET DEL VALLÈS,14,4,18
2022/2023,08021570,ESCOLA DEL BOSC,08124,081249,MOLLET DEL VALLÈS,13,3,16
2022/2023,08021466,ESCOLA COL·LEGIS NOUS,08124,081249,MOLLET DEL VALLÈS,17,6,23
2022/2023,08021442,ESCOLA CASTELL CIURÓ,08123,081234,MOLINS DE REI,18,7,25
2022/2023,08021430,INSTITUT LLUÍS DE REQUESENS,08123,081234,MOLINS DE REI,50,28,78
2022/2023,08021363,ESCOLA L'ALZINA,08123,081234,MOLINS DE REI,13,4,17
2022/2023,08021351,ESCOLA EL PALAU,08123,081234,MOLINS DE REI,16,1,17
2022/2023,08021326,ESCOLA LA FASSINA,08122,081228,MEDIONA,7,3,10
2022/2023,08021302,INSTITUT DAMIÀ CAMPENY,08121,081213,MATARÓ,40,22,62
2022/2023,08021260,INSTITUT ALEXANDRE SATORRAS,08121,081213,MATARÓ,65,43,108
2022/2023,08021041,ESCOLA JOSEP MONTSERRAT,08121,081213,MATARÓ,16,4,20
2022/2023,08020929,ESCOLA GERMANES BERTOMEU,08121,081213,MATARÓ,32,3,35
2022/2023,08020917,ESCOLA JOSEP MANUEL PERAMÀS,08121,081213,MATARÓ,30,4,34
2022/2023,08020905,ESCOLA ANGELETA FERRER,08121,081213,MATARÓ,24,7,31
2022/2023,08020863,ESCOLA GINESTA,08120,081206,MATADEPERA,29,2,31
2022/2023,08020841,ESCOLA EL TURÓ,08119,081192,MASQUEFA,27,6,33
2022/2023,08020838,INSTITUT MEDITERRÀNIA,08118,081189,EL MASNOU,23,20,43
2022/2023,08020826,INSTITUT MAREMAR,08118,081189,EL MASNOU,49,18,67
2022/2023,08020723,ESCOLA OCATA,08118,081189,EL MASNOU,17,0,17
2022/2023,08020701,ESCOLA COMTES DE LACAMBRA,08117,081173,LES MASIES DE VOLTREGÀ,12,2,14
2022/2023,08020656,ESCOLA SIMEÓ RABASA,08115,081154,MARTORELLES,14,2,16
2022/2023,08020620,INSTITUT POMPEU FABRA,08114,081141,MARTORELL,52,32,84
2022/2023,08020619,ESCOLA JOSÉ ECHEGARAY,08114,081141,MARTORELL,32,3,35
2022/2023,08020607,ESCOLA JUAN RAMÓN JIMÉNEZ,08114,081141,MARTORELL,25,5,30
2022/2023,08020516,CEE EL PONTARRÓ,08114,081141,MARTORELL,30,4,34
2022/2023,08020498,ESCOLA ELS CONVENTS,08114,081141,MARTORELL,16,1,17
2022/2023,08020474,INSTITUT LLUÍS DE PEGUERA,08113,081136,MANRESA,62,35,97
2022/2023,08020462,INSTITUT LACETÀNIA,08113,081136,MANRESA,80,96,176
2022/2023,08020127,ESCOLA BAGES,08113,081136,MANRESA,27,6,33
2022/2023,08020097,ESCOLA PARE ALGUÉ,08113,081136,MANRESA,19,3,22
2022/2023,08020073,ESCOLA SANT IGNASI,08113,081136,MANRESA,31,5,36
2022/2023,08020061,ESCOLA LA RENAIXENÇA,08113,081136,MANRESA,19,2,21
2022/2023,08020012,ESCOLA MUNTANYA DEL DRAC,08113,081136,MANRESA,16,3,19
2022/2023,08019940,ESCOLA PUIG-AGUT,08112,081120,MANLLEU,33,4,37
2022/2023,08019927,ESCOLA MARIÀ CUBÍ I SOLER,08110,081108,MALGRAT DE MAR,25,8,33
2022/2023,08019873,ESCOLA MARE DE DÉU DE MONTSERRAT,08110,081108,MALGRAT DE MAR,14,4,18
2022/2023,08019861,ESCOLA GAFARRÓ - ZER ALT LLUÇANÈS,08109,081094,LLUÇÀ,4,1,5
2022/2023,08019824,ESCOLA LES LLISSES,08108,081081,LLIÇÀ DE VALL,21,3,24
2022/2023,08019782,ESCOLA SALVADOR SANROMÀ,08106,081069,LLINARS DEL VALLÈS,25,3,28
2022/2023,08019745,ESCOLA JOAN MARAGALL,08105,081056,LA LLAGOSTA,26,2,28
2022/2023,08019711,ESCOLA SAGRADA FAMÍLIA,08105,081056,LA LLAGOSTA,15,5,20
2022/2023,08019691,ESCOLA VILADEMÀGER - ZER SERRA D'ANCOSA,08104,081043,LA LLACUNA,6,0,6
2022/2023,08019678,ESCOLA GUERAU DE JORBA,08103,081038,JORBA,9,1,10
2022/2023,08019654,INSTITUT MILÀ I FONTANALS,08102,081022,IGUALADA,85,69,154
2022/2023,08019642,ESCOLA PARE RAMON CASTELLTORT I MIRALDA,08102,081022,IGUALADA,31,2,33
2022/2023,08019630,INSTITUT PERE VIVES I VICH,08102,081022,IGUALADA,48,31,79
2022/2023,08019460,ESCOLA EMILI VALLÈS,08102,081022,IGUALADA,17,1,18
2022/2023,08019459,ESCOLA GABRIEL CASTELLA I RAICH,08102,081022,IGUALADA,21,0,21
2022/2023,08019435,ESCOLA GARCÍA I FOSSAS,08102,081022,IGUALADA,27,3,30
2022/2023,08019411,INSTITUT BELLVITGE,08101,081017,L'HOSPITALET DE LLOBREGAT,27,16,43
2022/2023,08019401,INSTITUT PROVENÇANA,08101,081017,L'HOSPITALET DE LLOBREGAT,49,58,107
2022/2023,08019371,INSTITUT LLOBREGAT,08101,081017,L'HOSPITALET DE LLOBREGAT,12,31,43
2022/2023,08019320,INSTITUT TORRAS I BAGES,08101,081017,L'HOSPITALET DE LLOBREGAT,35,22,57
2022/2023,08019319,INSTITUT PEDRAFORCA,08101,081017,L'HOSPITALET DE LLOBREGAT,68,38,106
2022/2023,08019307,INSTITUT SANTA EULÀLIA,08101,081017,L'HOSPITALET DE LLOBREGAT,43,13,56
2022/2023,08019290,ESCOLA PROVENÇANA,08101,081017,L'HOSPITALET DE LLOBREGAT,11,7,18
2022/2023,08019277,ESCOLA LA MARINA,08101,081017,L'HOSPITALET DE LLOBREGAT,27,4,31
2022/2023,08019265,ESCOLA JOAQUIM RUYRA,08101,081017,L'HOSPITALET DE LLOBREGAT,28,10,38
2022/2023,08019241,ESCOLA FREDERIC MISTRAL,08101,081017,L'HOSPITALET DE LLOBREGAT,28,3,31
2022/2023,08019231,ESCOLA MILAGROS CONSARNAU,08101,081017,L'HOSPITALET DE LLOBREGAT,28,6,34
2022/2023,08019216,ESCOLA BUSQUETS I PUNSET,08101,081017,L'HOSPITALET DE LLOBREGAT,25,4,29
2022/2023,08019198,ESCOLA POMPEU FABRA,08101,081017,L'HOSPITALET DE LLOBREGAT,27,7,34
2022/2023,08019149,ESCOLA BERNAT METGE,08101,081017,L'HOSPITALET DE LLOBREGAT,18,2,20
2022/2023,08018157,ESCOLA SANTIAGO RAMON Y CAJAL,08101,081017,L'HOSPITALET DE LLOBREGAT,34,7,41
2022/2023,08018145,ESCOLA PAU VILA,08101,081017,L'HOSPITALET DE LLOBREGAT,20,6,26
2022/2023,08018091,ESCOLA PEP VENTURA,08101,081017,L'HOSPITALET DE LLOBREGAT,35,7,42
2022/2023,08018078,ESCOLA BELLVITGE,08101,081017,L'HOSPITALET DE LLOBREGAT,14,4,18
2022/2023,08018066,ESCOLA MENÉNDEZ PIDAL,08101,081017,L'HOSPITALET DE LLOBREGAT,53,5,58
2022/2023,08018029,ESCOLA LES ESCOLES,08100,081000,GURB,28,2,30
2022/2023,08018017,ESCOLA L'ALBIOL - ZER ALT BERGUEDÀ,08903,089030,SANT JULIÀ DE CERDANYOLA,3,0,3
2022/2023,08018005,ESCOLA SANT LLORENÇ,08099,080996,GUARDIOLA DE BERGUEDÀ,6,4,10
2022/2023,08017992,ESCOLA MONTSERRAT,08098,080983,SANT SALVADOR DE GUARDIOLA,19,2,21
2022/2023,08017979,ESCOLA AQUA ALBA,08097,080977,GUALBA,12,3,15
2022/2023,08017931,INSTITUT ANTONI CUMELLA,08096,080961,GRANOLLERS,46,22,68
2022/2023,08017918,ESCOLA GRANULLARIUS,08096,080961,GRANOLLERS,27,3,30
2022/2023,08017712,ESCOLA FERRER I GUÀRDIA,08096,080961,GRANOLLERS,16,2,18
2022/2023,08017700,ESCOLA JOAN SOLANS,08096,080961,GRANOLLERS,15,5,20
2022/2023,08017694,ESCOLA PEREANTON,08096,080961,GRANOLLERS,15,2,17
2022/2023,08017682,ESCOLA JACINT VERDAGUER,08094,080945,LA GRANADA,12,3,15
2022/2023,08017645,ESCOLA DE GIRONELLA,08092,080924,GIRONELLA,17,2,19
2022/2023,08017633,ESCOLA SANT MARC,08092,080924,GIRONELLA,14,2,16
2022/2023,08017611,ESCOLA MONTCAU,08091,080919,GELIDA,23,4,27
2022/2023,08017530,INSTITUT DE BRUGUERS,08089,080898,GAVÀ,29,23,52
2022/2023,08017505,ESCOLA JUAN SALAMERO,08089,080898,GAVÀ,13,3,16
2022/2023,08017360,ESCOLA JACME MARCH,08089,080898,GAVÀ,16,3,19
2022/2023,08017359,ESCOLA SALVADOR LLUCH,08089,080898,GAVÀ,29,2,31
2022/2023,08017311,ESCOLA PUIGGRACIÓS,08088,080885,LA GARRIGA,24,5,29
2022/2023,08017271,ESCOLA JOAN SANPERA I TORRAS,08086,080863,LES FRANQUESES DEL VALLÈS,29,1,30
2022/2023,08017244,ESCOLA FONT-RÚBIA,08085,080850,FONT-RUBÍ,14,0,14
2022/2023,08017232,ESCOLA AGRUPACIÓ SANT JORDI,08084,080847,FONOLLOSA,14,2,16
2022/2023,08017153,INSTITUT JOANOT MARTORELL,08077,080771,ESPLUGUES DE LLOBREGAT,34,24,58
2022/2023,08017131,INSTITUT SEVERO OCHOA,08077,080771,ESPLUGUES DE LLOBREGAT,69,36,105
2022/2023,08017116,ESCOLA MATILDE ORDUÑA,08077,080771,ESPLUGUES DE LLOBREGAT,17,2,19
2022/2023,08017104,ESCOLA GRAS I SOLER,08077,080771,ESPLUGUES DE LLOBREGAT,13,4,17
2022/2023,08016941,ESCOLA ISIDRE MARTÍ,08077,080771,ESPLUGUES DE LLOBREGAT,27,1,28
2022/2023,08016938,ESCOLA TAQUÍGRAF GARRIGA,08076,080765,ESPARREGUERA,23,4,27
2022/2023,08016872,ESCOLA MARE DE DÉU DE LA MUNTANYA,08076,080765,ESPARREGUERA,14,3,17
2022/2023,08016811,ESCOLA JOSEP ANDREU - CHARLIE RIVEL,08074,080749,CUBELLES,31,5,36
2022/2023,08016793,INSTITUT FRANCESC MACIÀ,08073,080734,CORNELLÀ DE LLOBREGAT,44,29,73
2022/2023,08016781,INSTITUT ESTEVE TERRADAS I ILLA,08073,080734,CORNELLÀ DE LLOBREGAT,70,97,167
2022/2023,08016771,ESCOLA ELS PINS,08073,080734,CORNELLÀ DE LLOBREGAT,27,4,31
2022/2023,08016744,ESCOLA ANTONI GAUDÍ,08073,080734,CORNELLÀ DE LLOBREGAT,18,4,22
2022/2023,08016422,ESCOLA ABAT OLIBA,08073,080734,CORNELLÀ DE LLOBREGAT,19,4,23
2022/2023,08016410,ESCOLA SANT ILDEFONS,08073,080734,CORNELLÀ DE LLOBREGAT,21,5,26
2022/2023,08016409,ESCOLA MONTSERRAT,08073,080734,CORNELLÀ DE LLOBREGAT,12,6,18
2022/2023,08016392,ESCOLA MOSSÈN JACINT VERDAGUER,08073,080734,CORNELLÀ DE LLOBREGAT,16,1,17
2022/2023,08016380,ESCOLA ANSELM CLAVÉ,08073,080734,CORNELLÀ DE LLOBREGAT,15,2,17
2022/2023,08016367,ESCOLA DOLORS ALMEDA,08073,080734,CORNELLÀ DE LLOBREGAT,26,3,29
2022/2023,08016331,ESCOLA JAUME BALMES,08072,080728,CORBERA DE LLOBREGAT,21,8,29
2022/2023,08016291,ESCOLA QUATRE VENTS - ZER VENT D'AVALL,08071,080713,COPONS,6,1,7
2022/2023,08016264,ESCOLA EL SOLELL,08905,089058,LA PALMA DE CERVELLÓ,12,6,18
2022/2023,08016240,ESCOLA SANTA MARIA DE CERVELLÓ,08068,080689,CERVELLÓ,25,4,29
2022/2023,08016185,ESCOLA ILDEFONS CERDÀ,08067,080673,CENTELLES,25,4,29
2022/2023,08016173,ESCOLA MARE DE DÉU DE MONTSERRAT,08066,080667,CASTELLVÍ DE ROSANES,15,0,15
2022/2023,08016161,ESCOLA EL CASTELLOT,08065,080654,CASTELLVÍ DE LA MARCA,12,2,14
2022/2023,08016136,ESCOLA LES PASSERES - ZER TRES BRANQUES,08063,080636,CASTELLOLÍ,6,1,7
2022/2023,08016094,ESCOLA SANT MIQUEL,08061,080615,CASTELLGALÍ,14,2,16
2022/2023,08016082,ESCOLA SANT ROC - ZER VENT D'AVALL,08060,080608,CASTELLFOLLIT DE RIUBREGÓS,3,0,3
2022/2023,08016033,ESCOLA MONTANYANS,08058,080581,CASTELLET I LA GORNAL,10,5,15
2022/2023,08015961,ESCOLA JACINT VERDAGUER,08056,080569,CASTELLDEFELS,14,4,18
2022/2023,08015855,ESCOLA ELS PINS,08056,080569,CASTELLDEFELS,26,4,30
2022/2023,08015843,ESCOLA LLUÍS VIVES,08056,080569,CASTELLDEFELS,30,1,31
2022/2023,08015831,ESCOLA LA POPA,08055,080556,CASTELLCIR,11,3,14
2022/2023,08015821,ESCOLA MARE DE DÉU DE MONTSERRAT,08054,080543,CASTELLBISBAL,28,1,29
2022/2023,08015806,ESCOLA JAUME BALMES,08053,080538,CASTELLBELL I EL VILAR,15,4,19
2022/2023,08015651,ESCOLA PRINCESA LÀSCARIS,08049,080497,CASSERRES,13,3,16
2022/2023,08015648,ESCOLA SERRA DE COLL-BAS,08048,080484,CARME,9,2,11
2022/2023,08015612,ESCOLA JOAN DE PALÀ - ZER EL CARDENER,08047,080478,CARDONA,2,1,3
2022/2023,08015582,ESCOLA PATROCINI,08047,080478,CARDONA,13,3,16
2022/2023,08015454,ESCOLA RAMON MACIP - DOLORS GRANÉS,08046,080462,CARDEDEU,22,4,26
2022/2023,08015430,ESCOLA MARQUÈS DE LA POBLA,08044,080446,CAPELLADES,21,8,29
2022/2023,08015399,ESCOLA SANT NICOLAU,08043,080431,CANYELLES,25,5,30
2022/2023,08015375,ESCOLA L'ESTELADA,08042,080425,CÀNOVES I SAMALÚS,15,3,18
2022/2023,08015351,ESCOLA JACINT VERDAGUER,08041,080410,CANOVELLES,20,4,24
2022/2023,08015302,ESCOLA MISERICÒRDIA,08040,080403,CANET DE MAR,24,5,29
2022/2023,08015259,ESCOLA L'ALZINAR - ZER BAIX MONTSENY,08039,080399,CAMPINS,3,1,4
2022/2023,08015247,ESCOLA JOVENTUT,08038,080386,CALLÚS,16,1,17
2022/2023,08015193,ESCOLA SANT MARC,08037,080370,CALLDETENES,19,4,23
2022/2023,08015171,INSTITUT BISBE SIVILLA,08035,080351,CALELLA,48,30,78
2022/2023,08015144,ESCOLA EL FAR,08035,080351,CALELLA,29,2,31
2022/2023,08015119,ESCOLA LA MINERVA,08035,080351,CALELLA,27,3,30
2022/2023,08015107,ESCOLA ANTON BUSQUETS I PUNSET - ZER EL MOIANÈS PONENT,08034,080348,CALDERS,8,1,9
2022/2023,08015077,ESCOLA EL FARELL,08033,080333,CALDES DE MONTBUI,30,2,32
2022/2023,08015004,ESCOLA SAGRADA FAMÍLIA,08032,080327,CALDES D'ESTRAC,16,1,17
2022/2023,08014929,ESCOLA ALTA SEGARRA,08031,080312,CALAF,32,6,38
2022/2023,08014905,ESCOLA L'OLIVERA,08030,080305,CABRILS,27,1,28
2022/2023,08014841,ESCOLA LES OLIVERES - ZER SERRA D'ANCOSA,08028,080288,CABRERA D'ANOIA,4,1,5
2022/2023,08014814,ESCOLA EL BRUC,08025,080253,EL BRUC,12,4,16
2022/2023,08014796,ESCOLA DE BORREDÀ - ZER BERGUEDÀ CENTRE,08024,080240,BORREDÀ,3,0,3
2022/2023,08014747,ESCOLA EL TURÓ,08023,080235,BIGUES I RIELLS,14,4,18
2022/2023,08014693,INSTITUT GUILLEM DE BERGUEDÀ,08022,080229,BERGA,47,22,69
2022/2023,08014681,ESCOLA SANTA EULÀLIA,08022,080229,BERGA,28,3,31
2022/2023,08014668,ESCOLA DE LA VALLDAN,08022,080229,BERGA,11,1,12
2022/2023,08014620,ESCOLA SANT JOAN,08022,080229,BERGA,21,5,26
2022/2023,08014589,ESCOLA SANT CRISTÒFOR,08020,080207,BEGUES,28,4,32
2022/2023,08014401,INSTITUT MARE DE DÉU DE LA MERCÈ,08019,080193,BARCELONA,73,85,158
2022/2023,08013470,INSTITUT BARRI BESÒS,08019,080193,BARCELONA,39,14,53
2022/2023,08013469,INSTITUT RAMBLA PRIM,08019,080193,BARCELONA,23,32,55
2022/2023,08013457,ESCOLA PEGASO,08019,080193,BARCELONA,30,2,32
2022/2023,08013411,ESCOLA POBLE-SEC,08019,080193,BARCELONA,32,1,33
2022/2023,08013408,ESCOLA BARCELONA,08019,080193,BARCELONA,29,4,33
2022/2023,08013366,INSTITUT NOU BARRIS,08019,080193,BARCELONA,36,19,55
2022/2023,08013329,EA LLOTJA,08019,080193,BARCELONA,76,58,134
2022/2023,08013275,INSTITUT ESCOLA DEL TREBALL,08019,080193,BARCELONA,97,160,257
2022/2023,08013238,INSTITUT VERDAGUER,08019,080193,BARCELONA,24,13,37
2022/2023,08013226,INSTITUT MENÉNDEZ Y PELAYO,08019,080193,BARCELONA,35,28,63
2022/2023,08013214,INSTITUT NARCÍS MONTURIOL,08019,080193,BARCELONA,23,14,37
2022/2023,08013202,INSTITUT MONTSERRAT,08019,080193,BARCELONA,48,26,74
2022/2023,08013196,INSTITUT MILÀ I FONTANALS,08019,080193,BARCELONA,40,21,61
2022/2023,08013184,INSTITUT BERNAT METGE,08019,080193,BARCELONA,24,19,43
2022/2023,08013160,INSTITUT POETA MARAGALL,08019,080193,BARCELONA,46,23,69
2022/2023,08013159,INSTITUT INFANTA ISABEL D'ARAGÓ,08019,080193,BARCELONA,39,27,66
2022/2023,08013147,INSTITUT SANTS,08019,080193,BARCELONA,44,17,61
2022/2023,08013135,INSTITUT MOISÈS BROGGI,08019,080193,BARCELONA,58,17,75
2022/2023,08013111,INSTITUT JAUME BALMES,08019,080193,BARCELONA,47,41,88
2022/2023,08013101,INSTITUT JOAN D'ÀUSTRIA,08019,080193,BARCELONA,42,42,84
2022/2023,08013093,INSTITUT MONTJUÏC,08019,080193,BARCELONA,27,15,42
2022/2023,08002991,ESCOLA CASCAVELL,08194,081944,SANT ADRIÀ DE BESÒS,12,6,18
2022/2023,08002988,ESCOLA PARE POVEDA,08019,080193,BARCELONA,25,2,27
2022/2023,08002976,ESCOLA RAMON CASAS,08019,080193,BARCELONA,28,3,31
2022/2023,08002952,ESCOLA ENRIC GRANADOS,08019,080193,BARCELONA,15,4,19
2022/2023,08002927,ESCOLA JOAQUIM RUYRA,08019,080193,BARCELONA,25,7,32
2022/2023,08002915,ESCOLA BRASIL,08019,080193,BARCELONA,20,3,23
2022/2023,08002903,CEE SANT JOAN DE LA CREU,08019,080193,BARCELONA,34,2,36
2022/2023,08002897,ESCOLA MESTRE MORERA,08019,080193,BARCELONA,22,0,22
2022/2023,08002873,ESCOLA BAC DE RODA,08019,080193,BARCELONA,27,3,30
2022/2023,08002800,ESCOLA MAS CASANOVAS,08019,080193,BARCELONA,15,5,20
2022/2023,08002770,ESCOLA ÀGORA,08019,080193,BARCELONA,11,7,18
2022/2023,08002745,ESCOLA EL CARMEL,08019,080193,BARCELONA,30,6,36
2022/2023,08002733,ESCOLA MIRALLETES,08019,080193,BARCELONA,18,0,18
2022/2023,08002721,ESCOLA FONT D'EN FARGAS,08019,080193,BARCELONA,30,3,33
2022/2023,08002681,ESCOLA DURAN I BAS,08019,080193,BARCELONA,30,1,31
2022/2023,08002666,CEE CONCHA ESPINA,08019,080193,BARCELONA,19,2,21
2022/2023,08002654,ESCOLA PRIM,08019,080193,BARCELONA,20,0,20
2022/2023,08002642,ESCOLA POBLENOU,08019,080193,BARCELONA,23,4,27
2022/2023,08002630,ESCOLA ELS PORXOS,08019,080193,BARCELONA,14,3,17
2022/2023,08002629,ESCOLA LES ACÀCIES,08019,080193,BARCELONA,28,5,33
2022/2023,08002617,ESCOLA RAMBLETA DEL CLOT,08019,080193,BARCELONA,28,5,33
2022/2023,08002599,ESCOLA EDUARD MARQUINA,08019,080193,BARCELONA,16,6,22
2022/2023,08002587,ESCOLA CONCEPCIÓN ARENAL,08019,080193,BARCELONA,19,4,23
2022/2023,08002575,ESCOLA LA PAU,08019,080193,BARCELONA,17,3,20
2022/2023,08002563,ESCOLA LA MAR BELLA,08019,080193,BARCELONA,22,6,28
2022/2023,08002551,ESCOLA MOLÍ DE FINESTRELLES,08019,080193,BARCELONA,27,4,31
2022/2023,08002538,ESCOLA VÍCTOR CATALÀ,08019,080193,BARCELONA,30,1,31
2022/2023,08002526,ESCOLA TIBIDABO,08019,080193,BARCELONA,15,3,18
2022/2023,08002484,ESCOLA MARTA MATA,08019,080193,BARCELONA,18,1,19
2022/2023,08002459,ESCOLA ELISENDA DE MONTCADA,08019,080193,BARCELONA,27,9,36
2022/2023,08002411,ESCOLA BARÓ DE VIVER,08019,080193,BARCELONA,17,1,18
2022/2023,08002393,ESCOLA L'ARC DE SANT MARTÍ,08019,080193,BARCELONA,19,2,21
2022/2023,08002368,ESCOLA TIMBALER DEL BRUC,08019,080193,BARCELONA,16,2,18
2022/2023,08002344,ESCOLA EL TURÓ,08019,080193,BARCELONA,18,2,20
2022/2023,08002320,ESCOLA CIUTAT COMTAL,08019,080193,BARCELONA,15,4,19
2022/2023,08000098,ESCOLA BERTÍ,08005,080057,L'AMETLLA DEL VALLÈS,26,1,27
2022/2023,08002290,ESCOLA EMILI JUNCADELLA,08019,080193,BARCELONA,17,2,19
2022/2023,08002277,ESCOLA CALDERÓN DE LA BARCA,08019,080193,BARCELONA,30,4,34
2022/2023,08002216,ESCOLA JOSEP MARIA DE SAGARRA,08019,080193,BARCELONA,16,1,17
2022/2023,08002204,ESCOLA MONTSENY,08019,080193,BARCELONA,16,1,17
2022/2023,08002198,ESCOLA LA FARIGOLA DE VALLCARCA,08019,080193,BARCELONA,15,2,17
2022/2023,08002186,ESCOLA MARE DE DÉU DE MONTSERRAT,08019,080193,BARCELONA,16,3,19
2022/2023,08002174,ESCOLA BALDIRI REIXAC,08019,080193,BARCELONA,17,0,17
2022/2023,08002113,ESCOLA RIUS I TAULET,08019,080193,BARCELONA,27,5,32
2022/2023,08002071,ESCOLA GAYARRE,08019,080193,BARCELONA,21,2,23
2022/2023,08002061,ESCOLA JAUME I,08019,080193,BARCELONA,33,4,37
2022/2023,08002058,ESCOLA PRÀCTIQUES,08019,080193,BARCELONA,29,4,33
2022/2023,08002022,ESCOLA CAL MAIOL,08019,080193,BARCELONA,14,3,17
2022/2023,08002010,ESCOLA LLUÍS VIVES,08019,080193,BARCELONA,14,4,18
2022/2023,08002009,ESCOLA FRANCESC MACIÀ,08019,080193,BARCELONA,17,3,20
2022/2023,08001947,ESCOLA MALLORCA,08019,080193,BARCELONA,28,4,32
2022/2023,08001923,ESCOLA DIPUTACIÓ,08019,080193,BARCELONA,26,5,31
2022/2023,08001911,ESCOLA ELS LLORERS,08019,080193,BARCELONA,29,6,35
2022/2023,08001868,ESCOLA RUBÉN DARÍO,08019,080193,BARCELONA,19,2,21
2022/2023,08001856,ESCOLA DRASSANES,08019,080193,BARCELONA,27,6,33
2022/2023,08001832,ESCOLA CASTELLA,08019,080193,BARCELONA,18,4,22
2022/2023,08001820,ESCOLA MILÀ I FONTANALS,08019,080193,BARCELONA,32,5,37
2022/2023,08001819,ESCOLA COLLASO I GIL,08019,080193,BARCELONA,33,8,41
2022/2023,08001807,ESCOLA DE LA CONCEPCIÓ,08019,080193,BARCELONA,14,3,17
2022/2023,08001790,ESCOLA PERE VILA,08019,080193,BARCELONA,29,5,34
2022/2023,08001789,ESCOLA CERVANTES,08019,080193,BARCELONA,16,3,19
2022/2023,08001777,ESCOLA RAMON LLULL,08019,080193,BARCELONA,31,5,36
2022/2023,08001731,ESCOLA POETA FOIX,08019,080193,BARCELONA,16,2,18
2022/2023,08001716,ESCOLA DOLORS MONSERDÀ-SANTAPAU,08019,080193,BARCELONA,25,5,30
2022/2023,08001674,ESCOLA CAN CLOS,08019,080193,BARCELONA,13,1,14
2022/2023,08001650,ESCOLA EL POLVORÍ,08019,080193,BARCELONA,16,4,20
2022/2023,08001649,ESCOLA MOSSÈN JACINT VERDAGUER,08019,080193,BARCELONA,33,6,39
2022/2023,08001601,ESCOLA PARC DE LA CIUTADELLA,08019,080193,BARCELONA,18,1,19
2022/2023,08001595,ESCOLA BAIXERAS,08019,080193,BARCELONA,14,4,18
2022/2023,08001522,ESCOLA GALCERAN DE PINÓS,08016,080168,BAGÀ,12,2,14
2022/2023,08001509,ESCOLA ANTONI BOTEY,08015,080155,BADALONA,32,2,34
2022/2023,08001480,EA PAU GARGALLO,08015,080155,BADALONA,29,24,53
2022/2023,08001443,INSTITUT EUGENI D'ORS,08015,080155,BADALONA,65,37,102
2022/2023,08001431,INSTITUT ISAAC ALBÉNIZ,08015,080155,BADALONA,32,29,61
2022/2023,08001421,INSTITUT LA PINEDA,08015,080155,BADALONA,53,54,107
2022/2023,08001391,ESCOLA PLANAS I CASALS,08015,080155,BADALONA,24,6,30
2022/2023,08000402,ESCOLA FELIU I VEGUÉS,08015,080155,BADALONA,22,5,27
2022/2023,08000396,ESCOLA VENTÓS I MIR,08015,080155,BADALONA,25,2,27
2021/2022,25001278,ESCOLA SANTA MARIA - ZER SERRA LLARGA,25069,250693,CASTELLÓ DE FARFANYA,3,1,4
2021/2022,08002071,ESCOLA GAYARRE,08019,080193,BARCELONA,18,2,20
2021/2022,08044636,EOI DE SABADELL,08187,081878,SABADELL,18,6,24
2021/2022,08044648,ESCOLA LA RODA,08279,082798,TERRASSA,30,3,33
2021/2022,08000013,ESCOLA FRANCESC PLATÓN I SARTÍ,08001,080018,ABRERA,27,6,33
2021/2022,08000049,ESCOLA FABRA,08003,080039,ALELLA,31,1,32
2021/2022,08000086,ESCOLA LA FORJA - ZER ALT LLUÇANÈS,08004,080044,ALPENS,4,0,4
2021/2022,08000098,ESCOLA BERTÍ,08005,080057,L'AMETLLA DEL VALLÈS,26,1,27
2021/2022,08000153,ESCOLA JOAN MARAGALL,08006,080060,ARENYS DE MAR,38,4,42
2021/2022,08000165,ESCOLA SANT MARTÍ,08007,080076,ARENYS DE MUNT,20,8,28
2021/2022,08000189,ESCOLA BERNAT DE RIUDEMEIA,08009,080095,ARGENTONA,14,2,16
2021/2022,08000244,ESCOLA DOCTOR FERRER,08010,080109,ARTÉS,24,7,31
2021/2022,08000271,ESCOLA SANTA MARIA D'AVIÀ,08011,080116,AVIÀ,18,2,20
2021/2022,08000347,ESCOLA D'AVINYONET DEL PENEDÈS,08013,080137,AVINYONET DEL PENEDÈS,12,1,13
2021/2022,08000359,ESCOLA LA MUNTANYA,08014,080142,AIGUAFREDA,16,1,17
2021/2022,08000384,ESCOLA LOLA ANGLADA,08015,080155,BADALONA,28,4,32
2021/2022,08000396,ESCOLA VENTÓS I MIR,08015,080155,BADALONA,24,3,27
2021/2022,08000402,ESCOLA FELIU I VEGUÉS,08015,080155,BADALONA,26,5,31
2021/2022,08001391,ESCOLA PLANAS I CASALS,08015,080155,BADALONA,25,6,31
2021/2022,08001421,INSTITUT LA PINEDA,08015,080155,BADALONA,51,50,101
2021/2022,08001431,INSTITUT ISAAC ALBÉNIZ,08015,080155,BADALONA,40,23,63
2021/2022,08001443,INSTITUT EUGENI D'ORS,08015,080155,BADALONA,55,38,93
2021/2022,08001480,EA PAU GARGALLO,08015,080155,BADALONA,24,23,47
2021/2022,08001509,ESCOLA ANTONI BOTEY,08015,080155,BADALONA,34,3,37
2021/2022,08001522,ESCOLA GALCERAN DE PINÓS,08016,080168,BAGÀ,12,1,13
2021/2022,08001595,ESCOLA BAIXERAS,08019,080193,BARCELONA,17,2,19
2021/2022,08001601,ESCOLA PARC DE LA CIUTADELLA,08019,080193,BARCELONA,16,2,18
2021/2022,08001649,ESCOLA MOSSÈN JACINT VERDAGUER,08019,080193,BARCELONA,34,4,38
2021/2022,08001650,ESCOLA EL POLVORÍ,08019,080193,BARCELONA,13,5,18
2021/2022,08001674,ESCOLA CAN CLOS,08019,080193,BARCELONA,14,0,14
2021/2022,08001716,ESCOLA DOLORS MONSERDÀ-SANTAPAU,08019,080193,BARCELONA,24,6,30
2021/2022,08001731,ESCOLA POETA FOIX,08019,080193,BARCELONA,15,3,18
2021/2022,08001777,ESCOLA RAMON LLULL,08019,080193,BARCELONA,28,7,35
2021/2022,08001789,ESCOLA CERVANTES,08019,080193,BARCELONA,16,2,18
2021/2022,08001790,ESCOLA PERE VILA,08019,080193,BARCELONA,29,7,36
2021/2022,08001807,ESCOLA DE LA CONCEPCIÓ,08019,080193,BARCELONA,13,5,18
2021/2022,08001819,ESCOLA COLLASO I GIL,08019,080193,BARCELONA,35,6,41
2021/2022,08001820,ESCOLA MILÀ I FONTANALS,08019,080193,BARCELONA,31,7,38
2021/2022,08001832,ESCOLA CASTELLA,08019,080193,BARCELONA,17,5,22
2021/2022,08001856,ESCOLA DRASSANES,08019,080193,BARCELONA,26,7,33
2021/2022,08001868,ESCOLA RUBÉN DARÍO,08019,080193,BARCELONA,18,4,22
2021/2022,08001911,ESCOLA ELS LLORERS,08019,080193,BARCELONA,30,5,35
2021/2022,08001923,ESCOLA DIPUTACIÓ,08019,080193,BARCELONA,27,4,31
2021/2022,08001947,ESCOLA MALLORCA,08019,080193,BARCELONA,27,4,31
2021/2022,08002009,ESCOLA FRANCESC MACIÀ,08019,080193,BARCELONA,17,2,19
2021/2022,08002010,ESCOLA LLUÍS VIVES,08019,080193,BARCELONA,14,6,20
2021/2022,08002022,ESCOLA CAL MAIOL,08019,080193,BARCELONA,15,3,18
2021/2022,08002058,ESCOLA PRÀCTIQUES,08019,080193,BARCELONA,30,4,34
2021/2022,08002061,ESCOLA JAUME I,08019,080193,BARCELONA,34,4,38
2021/2022,08002113,ESCOLA RIUS I TAULET,08019,080193,BARCELONA,28,4,32
2021/2022,08002174,ESCOLA BALDIRI REIXAC,08019,080193,BARCELONA,18,0,18
2021/2022,08002186,ESCOLA MARE DE DÉU DE MONTSERRAT,08019,080193,BARCELONA,13,6,19
2021/2022,08002198,ESCOLA LA FARIGOLA DE VALLCARCA,08019,080193,BARCELONA,14,3,17
2021/2022,08002204,ESCOLA MONTSENY,08019,080193,BARCELONA,16,1,17
2021/2022,08002216,ESCOLA JOSEP MARIA DE SAGARRA,08019,080193,BARCELONA,17,1,18
2021/2022,08002277,ESCOLA CALDERÓN DE LA BARCA,08019,080193,BARCELONA,29,4,33
2021/2022,08002290,ESCOLA EMILI JUNCADELLA,08019,080193,BARCELONA,17,2,19
2021/2022,08002320,ESCOLA CIUTAT COMTAL,08019,080193,BARCELONA,14,5,19
2021/2022,08002344,ESCOLA EL TURÓ,08019,080193,BARCELONA,18,2,20
2021/2022,08002368,ESCOLA TIMBALER DEL BRUC,08019,080193,BARCELONA,15,3,18
2021/2022,08002393,ESCOLA L'ARC DE SANT MARTÍ,08019,080193,BARCELONA,20,1,21
2021/2022,08002411,ESCOLA BARÓ DE VIVER,08019,080193,BARCELONA,16,1,17
2021/2022,08002459,ESCOLA ELISENDA DE MONTCADA,08019,080193,BARCELONA,29,8,37
2021/2022,08002484,ESCOLA MARTA MATA,08019,080193,BARCELONA,17,2,19
2021/2022,08002526,ESCOLA TIBIDABO,08019,080193,BARCELONA,13,4,17
2021/2022,08002538,ESCOLA VÍCTOR CATALÀ,08019,080193,BARCELONA,31,1,32
2021/2022,08002551,ESCOLA MOLÍ DE FINESTRELLES,08019,080193,BARCELONA,28,3,31
2021/2022,08002563,ESCOLA LA MAR BELLA,08019,080193,BARCELONA,23,3,26
2021/2022,08002575,ESCOLA LA PAU,08019,080193,BARCELONA,17,4,21
2021/2022,08002587,ESCOLA CONCEPCIÓN ARENAL,08019,080193,BARCELONA,18,4,22
2021/2022,08002599,ESCOLA EDUARD MARQUINA,08019,080193,BARCELONA,17,5,22
2021/2022,08002617,ESCOLA RAMBLETA DEL CLOT,08019,080193,BARCELONA,26,4,30
2021/2022,08002629,ESCOLA LES ACÀCIES,08019,080193,BARCELONA,26,7,33
2021/2022,08002630,ESCOLA ELS PORXOS,08019,080193,BARCELONA,13,4,17
2021/2022,08002642,ESCOLA POBLENOU,08019,080193,BARCELONA,21,4,25
2021/2022,08002654,ESCOLA PRIM,08019,080193,BARCELONA,21,1,22
2021/2022,08002666,CEE CONCHA ESPINA,08019,080193,BARCELONA,17,3,20
2021/2022,08002681,ESCOLA DURAN I BAS,08019,080193,BARCELONA,28,2,30
2021/2022,08002721,ESCOLA FONT D'EN FARGAS,08019,080193,BARCELONA,28,4,32
2021/2022,08002733,ESCOLA MIRALLETES,08019,080193,BARCELONA,17,1,18
2021/2022,08002745,ESCOLA EL CARMEL,08019,080193,BARCELONA,32,5,37
2021/2022,08002770,ESCOLA ÀGORA,08019,080193,BARCELONA,13,6,19
2021/2022,08002800,ESCOLA MAS CASANOVAS,08019,080193,BARCELONA,19,1,20
2021/2022,08002873,ESCOLA BAC DE RODA,08019,080193,BARCELONA,26,4,30
2021/2022,08002885,ESCOLA PROSPERITAT,08019,080193,BARCELONA,17,1,18
2021/2022,08002897,ESCOLA MESTRE MORERA,08019,080193,BARCELONA,21,1,22
2021/2022,08002903,CEE SANT JOAN DE LA CREU,08019,080193,BARCELONA,32,2,34
2021/2022,08002915,ESCOLA BRASIL,08019,080193,BARCELONA,22,2,24
2021/2022,08002927,ESCOLA JOAQUIM RUYRA,08019,080193,BARCELONA,26,7,33
2021/2022,08002952,ESCOLA ENRIC GRANADOS,08019,080193,BARCELONA,17,5,22
2021/2022,08002976,ESCOLA RAMON CASAS,08019,080193,BARCELONA,27,3,30
2021/2022,08002988,ESCOLA PARE POVEDA,08019,080193,BARCELONA,23,3,26
2021/2022,08002991,ESCOLA CASCAVELL,08194,081944,SANT ADRIÀ DE BESÒS,13,5,18
2021/2022,08013093,INSTITUT MONTJUÏC,08019,080193,BARCELONA,25,15,40
2021/2022,08013101,INSTITUT JOAN D'ÀUSTRIA,08019,080193,BARCELONA,43,34,77
2021/2022,08013111,INSTITUT JAUME BALMES,08019,080193,BARCELONA,43,40,83
2021/2022,08013135,INSTITUT MOISÈS BROGGI,08019,080193,BARCELONA,51,21,72
2021/2022,08013147,INSTITUT EMPERADOR CARLES,08019,080193,BARCELONA,43,17,60
2021/2022,08013159,INSTITUT INFANTA ISABEL D'ARAGÓ,08019,080193,BARCELONA,41,25,66
2021/2022,08013160,INSTITUT POETA MARAGALL,08019,080193,BARCELONA,40,26,66
2021/2022,08013184,INSTITUT BERNAT METGE,08019,080193,BARCELONA,20,20,40
2021/2022,08013196,INSTITUT MILÀ I FONTANALS,08019,080193,BARCELONA,36,21,57
2021/2022,08013202,INSTITUT MONTSERRAT,08019,080193,BARCELONA,46,24,70
2021/2022,08013214,INSTITUT NARCÍS MONTURIOL,08019,080193,BARCELONA,24,12,36
2021/2022,08013226,INSTITUT MENÉNDEZ Y PELAYO,08019,080193,BARCELONA,33,25,58
2021/2022,08013238,INSTITUT VERDAGUER,08019,080193,BARCELONA,24,13,37
2021/2022,08013275,INSTITUT ESCOLA DEL TREBALL,08019,080193,BARCELONA,88,136,224
2021/2022,08013329,EA LLOTJA,08019,080193,BARCELONA,65,52,117
2021/2022,08013366,INSTITUT NOU BARRIS,08019,080193,BARCELONA,38,12,50
2021/2022,08013408,ESCOLA BARCELONA,08019,080193,BARCELONA,28,4,32
2021/2022,08013411,ESCOLA POBLE-SEC,08019,080193,BARCELONA,28,3,31
2021/2022,08013457,ESCOLA PEGASO,08019,080193,BARCELONA,28,3,31
2021/2022,08013469,INSTITUT RAMBLA PRIM,08019,080193,BARCELONA,21,32,53
2021/2022,08013470,INSTITUT BARRI BESÒS,08019,080193,BARCELONA,38,15,53
2021/2022,08014401,INSTITUT MARE DE DÉU DE LA MERCÈ,08019,080193,BARCELONA,62,83,145
2021/2022,08014589,ESCOLA SANT CRISTÒFOR,08020,080207,BEGUES,28,4,32
2021/2022,08014620,ESCOLA SANT JOAN,08022,080229,BERGA,20,4,24
2021/2022,08014668,ESCOLA DE LA VALLDAN,08022,080229,BERGA,9,4,13
2021/2022,08014681,ESCOLA SANTA EULÀLIA,08022,080229,BERGA,29,2,31
2021/2022,08014693,INSTITUT GUILLEM DE BERGUEDÀ,08022,080229,BERGA,43,17,60
2021/2022,08014747,ESCOLA EL TURÓ,08023,080235,BIGUES I RIELLS,15,3,18
2021/2022,08014796,ESCOLA DE BORREDÀ - ZER BERGUEDÀ CENTRE,08024,080240,BORREDÀ,3,0,3
2021/2022,08014814,ESCOLA EL BRUC,08025,080253,EL BRUC,11,4,15
2021/2022,08014841,ESCOLA LES OLIVERES - ZER SERRA D'ANCOSA,08028,080288,CABRERA D'ANOIA,4,1,5
2021/2022,08014905,ESCOLA L'OLIVERA,08030,080305,CABRILS,27,2,29
2021/2022,08014929,ESCOLA ALTA SEGARRA,08031,080312,CALAF,32,4,36
2021/2022,08015004,ESCOLA SAGRADA FAMÍLIA,08032,080327,CALDES D'ESTRAC,14,1,15
2021/2022,08015077,ESCOLA EL FARELL,08033,080333,CALDES DE MONTBUI,28,1,29
2021/2022,08015107,ESCOLA ANTON BUSQUETS I PUNSET - ZER EL MOIANÈS PONENT,08034,080348,CALDERS,8,1,9
2021/2022,08015119,ESCOLA LA MINERVA,08035,080351,CALELLA,24,4,28
2021/2022,08015144,ESCOLA EL FAR,08035,080351,CALELLA,27,3,30
2021/2022,08015171,INSTITUT BISBE SIVILLA,08035,080351,CALELLA,44,23,67
2021/2022,08015193,ESCOLA SANT MARC,08037,080370,CALLDETENES,19,4,23
2021/2022,08015247,ESCOLA JOVENTUT,08038,080386,CALLÚS,14,2,16
2021/2022,08015259,ESCOLA L'ALZINAR - ZER BAIX MONTSENY,08039,080399,CAMPINS,3,1,4
2021/2022,08015302,ESCOLA MISERICÒRDIA,08040,080403,CANET DE MAR,24,5,29
2021/2022,08015351,ESCOLA JACINT VERDAGUER,08041,080410,CANOVELLES,21,4,25
2021/2022,08015375,ESCOLA L'ESTELADA,08042,080425,CÀNOVES I SAMALÚS,14,3,17
2021/2022,08015399,ESCOLA SANT NICOLAU,08043,080431,CANYELLES,23,5,28
2021/2022,08015430,ESCOLA MARQUÈS DE LA POBLA,08044,080446,CAPELLADES,20,8,28
2021/2022,08015454,ESCOLA RAMON MACIP - DOLORS GRANÉS,08046,080462,CARDEDEU,21,4,25
2021/2022,08015582,ESCOLA PATROCINI,08047,080478,CARDONA,13,3,16
2021/2022,08015612,ESCOLA JOAN DE PALÀ - ZER EL CARDENER,08047,080478,CARDONA,3,1,4
2021/2022,08015648,ESCOLA SERRA DE COLL-BAS,08048,080484,CARME,8,2,10
2021/2022,08015651,ESCOLA PRINCESA LÀSCARIS,08049,080497,CASSERRES,11,3,14
2021/2022,08015806,ESCOLA JAUME BALMES,08053,080538,CASTELLBELL I EL VILAR,15,4,19
2021/2022,08015821,ESCOLA MARE DE DÉU DE MONTSERRAT,08054,080543,CASTELLBISBAL,26,2,28
2021/2022,08015831,ESCOLA LA POPA,08055,080556,CASTELLCIR,9,3,12
2021/2022,08015843,ESCOLA LLUÍS VIVES,08056,080569,CASTELLDEFELS,30,2,32
2021/2022,08015855,ESCOLA ELS PINS,08056,080569,CASTELLDEFELS,26,4,30
2021/2022,08015961,ESCOLA JACINT VERDAGUER,08056,080569,CASTELLDEFELS,15,2,17
2021/2022,08016033,ESCOLA MONTANYANS,08058,080581,CASTELLET I LA GORNAL,10,4,14
2021/2022,08016069,ESCOLA COLL DE GOSSEM - ZER TRES BRANQUES,08059,080594,CASTELLFOLLIT DEL BOIX,3,0,3
2021/2022,08016070,ESCOLA DE MAIANS - ZER TRES BRANQUES,08059,080594,CASTELLFOLLIT DEL BOIX,2,0,2
2021/2022,08016082,ESCOLA SANT ROC - ZER VENT D'AVALL,08060,080608,CASTELLFOLLIT DE RIUBREGÓS,3,0,3
2021/2022,08016094,ESCOLA SANT MIQUEL,08061,080615,CASTELLGALÍ,14,1,15
2021/2022,08016136,ESCOLA LES PASSERES - ZER TRES BRANQUES,08063,080636,CASTELLOLÍ,6,1,7
2021/2022,08016161,ESCOLA EL CASTELLOT,08065,080654,CASTELLVÍ DE LA MARCA,10,3,13
2021/2022,08016173,ESCOLA MARE DE DÉU DE MONTSERRAT,08066,080667,CASTELLVÍ DE ROSANES,14,0,14
2021/2022,08016185,ESCOLA ILDEFONS CERDÀ,08067,080673,CENTELLES,23,4,27
2021/2022,08016240,ESCOLA SANTA MARIA DE CERVELLÓ,08068,080689,CERVELLÓ,28,3,31
2021/2022,08016264,ESCOLA EL SOLELL,08905,089058,LA PALMA DE CERVELLÓ,12,5,17
2021/2022,08016291,ESCOLA QUATRE VENTS - ZER VENT D'AVALL,08071,080713,COPONS,7,0,7
2021/2022,08016331,ESCOLA JAUME BALMES,08072,080728,CORBERA DE LLOBREGAT,20,7,27
2021/2022,08016367,ESCOLA DOLORS ALMEDA,08073,080734,CORNELLÀ DE LLOBREGAT,27,4,31
2021/2022,08016380,ESCOLA ANSELM CLAVÉ,08073,080734,CORNELLÀ DE LLOBREGAT,16,2,18
2021/2022,08016392,ESCOLA MOSSÈN JACINT VERDAGUER,08073,080734,CORNELLÀ DE LLOBREGAT,17,2,19
2021/2022,08016409,ESCOLA MONTSERRAT,08073,080734,CORNELLÀ DE LLOBREGAT,13,5,18
2021/2022,08016410,ESCOLA SANT ILDEFONS,08073,080734,CORNELLÀ DE LLOBREGAT,19,6,25
2021/2022,08016422,ESCOLA ABAT OLIBA,08073,080734,CORNELLÀ DE LLOBREGAT,18,4,22
2021/2022,08016744,ESCOLA ANTONI GAUDÍ,08073,080734,CORNELLÀ DE LLOBREGAT,18,5,23
2021/2022,08016771,ESCOLA ELS PINS,08073,080734,CORNELLÀ DE LLOBREGAT,25,6,31
2021/2022,08016781,INSTITUT ESTEVE TERRADAS I ILLA,08073,080734,CORNELLÀ DE LLOBREGAT,70,81,151
2021/2022,08016793,INSTITUT FRANCESC MACIÀ,08073,080734,CORNELLÀ DE LLOBREGAT,35,30,65
2021/2022,08016811,ESCOLA JOSEP ANDREU - CHARLIE RIVEL,08074,080749,CUBELLES,35,4,39
2021/2022,08016872,ESCOLA MARE DE DÉU DE LA MUNTANYA,08076,080765,ESPARREGUERA,15,2,17
2021/2022,08016938,ESCOLA TAQUÍGRAF GARRIGA,08076,080765,ESPARREGUERA,21,5,26
2021/2022,08016941,ESCOLA ISIDRE MARTÍ,08077,080771,ESPLUGUES DE LLOBREGAT,23,4,27
2021/2022,08017104,ESCOLA GRAS I SOLER,08077,080771,ESPLUGUES DE LLOBREGAT,15,3,18
2021/2022,08017116,ESCOLA MATILDE ORDUÑA,08077,080771,ESPLUGUES DE LLOBREGAT,17,2,19
2021/2022,08017131,INSTITUT SEVERO OCHOA,08077,080771,ESPLUGUES DE LLOBREGAT,64,33,97
2021/2022,08017153,INSTITUT JOANOT MARTORELL,08077,080771,ESPLUGUES DE LLOBREGAT,33,20,53
2021/2022,08017232,ESCOLA AGRUPACIÓ SANT JORDI,08084,080847,FONOLLOSA,14,2,16
2021/2022,08017244,ESCOLA FONT-RÚBIA,08085,080850,FONT-RUBÍ,14,0,14
2021/2022,08017271,ESCOLA JOAN SANPERA I TORRAS,08086,080863,LES FRANQUESES DEL VALLÈS,30,1,31
2021/2022,08017311,ESCOLA PUIGGRACIÓS,08088,080885,LA GARRIGA,23,7,30
2021/2022,08017359,ESCOLA SALVADOR LLUCH,08089,080898,GAVÀ,30,1,31
2021/2022,08017360,ESCOLA JACME MARCH,08089,080898,GAVÀ,19,2,21
2021/2022,08017505,ESCOLA JUAN SALAMERO,08089,080898,GAVÀ,12,4,16
2021/2022,08017530,INSTITUT DE BRUGUERS,08089,080898,GAVÀ,29,23,52
2021/2022,08017611,ESCOLA MONTCAU,08091,080919,GELIDA,23,3,26
2021/2022,08017633,ESCOLA SANT MARC,08092,080924,GIRONELLA,15,1,16
2021/2022,08017645,ESCOLA DE GIRONELLA,08092,080924,GIRONELLA,16,1,17
2021/2022,08017682,ESCOLA JACINT VERDAGUER,08094,080945,LA GRANADA,11,3,14
2021/2022,08017694,ESCOLA PEREANTON,08096,080961,GRANOLLERS,14,2,16
2021/2022,08017700,ESCOLA JOAN SOLANS,08096,080961,GRANOLLERS,15,4,19
2021/2022,08017712,ESCOLA FERRER I GUÀRDIA,08096,080961,GRANOLLERS,16,3,19
2021/2022,08017918,ESCOLA GRANULLARIUS,08096,080961,GRANOLLERS,29,2,31
2021/2022,08017931,INSTITUT ANTONI CUMELLA,08096,080961,GRANOLLERS,41,21,62
2021/2022,08017979,ESCOLA AQUA ALBA,08097,080977,GUALBA,11,3,14
2021/2022,08017992,ESCOLA MONTSERRAT,08098,080983,SANT SALVADOR DE GUARDIOLA,19,2,21
2021/2022,08018005,ESCOLA SANT LLORENÇ,08099,080996,GUARDIOLA DE BERGUEDÀ,7,4,11
2021/2022,08018017,ESCOLA L'ALBIOL - ZER ALT BERGUEDÀ,08903,089030,SANT JULIÀ DE CERDANYOLA,3,0,3
2021/2022,08018029,ESCOLA LES ESCOLES,08100,081000,GURB,28,2,30
2021/2022,08018066,ESCOLA MENÉNDEZ PIDAL,08101,081017,L'HOSPITALET DE LLOBREGAT,48,10,58
2021/2022,08018078,ESCOLA BELLVITGE,08101,081017,L'HOSPITALET DE LLOBREGAT,17,2,19
2021/2022,08018091,ESCOLA PEP VENTURA,08101,081017,L'HOSPITALET DE LLOBREGAT,35,7,42
2021/2022,08018145,ESCOLA PAU VILA,08101,081017,L'HOSPITALET DE LLOBREGAT,20,7,27
2021/2022,08018157,ESCOLA SANTIAGO RAMON Y CAJAL,08101,081017,L'HOSPITALET DE LLOBREGAT,36,6,42
2021/2022,08019149,ESCOLA BERNAT METGE,08101,081017,L'HOSPITALET DE LLOBREGAT,20,2,22
2021/2022,08019198,ESCOLA POMPEU FABRA,08101,081017,L'HOSPITALET DE LLOBREGAT,29,6,35
2021/2022,08019216,ESCOLA BUSQUETS I PUNSET,08101,081017,L'HOSPITALET DE LLOBREGAT,25,6,31
2021/2022,08019231,ESCOLA MILAGROS CONSARNAU,08101,081017,L'HOSPITALET DE LLOBREGAT,27,7,34
2021/2022,08019241,ESCOLA FREDERIC MISTRAL,08101,081017,L'HOSPITALET DE LLOBREGAT,26,4,30
2021/2022,08019265,ESCOLA JOAQUIM RUYRA,08101,081017,L'HOSPITALET DE LLOBREGAT,29,9,38
2021/2022,08019277,ESCOLA LA MARINA,08101,081017,L'HOSPITALET DE LLOBREGAT,30,3,33
2021/2022,08019290,ESCOLA PROVENÇANA,08101,081017,L'HOSPITALET DE LLOBREGAT,13,6,19
2021/2022,08019307,INSTITUT SANTA EULÀLIA,08101,081017,L'HOSPITALET DE LLOBREGAT,43,13,56
2021/2022,08019319,INSTITUT PEDRAFORCA,08101,081017,L'HOSPITALET DE LLOBREGAT,65,36,101
2021/2022,08019320,INSTITUT TORRAS I BAGES,08101,081017,L'HOSPITALET DE LLOBREGAT,37,21,58
2021/2022,08019371,INSTITUT LLOBREGAT,08101,081017,L'HOSPITALET DE LLOBREGAT,9,31,40
2021/2022,08019401,INSTITUT PROVENÇANA,08101,081017,L'HOSPITALET DE LLOBREGAT,43,47,90
2021/2022,08019411,INSTITUT BELLVITGE,08101,081017,L'HOSPITALET DE LLOBREGAT,29,15,44
2021/2022,08019435,ESCOLA GARCÍA I FOSSAS,08102,081022,IGUALADA,29,3,32
2021/2022,08019459,ESCOLA GABRIEL CASTELLA I RAICH,08102,081022,IGUALADA,22,0,22
2021/2022,08019460,ESCOLA EMILI VALLÈS,08102,081022,IGUALADA,17,3,20
2021/2022,08019630,INSTITUT PERE VIVES I VICH,08102,081022,IGUALADA,48,28,76
2021/2022,08019642,ESCOLA PARE RAMON CASTELLTORT I MIRALDA,08102,081022,IGUALADA,31,1,32
2021/2022,08019654,INSTITUT MILÀ I FONTANALS,08102,081022,IGUALADA,70,65,135
2021/2022,08019678,ESCOLA GUERAU DE JORBA,08103,081038,JORBA,8,1,9
2021/2022,08019691,ESCOLA VILADEMÀGER - ZER SERRA D'ANCOSA,08104,081043,LA LLACUNA,6,0,6
2021/2022,08019711,ESCOLA SAGRADA FAMÍLIA,08105,081056,LA LLAGOSTA,18,4,22
2021/2022,08019745,ESCOLA JOAN MARAGALL,08105,081056,LA LLAGOSTA,26,3,29
2021/2022,08019782,ESCOLA SALVADOR SANROMÀ,08106,081069,LLINARS DEL VALLÈS,26,3,29
2021/2022,08019824,ESCOLA LES LLISSES,08108,081081,LLIÇÀ DE VALL,18,6,24
2021/2022,08019861,ESCOLA GAFARRÓ - ZER ALT LLUÇANÈS,08109,081094,LLUÇÀ,4,1,5
2021/2022,08019873,ESCOLA MARE DE DÉU DE MONTSERRAT,08110,081108,MALGRAT DE MAR,14,4,18
2021/2022,08019927,ESCOLA MARIÀ CUBÍ I SOLER,08110,081108,MALGRAT DE MAR,23,8,31
2021/2022,08019940,ESCOLA PUIG-AGUT,08112,081120,MANLLEU,34,3,37
2021/2022,08020012,ESCOLA MUNTANYA DEL DRAC,08113,081136,MANRESA,14,4,18
2021/2022,08020061,ESCOLA LA RENAIXENÇA,08113,081136,MANRESA,21,4,25
2021/2022,08020073,ESCOLA SANT IGNASI,08113,081136,MANRESA,29,6,35
2021/2022,08020097,ESCOLA PARE ALGUÉ,08113,081136,MANRESA,21,1,22
2021/2022,08020127,ESCOLA BAGES,08113,081136,MANRESA,32,6,38
2021/2022,08020462,INSTITUT LACETÀNIA,08113,081136,MANRESA,70,87,157
2021/2022,08020474,INSTITUT LLUÍS DE PEGUERA,08113,081136,MANRESA,62,31,93
2021/2022,08020498,ESCOLA ELS CONVENTS,08114,081141,MARTORELL,19,0,19
2021/2022,08020516,CEE EL PONTARRÓ,08114,081141,MARTORELL,30,2,32
2021/2022,08020607,ESCOLA JUAN RAMÓN JIMÉNEZ,08114,081141,MARTORELL,24,4,28
2021/2022,08020619,ESCOLA JOSÉ ECHEGARAY,08114,081141,MARTORELL,31,5,36
2021/2022,08020620,INSTITUT POMPEU FABRA,08114,081141,MARTORELL,50,31,81
2021/2022,08020656,ESCOLA SIMEÓ RABASA,08115,081154,MARTORELLES,14,1,15
2021/2022,08020701,ESCOLA COMTES DE LACAMBRA,08117,081173,LES MASIES DE VOLTREGÀ,11,2,13
2021/2022,08020723,ESCOLA OCATA,08118,081189,EL MASNOU,17,0,17
2021/2022,08020826,INSTITUT MAREMAR,08118,081189,EL MASNOU,43,20,63
2021/2022,08020838,INSTITUT MEDITERRÀNIA,08118,081189,EL MASNOU,21,20,41
2021/2022,08020841,ESCOLA EL TURÓ,08119,081192,MASQUEFA,25,6,31
2021/2022,08020863,ESCOLA GINESTA,08120,081206,MATADEPERA,29,2,31
2021/2022,08020905,ESCOLA ANGELETA FERRER,08121,081213,MATARÓ,24,6,30
2021/2022,08020917,ESCOLA JOSEP MANUEL PERAMÀS,08121,081213,MATARÓ,31,3,34
2021/2022,08020929,ESCOLA GERMANES BERTOMEU,08121,081213,MATARÓ,33,4,37
2021/2022,08021041,ESCOLA JOSEP MONTSERRAT,08121,081213,MATARÓ,16,4,20
2021/2022,08021260,INSTITUT ALEXANDRE SATORRAS,08121,081213,MATARÓ,66,35,101
2021/2022,08021302,INSTITUT DAMIÀ CAMPENY,08121,081213,MATARÓ,34,23,57
2021/2022,08021326,ESCOLA LA FASSINA,08122,081228,MEDIONA,6,3,9
2021/2022,08021351,ESCOLA EL PALAU,08123,081234,MOLINS DE REI,14,2,16
2021/2022,08021363,ESCOLA L'ALZINA,08123,081234,MOLINS DE REI,15,3,18
2021/2022,08021430,INSTITUT LLUÍS DE REQUESENS,08123,081234,MOLINS DE REI,44,29,73
2021/2022,08021442,ESCOLA CASTELL CIURÓ,08123,081234,MOLINS DE REI,19,6,25
2021/2022,08021466,ESCOLA COL·LEGIS NOUS,08124,081249,MOLLET DEL VALLÈS,19,5,24
2021/2022,08021570,ESCOLA DEL BOSC,08124,081249,MOLLET DEL VALLÈS,13,2,15
2021/2022,08021582,ESCOLA JOAN SALVAT PAPASSEIT,08124,081249,MOLLET DEL VALLÈS,14,4,18
2021/2022,08021594,INSTITUT DE MOLLET DEL VALLÈS,08124,081249,MOLLET DEL VALLÈS,41,74,115
2021/2022,08021600,INSTITUT VICENÇ PLANTADA,08124,081249,MOLLET DEL VALLÈS,41,29,70
2021/2022,08021685,ESCOLA FONT FREDA,08125,081252,MONTCADA I REIXAC,22,1,23
2021/2022,08021764,ESCOLA MITJA COSTA,08125,081252,MONTCADA I REIXAC,13,3,16
2021/2022,08021788,INSTITUT MONTSERRAT MIRÓ I VILA,08125,081252,MONTCADA I REIXAC,36,17,53
2021/2022,08021880,ESCOLA SALVADOR ESPRIU,08126,081265,MONTGAT,26,1,27
2021/2022,08021892,ESCOLA SANT PERE,08127,081271,MONISTROL DE MONTSERRAT,18,0,18
2021/2022,08021934,ESCOLA L'ESQUEIX - ZER EL MOIANÈS PONENT,08128,081287,MONISTROL DE CALDERS,5,1,6
2021/2022,08021961,ESCOLA EL ROCAL - ZER ELS CASTELLS,08131,081311,MONTESQUIU,10,1,11
2021/2022,08021983,ESCOLA GIRA-SOL - ZER BAIX BERGUEDÀ,08132,081326,MONTMAJOR,6,0,6
2021/2022,08022008,ESCOLA MONTMANY,08134,081347,FIGARÓ-MONTMANY,9,1,10
2021/2022,08022011,ESCOLA PAU CASALS,08135,081350,MONTMELÓ,20,2,22
2021/2022,08022045,ESCOLA SANT JORDI,08135,081350,MONTMELÓ,27,2,29
2021/2022,08022057,ESCOLA SANT SADURNÍ,08136,081363,MONTORNÈS DEL VALLÈS,13,3,16
2021/2022,08022070,ESCOLA MARINADA,08136,081363,MONTORNÈS DEL VALLÈS,28,5,33
2021/2022,08022082,ESCOLA PUIG DRAU - ZER BAIX MONTSENY,08137,081379,MONTSENY,4,0,4
2021/2022,08022094,ESCOLA JOSEP ORRIOLS I ROCA,08138,081385,MOIÀ,26,4,30
2021/2022,08022197,ESCOLA CATALUNYA,08140,081402,NAVARCLES,26,6,32
2021/2022,08022331,ESCOLA D'OLVAN - ZER BAIX BERGUEDÀ,08144,081445,OLVAN,7,0,7
2021/2022,08022343,ESCOLA CIRCELL,08145,081458,OLÈRDOLA,14,2,16
2021/2022,08022367,ESCOLA ROSSEND MONTANÉ,08145,081458,OLÈRDOLA,14,1,15
2021/2022,08022379,ESCOLA PONT DE L'ARCADA,08146,081461,OLESA DE BONESVALLS,10,2,12
2021/2022,08022380,ESCOLA MARE DE DÉU DE MONTSERRAT,08147,081477,OLESA DE MONTSERRAT,23,2,25
2021/2022,08022461,ESCOLA SANT BERNAT,08147,081477,OLESA DE MONTSERRAT,23,6,29
2021/2022,08022495,ESCOLA TERRA NOSTRA,08149,081496,OLOST,10,2,12
2021/2022,08022549,ESCOLA LLEVANT - ZER GAVARRESA,08151,081516,ORISTÀ,3,0,3
2021/2022,08022574,ESCOLA FRANCESC MACIÀ,08153,081537,ÒRRIUS,12,1,13
2021/2022,08022586,ESCOLA EL DRAC,08154,081542,PACS DEL PENEDÈS,10,2,12
2021/2022,08022598,ESCOLA LES FERRERIES DE PALAFOLLS,08155,081555,PALAFOLLS,28,3,31
2021/2022,08022616,ESCOLA JOSEP MARIA FOLCH I TORRES,08156,081568,PALAU-SOLITÀ I PLEGAMANS,17,2,19
2021/2022,08022665,ESCOLA ÀNGEL GUIMERÀ,08157,081574,PALLEJÀ,13,5,18
2021/2022,08022677,ESCOLA JACINT VERDAGUER,08157,081574,PALLEJÀ,16,1,17
2021/2022,08022689,ESCOLA PAU VILA,08158,081580,EL PAPIOL,27,2,29
2021/2022,08022690,ESCOLA LLUÍS PIQUER,08159,081593,PARETS DEL VALLÈS,30,2,32
2021/2022,08022707,ESCOLA POMPEU FABRA,08159,081593,PARETS DEL VALLÈS,15,1,16
2021/2022,08022768,ESCOLA HEROIS DEL BRUC,08161,081614,PIERA,31,3,34
2021/2022,08022801,ESCOLA ANTONI DOLTRA,08163,081635,PINEDA DE MAR,19,3,22
2021/2022,08022835,ESCOLA JAUME I,08163,081635,PINEDA DE MAR,27,2,29
2021/2022,08022847,ESCOLA SANTS ABDÓ I SENÉN,08164,081640,EL PLA DEL PENEDÈS,10,4,14
2021/2022,08022859,ESCOLA MARIA BORÉS,08165,081653,LA POBLA DE CLARAMUNT,12,4,16
2021/2022,08022860,ESCOLA LILLET A GÜELL,08166,081666,LA POBLA DE LILLET,8,1,9
2021/2022,08022872,ESCOLA PERE CALDERS,08167,081672,POLINYÀ,18,9,27
2021/2022,08022884,ESCOLA JOAN MARAGALL,08169,081691,EL PRAT DE LLOBREGAT,16,2,18
2021/2022,08022902,ESCOLA DEL PARC,08169,081691,EL PRAT DE LLOBREGAT,31,2,33
2021/2022,08022914,ESCOLA JAUME BALMES,08169,081691,EL PRAT DE LLOBREGAT,26,5,31
2021/2022,08022926,CEE CAN RIGOL,08169,081691,EL PRAT DE LLOBREGAT,26,6,32
2021/2022,08022938,ESCOLA JACINT VERDAGUER,08169,081691,EL PRAT DE LLOBREGAT,30,3,33
2021/2022,08023131,INSTITUT BALDIRI GUILERA,08169,081691,EL PRAT DE LLOBREGAT,46,14,60
2021/2022,08023141,ESCOLA MARE DE DÉU DEL PORTAL - ZER VENT D'AVALL,08170,081705,ELS PRATS DE REI,6,1,7
2021/2022,08023207,ESCOLA LLUÇANÈS,08171,081712,PRATS DE LLUÇANÈS,15,1,16
2021/2022,08023232,ESCOLA SANT CRISTÒFOL,08172,081727,PREMIÀ DE MAR,22,2,24
2021/2022,08023335,ESCOLA MONTSERRAT,08172,081727,PREMIÀ DE MAR,22,7,29
2021/2022,08023359,ESCOLA VIROLAI - ZER CEP DE SIS,08174,081748,PUIGDÀLBER,5,0,5
2021/2022,08023372,ESCOLA ALFRED MATA,08175,081751,PUIG-REIG,13,3,16
2021/2022,08023426,ESCOLA GASSÓ I VIDAL,08180,081803,RIPOLLET,16,2,18
2021/2022,08023542,ESCOLA TIANA DE LA RIBA,08180,081803,RIPOLLET,14,4,18
2021/2022,08023554,ESCOLA JOSEP MARIA GINESTA,08180,081803,RIPOLLET,30,2,32
2021/2022,08023566,ESCOLA ANSELM CLAVÉ,08180,081803,RIPOLLET,28,3,31
2021/2022,08023591,ESCOLA PILAR MESTRES-JAUME TORRENS,08181,081810,LA ROCA DEL VALLÈS,14,2,16
2021/2022,08023669,ESCOLA MARE DE DÉU DEL SÒL DEL PONT,08183,081831,RODA DE TER,29,2,31
2021/2022,08023852,ESCOLA JOAN MARAGALL,08184,081846,RUBÍ,22,1,23
2021/2022,08023918,ESCOLA CONCÒRDIA,08187,081878,SABADELL,29,4,33
2021/2022,08023921,ESCOLA ESPRONCEDA,08187,081878,SABADELL,28,5,33
2021/2022,08023931,ESCOLA ENRIC CASASSAS,08187,081878,SABADELL,15,3,18
2021/2022,08023943,ESCOLA GAUDÍ,08187,081878,SABADELL,20,0,20
2021/2022,08023955,ESCOLA CIFUENTES,08187,081878,SABADELL,29,5,34
2021/2022,08023979,ESCOLA JOAN MONTLLOR,08187,081878,SABADELL,14,3,17
2021/2022,08023980,ESCOLA JUAN RAMÓN JIMÉNEZ,08187,081878,SABADELL,14,2,16
2021/2022,08024005,ESCOLA JOAN MARAGALL,08187,081878,SABADELL,20,1,21
2021/2022,08024017,ESCOLA MIQUEL CARRERAS,08187,081878,SABADELL,14,5,19
2021/2022,08024030,ESCOLA SAMUNTADA,08187,081878,SABADELL,19,2,21
2021/2022,08024042,ESCOLA LA ROMÀNICA,08187,081878,SABADELL,30,6,36
2021/2022,08024066,ESCOLA TARLATANA,08187,081878,SABADELL,13,3,16
2021/2022,08024741,INSTITUT ESCOLA INDUSTRIAL,08187,081878,SABADELL,57,61,118
2021/2022,08024765,INSTITUT ARRAONA,08187,081878,SABADELL,36,26,62
2021/2022,08024777,INSTITUT EGARA,08279,082798,TERRASSA,33,20,53
2021/2022,08024789,CEE FRANCESC BELLAPART,08187,081878,SABADELL,37,3,40
2021/2022,08024790,ESCOLA ROUREDA,08187,081878,SABADELL,29,4,33
2021/2022,08024807,ESCOLA AGNÈS ARMENGOL,08187,081878,SABADELL,15,3,18
2021/2022,08024819,ESCOLA CALVET D'ESTRELLA,08187,081878,SABADELL,17,2,19
2021/2022,08024820,ESCOLA PAU CASALS,08187,081878,SABADELL,27,6,33
2021/2022,08024832,ESCOLA FLORESTA,08187,081878,SABADELL,13,4,17
2021/2022,08024844,ESCOLA TORREGUITART,08187,081878,SABADELL,13,6,19
2021/2022,08024856,ESCOLA FONT ROSELLA,08187,081878,SABADELL,28,3,31
2021/2022,08024871,INSTITUT PAU VILA,08187,081878,SABADELL,48,29,77
2021/2022,08024881,INSTITUT FERRAN CASABLANCAS,08187,081878,SABADELL,47,46,93
2021/2022,08024893,INSTITUT CASTELLARNAU,08187,081878,SABADELL,56,49,105
2021/2022,08024972,ESCOLA TORRES AMAT,08191,081918,SALLENT,25,3,28
2021/2022,08025058,ESCOLA RIU D'OR,08192,081923,SANTPEDOR,25,4,29
2021/2022,08025071,ESCOLA DONES D'AIGUA,08193,081939,SANT ISCLE DE VALLALTA,12,2,14
2021/2022,08025083,ESCOLA POMPEU FABRA,08194,081944,SANT ADRIÀ DE BESÒS,27,8,35
2021/2022,08025241,ESCOLA JOAN MARAGALL,08196,081960,SANT ANDREU DE LA BARCA,14,3,17
2021/2022,08025265,ESCOLA ÀNGEL GUIMERÀ,08196,081960,SANT ANDREU DE LA BARCA,26,4,30
2021/2022,08025319,ESCOLA JOAN CASAS,08198,081982,SANT ANTONI DE VILAMAJOR,22,5,27
2021/2022,08025320,ESCOLA LA MONJOIA,08199,081995,SANT BARTOMEU DEL GRAU,12,1,13
2021/2022,08025344,ESCOLA AMAT VERDÚ,08200,082009,SANT BOI DE LLOBREGAT,18,3,21
2021/2022,08025526,ESCOLA CIUTAT COOPERATIVA,08200,082009,SANT BOI DE LLOBREGAT,17,2,19
2021/2022,08025587,ESCOLA CASABLANCA,08200,082009,SANT BOI DE LLOBREGAT,30,4,34
2021/2022,08025599,ESCOLA MARIANAO,08200,082009,SANT BOI DE LLOBREGAT,17,2,19
2021/2022,08025605,INSTITUT CAMPS BLANCS,08200,082009,SANT BOI DE LLOBREGAT,81,53,134
2021/2022,08025642,ESCOLA JOSEP MARIA CIURANA,08200,082009,SANT BOI DE LLOBREGAT,27,1,28
2021/2022,08025654,INSTITUT JOAQUIM RUBIÓ I ORS,08200,082009,SANT BOI DE LLOBREGAT,39,30,69
2021/2022,08025666,ESCOLA AURORA - ZER ALT LLUÇANÈS,08201,082016,SANT BOI DE LLUÇANÈS,2,2,4
2021/2022,08025812,ESCOLA SANT CLIMENT,08204,082042,SANT CLIMENT DE LLOBREGAT,26,5,31
2021/2022,08025824,ESCOLA LA FLORESTA,08205,082055,SANT CUGAT DEL VALLÈS,16,1,17
2021/2022,08025927,ESCOLA PI D'EN XANDRI,08205,082055,SANT CUGAT DEL VALLÈS,29,5,34
2021/2022,08026026,ESCOLA PINS DEL VALLÈS,08205,082055,SANT CUGAT DEL VALLÈS,29,6,35
2021/2022,08026087,ESCOLA JAUME FERRAN I CLUA,08205,082055,SANT CUGAT DEL VALLÈS,30,2,32
2021/2022,08026099,ESCOLA LES VINYES,08206,082068,SANT CUGAT SESGARRIGUES,13,0,13
2021/2022,08026117,ESCOLA VALLMANYA,08207,082074,SANT ESTEVE DE PALAUTORDERA,25,1,26
2021/2022,08026130,ESCOLA LA ROUREDA,08208,082080,SANT ESTEVE SESROVIRES,23,3,26
2021/2022,08026154,ESCOLA JOAQUIM ABRIL,08209,082093,SANT FOST DE CAMPSENTELLES,22,2,24
2021/2022,08026208,ESCOLA JAUME BALMES,08210,082107,SANT FELIU DE CODINES,19,7,26
2021/2022,08026211,ESCOLA NADAL,08211,082114,SANT FELIU DE LLOBREGAT,26,3,29
2021/2022,08026221,ESCOLA FALGUERA,08211,082114,SANT FELIU DE LLOBREGAT,13,5,18
2021/2022,08026373,ESCOLA JOSEP MONMANY AMAT,08211,082114,SANT FELIU DE LLOBREGAT,19,3,22
2021/2022,08026385,ESCOLA ARQUITECTE GAUDÍ,08211,082114,SANT FELIU DE LLOBREGAT,19,2,21
2021/2022,08026397,INSTITUT OLORDA,08211,082114,SANT FELIU DE LLOBREGAT,50,15,65
2021/2022,08026415,ESCOLA ELS ROURES - ZER GAVARRESA,08212,082129,SANT FELIU SASSERRA,7,0,7
2021/2022,08026464,ESCOLA MONSENYOR GIBERT,08213,082135,SANT FRUITÓS DE BAGES,24,5,29
2021/2022,08026476,ESCOLA FRANCESC MACIÀ,08214,082140,VILASSAR DE DALT,24,6,30
2021/2022,08026567,ESCOLA SANT FRANCESC D'ASSÍS,08217,082172,SANT JOAN DESPÍ,27,4,31
2021/2022,08026661,ESCOLA PAU CASALS,08217,082172,SANT JOAN DESPÍ,29,2,31
2021/2022,08026671,ESCOLA JOAN PERICH I VALLS,08217,082172,SANT JOAN DESPÍ,16,1,17
2021/2022,08026683,INSTITUT FRANCESC FERRER I GUÀRDIA,08217,082172,SANT JOAN DESPÍ,65,28,93
2021/2022,08026725,ESCOLA JONCADELLA,08218,082188,SANT JOAN DE VILATORRADA,26,2,28
2021/2022,08026749,ESCOLA PÉREZ SALA,08219,082191,VILASSAR DE MAR,20,6,26
2021/2022,08026786,ESCOLA BELLPUIG,08220,082205,SANT JULIÀ DE VILATORTA,16,1,17
2021/2022,08026816,ESCOLA MONTSERRAT,08221,082212,SANT JUST DESVERN,24,7,31
2021/2022,08026889,ESCOLA VINYES VERDES,08119,081192,MASQUEFA,13,2,15
2021/2022,08026907,ESCOLA PAU CASALS,08222,082227,SANT LLORENÇ D'HORTONS,12,3,15
2021/2022,08026919,ESCOLA JOSEP GRAS,08223,082233,SANT LLORENÇ SAVALL,13,2,15
2021/2022,08026956,ESCOLA CÉRVOLA BLANCA,08226,082264,SANT MARTÍ DE TOUS,14,2,16
2021/2022,08027018,ESCOLA JAUME BALMES,08227,082270,SANT MARTÍ SARROCA,18,4,22
2021/2022,08027021,ESCOLA FONT DE L'ANOIA - ZER VENT D'AVALL,08228,082286,SANT MARTÍ SESGUEIOLES,2,1,3
2021/2022,08027110,ESCOLA EL PI,08231,082310,SANT PERE DE RIBES,13,2,15
2021/2022,08027134,ESCOLA LES ROQUETES,08231,082310,SANT PERE DE RIBES,21,5,26
2021/2022,08027146,ESCOLA SANT JERONI,08232,082325,SANT PERE DE RIUDEBITLLES,14,3,17
2021/2022,08027183,ESCOLA TORRE ROJA,08234,082346,SANT PERE DE VILAMAJOR,27,4,31
2021/2022,08027225,ESCOLA SANT PAU,08235,082359,SANT POL DE MAR,29,4,33
2021/2022,08027249,ESCOLA SEGIMON COMAS,08237,082378,SANT QUIRZE DE BESORA,16,1,17
2021/2022,08027432,ESCOLA WAGNER,08245,082457,SANTA COLOMA DE GRAMENET,20,2,22
2021/2022,08027456,ESCOLA FERRAN DE SAGARRA,08245,082457,SANTA COLOMA DE GRAMENET,35,5,40
2021/2022,08027471,ESCOLA SANT JUST,08245,082457,SANTA COLOMA DE GRAMENET,28,4,32
2021/2022,08027511,ESCOLA TORRE BALLDOVINA,08245,082457,SANTA COLOMA DE GRAMENET,27,7,34
2021/2022,08027870,ESCOLA LES PALMERES,08245,082457,SANTA COLOMA DE GRAMENET,28,5,33
2021/2022,08027973,ESCOLA BEETHOVEN,08245,082457,SANTA COLOMA DE GRAMENET,19,3,22
2021/2022,08027985,ESCOLA JAUME SALVATELLA,08245,082457,SANTA COLOMA DE GRAMENET,27,5,32
2021/2022,08028035,ESCOLA AUSIÀS MARCH,08245,082457,SANTA COLOMA DE GRAMENET,15,5,20
2021/2022,08028047,INSTITUT PUIG CASTELLAR,08245,082457,SANTA COLOMA DE GRAMENET,53,37,90
2021/2022,08028059,ESCOLA JACINT VERDAGUER,08246,082460,SANTA EUGÈNIA DE BERGA,14,3,17
2021/2022,08028072,ESCOLA EL ROURE GROS,08247,082476,SANTA EULÀLIA DE RIUPRIMER,13,1,14
2021/2022,08028102,ESCOLA RONÇANA,08248,082482,SANTA EULÀLIA DE RONÇANA,19,1,20
2021/2022,08028151,ESCOLA LES MORERES - ZER CEP DE SIS,08249,082495,SANTA FE DEL PENEDÈS,5,0,5
2021/2022,08028163,ESCOLA MONTBOU,08250,082508,SANTA MARGARIDA DE MONTBUI,12,3,15
2021/2022,08028217,ESCOLA DOCTOR SAMARANCH I FINA,08251,082515,SANTA MARGARIDA I ELS MONJOS,27,4,31
2021/2022,08028229,ESCOLA ELISA BADIA,08252,082520,BARBERÀ DEL VALLÈS,28,3,31
2021/2022,08028333,ESCOLA EL CABRERÈS,08254,082541,L'ESQUIROL,13,3,16
2021/2022,08028345,ESCOLA LES MIMOSES,08256,082567,SANTA MARIA DE MARTORELLES,10,3,13
2021/2022,08028382,ESCOLA SESMON D'OLÓ,08258,082589,SANTA MARIA D'OLÓ,11,0,11
2021/2022,08028424,ESCOLA FONTMARTINA,08259,082592,SANTA MARIA DE PALAUTORDERA,20,4,24
2021/2022,08028436,ESCOLA LA FLORIDA,08260,082606,SANTA PERPÈTUA DE MOGODA,27,3,30
2021/2022,08028497,ESCOLA SANTA PERPÈTUA,08260,082606,SANTA PERPÈTUA DE MOGODA,22,5,27
2021/2022,08028515,ESCOLA SANTA SUSANNA,08261,082613,SANTA SUSANNA,13,5,18
2021/2022,08028576,ESCOLA SANT VICENÇ,08262,082628,SANT VICENÇ DE CASTELLET,33,4,37
2021/2022,08028588,ESCOLA SANT JORDI,08263,082634,SANT VICENÇ DELS HORTS,16,1,17
2021/2022,08028591,ESCOLA LA VINYALA,08263,082634,SANT VICENÇ DELS HORTS,21,2,23
2021/2022,08028667,ESCOLA JOAN JUNCADELLA,08263,082634,SANT VICENÇ DELS HORTS,28,0,28
2021/2022,08028709,ESCOLA LLORIANA,08265,082652,SANT VICENÇ DE TORELLÓ,12,2,14
2021/2022,08028746,ESCOLA SANT MARTÍ,08266,082665,CERDANYOLA DEL VALLÈS,16,4,20
2021/2022,08028758,ESCOLA LES FONTETES,08266,082665,CERDANYOLA DEL VALLÈS,12,4,16
2021/2022,08028783,ESCOLA SERRAPARERA,08266,082665,CERDANYOLA DEL VALLÈS,25,5,30
2021/2022,08028904,ESCOLA CARLES BUÏGAS,08266,082665,CERDANYOLA DEL VALLÈS,19,1,20
2021/2022,08028916,ESCOLA LAS SEGUIDILLAS,08904,089045,BADIA DEL VALLÈS,28,2,30
2021/2022,08028928,ESCOLA LA JOTA,08904,089045,BADIA DEL VALLÈS,25,6,31
2021/2022,08028941,ESCOLA LA SARDANA,08904,089045,BADIA DEL VALLÈS,20,3,23
2021/2022,08028990,ESCOLA CAN SORTS,08267,082671,SENTMENAT,37,7,44
2021/2022,08029015,ESCOLA SANT SALVADOR,08268,082687,CERCS,8,2,10
2021/2022,08029027,ESCOLA FARIGOLA,08269,082690,SEVA,14,1,15
2021/2022,08029088,ESCOLA MIQUEL UTRILLO,08270,082704,SITGES,25,8,33
2021/2022,08029143,ESCOLA SUBIRATS - ZER SUBIRATS,08273,082732,SUBIRATS,6,2,8
2021/2022,08029155,ESCOLA EL MONTCAU - ZER SUBIRATS,08273,082732,SUBIRATS,7,2,9
2021/2022,08029192,ESCOLA SANT JORDI,08273,082732,SUBIRATS,12,2,14
2021/2022,08029209,ESCOLA SALIPOTA,08274,082747,SÚRIA,12,3,15
2021/2022,08029222,ESCOLA FRANCESC MACIÀ,08274,082747,SÚRIA,14,1,15
2021/2022,08029283,ESCOLA EL GURRI - ZER GUILLERIES,08278,082785,TARADELL,4,0,4
2021/2022,08029301,ESCOLA LES PINEDIQUES,08278,082785,TARADELL,27,4,31
2021/2022,08029350,ESCOLA FRANÇA,08279,082798,TERRASSA,29,5,34
2021/2022,08029374,ESCOLA BISBAT D'EGARA,08279,082798,TERRASSA,43,5,48
2021/2022,08029386,ESCOLA RAMÓN Y CAJAL,08279,082798,TERRASSA,30,6,36
2021/2022,08029507,ESCOLA ISAAC PERAL,08279,082798,TERRASSA,17,2,19
2021/2022,08030200,ESCOLA MARIÀ GALÍ GUIX,08279,082798,TERRASSA,21,2,23
2021/2022,08030212,ESCOLA JOSEP VENTALLÓ I VINTRÓ,08279,082798,TERRASSA,20,3,23
2021/2022,08030248,ESCOLA PAU VILA I DINARÈS,08279,082798,TERRASSA,32,3,35
2021/2022,08030285,ESCOLA AURÓ,08279,082798,TERRASSA,17,5,22
2021/2022,08030297,ESCOLA SALVADOR VINYALS I GALÍ,08279,082798,TERRASSA,20,3,23
2021/2022,08030315,ESCOLA JOAN XXIII,08279,082798,TERRASSA,30,5,35
2021/2022,08030339,INSTITUT DE TERRASSA,08279,082798,TERRASSA,93,60,153
2021/2022,08030340,INSTITUT INVESTIGADOR BLANXART,08279,082798,TERRASSA,57,29,86
2021/2022,08030364,ESCOLA EL CIM,08281,082819,TEIÀ,26,4,30
2021/2022,08030388,ESCOLA LOLA ANGLADA,08282,082824,TIANA,25,5,30
2021/2022,08030421,ESCOLA L'ERA DE DALT,08283,082830,TONA,25,5,30
2021/2022,08030467,ESCOLA IGNASI IGLESIAS,08284,082845,TORDERA,31,5,36
2021/2022,08030510,ESCOLA DOCTOR FORTIÀ I SOLÀ,08285,082858,TORELLÓ,29,1,30
2021/2022,08030522,ESCOLA VALL DEL GES,08285,082858,TORELLÓ,16,0,16
2021/2022,08030583,ESCOLA LA TORRE,08286,082861,LA TORRE DE CLARAMUNT,13,1,14
2021/2022,08030595,ESCOLA TORRESCASANA,08286,082861,LA TORRE DE CLARAMUNT,11,3,14
2021/2022,08030613,ESCOLA J.J. RÀFOLS,08287,082877,TORRELAVIT,10,4,14
2021/2022,08030637,ESCOLA GUERAU DE PEGUERA,08288,082883,TORRELLES DE FOIX,15,3,18
2021/2022,08030649,ESCOLA SANT MARTÍ,08289,082896,TORRELLES DE LLOBREGAT,21,3,24
2021/2022,08030662,ESCOLA SERRALAVELLA,08290,082900,ULLASTRELL,18,4,22
2021/2022,08030686,ESCOLA PAU CASALS,08291,082917,VACARISSES,23,4,27
2021/2022,08030698,ESCOLA JOSEP MASCLANS,08292,082922,VALLBONA D'ANOIA,10,3,13
2021/2022,08030728,ESCOLA SERRAT VOLTOR - ZER ALT BERGUEDÀ,08293,082938,VALLCEBRE,3,0,3
2021/2022,08030789,ESCOLA POMPEU FABRA,08295,082956,VALLIRANA,17,2,19
2021/2022,08030819,ESCOLA SENTFORES,08298,082981,VIC,18,2,20
2021/2022,08031009,ESCOLA DOCTOR JOAQUIM SALARICH,08298,082981,VIC,37,5,42
2021/2022,08031022,INSTITUT DE VIC,08298,082981,VIC,96,68,164
2021/2022,08031034,INSTITUT JAUME CALLÍS,08298,082981,VIC,39,27,66
2021/2022,08031046,ESCOLA SERRA DE PICAMILL - ZER BERGUEDÀ CENTRE,08299,082994,VILADA,4,0,4
2021/2022,08031061,ESCOLA ROSELLA,08300,083008,VILADECAVALLS,29,3,32
2021/2022,08031083,ESCOLA ÀNGELA ROCA,08301,083015,VILADECANS,22,1,23
2021/2022,08031101,ESCOLA MONTSERRATINA,08301,083015,VILADECANS,29,3,32
2021/2022,08031204,ESCOLA EL GARROFER,08301,083015,VILADECANS,28,5,33
2021/2022,08031228,INSTITUT TORRE ROJA,08301,083015,VILADECANS,59,48,107
2021/2022,08031277,ESCOLA JOAN MARAGALL,08302,083020,VILANOVA DEL CAMÍ,31,4,35
2021/2022,08031290,ESCOLA LES ROQUES,08303,083036,VILANOVA DE SAU,3,1,4
2021/2022,08031319,ESCOLA LLEBEIG,08304,083041,VILOBÍ DEL PENEDÈS,14,0,14
2021/2022,08031320,ESCOLA ESTALELLA I GRAELLS,08305,083054,VILAFRANCA DEL PENEDÈS,30,4,34
2021/2022,08031332,ESCOLA JOSEP BALTÀ I ELIAS,08305,083054,VILAFRANCA DEL PENEDÈS,27,8,35
2021/2022,08031459,INSTITUT EUGENI D'ORS,08305,083054,VILAFRANCA DEL PENEDÈS,57,46,103
2021/2022,08031460,ESCOLA TRENTAPASSES,08306,083067,VILALBA SASSERRA,15,1,16
2021/2022,08031472,ESCOLA POMPEU FABRA,08307,083073,VILANOVA I LA GELTRÚ,27,4,31
2021/2022,08031484,ESCOLA GINESTA,08307,083073,VILANOVA I LA GELTRÚ,26,6,32
2021/2022,08031666,ESCOLA CANIGÓ,08307,083073,VILANOVA I LA GELTRÚ,26,5,31
2021/2022,08031681,INSTITUT FRANCESC XAVIER LLUCH I RAFECAS,08307,083073,VILANOVA I LA GELTRÚ,56,42,98
2021/2022,08031711,INSTITUT MANUEL DE CABANYES,08307,083073,VILANOVA I LA GELTRÚ,50,29,79
2021/2022,08031757,INSTITUT FORAT DEL VENT,08266,082665,CERDANYOLA DEL VALLÈS,36,28,64
2021/2022,08031770,INSTITUT CAN JOFRESA,08279,082798,TERRASSA,45,24,69
2021/2022,08031794,ESCOLA PALMA DE MALLORCA,08019,080193,BARCELONA,21,1,22
2021/2022,08031800,ESCOLA PAU CASALS,08019,080193,BARCELONA,15,4,19
2021/2022,08031812,INSTITUT VALLDEMOSSA,08019,080193,BARCELONA,29,20,49
2021/2022,08031836,INSTITUT ILLA DELS BANYOLS,08169,081691,EL PRAT DE LLOBREGAT,13,49,62
2021/2022,08031861,INSTITUT LEONARDO DA VINCI,08205,082055,SANT CUGAT DEL VALLÈS,50,21,71
2021/2022,08031873,INSTITUT ARNAU CADELL,08205,082055,SANT CUGAT DEL VALLÈS,40,23,63
2021/2022,08032300,ESCOLA FRAY LUIS DE LEÓN,08245,082457,SANTA COLOMA DE GRAMENET,32,4,36
2021/2022,08032312,ESCOLA MIGUEL DE UNAMUNO,08245,082457,SANTA COLOMA DE GRAMENET,32,5,37
2021/2022,08032348,ESCOLA 25 DE SETEMBRE,08184,081846,RUBÍ,39,8,47
2021/2022,08032351,ESCOLA PAU CASALS,08184,081846,RUBÍ,30,6,36
2021/2022,08032476,ESCOLA PRAT DE LA RIBA,08077,080771,ESPLUGUES DE LLOBREGAT,17,1,18
2021/2022,08032491,ESCOLA SANT VICENÇ,08124,081249,MOLLET DEL VALLÈS,27,2,29
2021/2022,08032521,ESCOLA VALL DE PALAU,08196,081960,SANT ANDREU DE LA BARCA,28,1,29
2021/2022,08032580,ESCOLA CANIGÓ,08221,082212,SANT JUST DESVERN,27,5,32
2021/2022,08032592,ESCOLA SANT JORDI,08264,082649,SANT VICENÇ DE MONTALT,16,1,17
2021/2022,08032634,ESCOLA FERRER I GUÀRDIA,08019,080193,BARCELONA,31,7,38
2021/2022,08032658,ESCOLA L'ERAMPRUNYÀ,08089,080898,GAVÀ,28,3,31
2021/2022,08032713,ESCOLA SANT JORDI,08124,081249,MOLLET DEL VALLÈS,20,7,27
2021/2022,08032725,ESCOLA HONORABLE JOSEP TARRADELLAS,08169,081691,EL PRAT DE LLOBREGAT,28,4,32
2021/2022,08032737,ESCOLA CAN RULL,08187,081878,SABADELL,28,5,33
2021/2022,08032750,ESCOLA PAU CASALS,08301,083015,VILADECANS,30,2,32
2021/2022,08032762,ESCOLA DOCTOR TRUETA,08301,083015,VILADECANS,28,4,32
2021/2022,08033341,ESCOLA BANÚS,08245,082457,SANTA COLOMA DE GRAMENET,15,4,19
2021/2022,08033407,ESCOLA PURIFICACIÓ SALAS I XANDRI,08238,082384,SANT QUIRZE DEL VALLÈS,15,2,17
2021/2022,08033468,ESCOLA LA SALUT,08069,080692,COLLBATÓ,16,4,20
2021/2022,08033501,ESCOLA ANTONI BRUSI,08019,080193,BARCELONA,24,8,32
2021/2022,08033523,ESCOLA LA MUNTANYETA,08019,080193,BARCELONA,13,4,17
2021/2022,08033535,ESCOLA JOAN MARAGALL,08077,080771,ESPLUGUES DE LLOBREGAT,32,1,33
2021/2022,08033560,ESCOLA MÀRIUS TORRES,08101,081017,L'HOSPITALET DE LLOBREGAT,32,11,43
2021/2022,08033602,ESCOLA CAN SERRA,08252,082520,BARBERÀ DEL VALLÈS,27,3,30
2021/2022,08033869,INSTITUT PAU CASALS,08015,080155,BADALONA,34,27,61
2021/2022,08033882,INSTITUT JOAN COROMINES,08019,080193,BARCELONA,10,10,20
2021/2022,08033894,INSTITUT TERESA PÀMIES,08019,080193,BARCELONA,26,21,47
2021/2022,08033900,INSTITUT JOAN MIRÓ,08073,080734,CORNELLÀ DE LLOBREGAT,38,19,57
2021/2022,08033912,INSTITUT MERCÈ RODOREDA,08101,081017,L'HOSPITALET DE LLOBREGAT,43,30,73
2021/2022,08033924,INSTITUT PIUS FONT I QUER,08113,081136,MANRESA,37,26,63
2021/2022,08033948,ESCOLA ENRIC TATCHÉ I POL,08180,081803,RIPOLLET,27,5,32
2021/2022,08033961,INSTITUT RAFAEL CASANOVA,08200,082009,SANT BOI DE LLOBREGAT,45,25,70
2021/2022,08033973,INSTITUT JAUME SALVADOR I PEDROL,08217,082172,SANT JOAN DESPÍ,41,26,67
2021/2022,08033985,INSTITUT DE SANT JUST DESVERN,08221,082212,SANT JUST DESVERN,36,21,57
2021/2022,08033997,ESCOLA PRIMAVERA,08245,082457,SANTA COLOMA DE GRAMENET,17,1,18
2021/2022,08034001,INSTITUT TERRA ROJA,08245,082457,SANTA COLOMA DE GRAMENET,46,13,59
2021/2022,08034011,INSTITUT FREDERIC MOMPOU,08263,082634,SANT VICENÇ DELS HORTS,42,19,61
2021/2022,08034035,INSTITUT FEDERICA MONTSENY,08904,089045,BADIA DEL VALLÈS,31,19,50
2021/2022,08034059,INSTITUT NICOLAU COPÈRNIC,08279,082798,TERRASSA,34,45,79
2021/2022,08034060,ESCOLA MOSSÈN CINTO VERDAGUER,08184,081846,RUBÍ,30,7,37
2021/2022,08034084,ESCOLA CAN ROCA,08056,080569,CASTELLDEFELS,27,4,31
2021/2022,08034096,ESCOLA ANTONI GAUDÍ,08056,080569,CASTELLDEFELS,24,8,32
2021/2022,08034102,ESCOLA JOSEP MARIA MADORELL,08123,081234,MOLINS DE REI,18,2,20
2021/2022,08034126,ESCOLA PAU BOADA,08305,083054,VILAFRANCA DEL PENEDÈS,20,7,27
2021/2022,08034138,INSTITUT POBLENOU,08019,080193,BARCELONA,41,35,76
2021/2022,08034187,INSTITUT DOMÈNEC PERRAMON,08007,080076,ARENYS DE MUNT,35,12,47
2021/2022,08034205,INSTITUT LA GUINEUETA,08019,080193,BARCELONA,67,65,132
2021/2022,08034217,INSTITUT BERNAT EL FERRER,08123,081234,MOLINS DE REI,62,49,111
2021/2022,08034229,ESCOLA BONAVISTA,08051,080517,CASTELLAR DEL VALLÈS,14,2,16
2021/2022,08034242,ESCOLA PABLO NERUDA,08101,081017,L'HOSPITALET DE LLOBREGAT,17,2,19
2021/2022,08034266,ESCOLA JOAN MARAGALL,08101,081017,L'HOSPITALET DE LLOBREGAT,17,1,18
2021/2022,08034278,ESCOLA VICENTE ALEIXANDRE,08114,081141,MARTORELL,24,4,28
2021/2022,08034321,ESCOLA TORRE LLAUDER,08121,081213,MATARÓ,20,3,23
2021/2022,08034333,ESCOLA LA LLÀNTIA,08121,081213,MATARÓ,28,5,33
2021/2022,08034357,ESCOLA VISTA ALEGRE,08121,081213,MATARÓ,15,3,18
2021/2022,08034382,ESCOLA RAMON LLULL,08184,081846,RUBÍ,28,5,33
2021/2022,08034400,ESCOLA ANTONI GAUDÍ,08200,082009,SANT BOI DE LLOBREGAT,17,1,18
2021/2022,08034412,ESCOLA CAN MASSALLERA,08200,082009,SANT BOI DE LLOBREGAT,15,3,18
2021/2022,08034448,ESCOLA SANTA EULÀLIA,08231,082310,SANT PERE DE RIBES,22,7,29
2021/2022,08034461,ESCOLA BERNAT DE MOGODA,08260,082606,SANTA PERPÈTUA DE MOGODA,23,4,27
2021/2022,08034485,ESCOLA JOAN MARQUÈS I CASALS,08279,082798,TERRASSA,27,7,34
2021/2022,08034497,ESCOLA L'ARAGAI,08307,083073,VILANOVA I LA GELTRÚ,18,1,19
2021/2022,08034527,ESCOLA RAMON MUNTANER,08101,081017,L'HOSPITALET DE LLOBREGAT,17,0,17
2021/2022,08034564,INSTITUT LES CORTS,08019,080193,BARCELONA,41,19,60
2021/2022,08034576,INSTITUT JOAN SALVAT I PAPASSEIT,08019,080193,BARCELONA,21,18,39
2021/2022,08034591,INSTITUT JOAN OLIVER,08187,081878,SABADELL,36,14,50
2021/2022,08034606,INSTITUT BAIX MONTSENY,08202,082021,SANT CELONI,52,26,78
2021/2022,08034621,INSTITUT DE SALES,08301,083015,VILADECANS,60,26,86
2021/2022,08034643,INSTITUT LES VINYES,08245,082457,SANTA COLOMA DE GRAMENET,54,41,95
2021/2022,08034667,ESCOLA ESTEVE BARRACHINA,08270,082704,SITGES,30,4,34
2021/2022,08034734,ESCOLA CAMÍ DEL MIG,08121,081213,MATARÓ,33,4,37
2021/2022,08034746,ESCOLA ROCAFONDA,08121,081213,MATARÓ,32,5,37
2021/2022,08034783,ESCOLA ELVIRA CUYÀS,08125,081252,MONTCADA I REIXAC,26,5,31
2021/2022,08034795,ESCOLA HEUROM - ZER ALT LLUÇANÈS,08160,081607,PERAFITA,4,1,5
2021/2022,08034837,ESCOLA BERNAT DESCLOT,08101,081017,L'HOSPITALET DE LLOBREGAT,19,1,20
2021/2022,08034850,ESCOLA PAU CASALS,08101,081017,L'HOSPITALET DE LLOBREGAT,35,8,43
2021/2022,08034862,ESCOLA AUSIÀS MARCH,08101,081017,L'HOSPITALET DE LLOBREGAT,18,2,20
2021/2022,08034904,ESCOLA EMILI CARLES I TOLRÀ,08051,080517,CASTELLAR DEL VALLÈS,14,3,17
2021/2022,08034965,ESCOLA MARGARIDA XIRGU,08015,080155,BADALONA,37,1,38
2021/2022,08034989,ESCOLA CATALUNYA,08194,081944,SANT ADRIÀ DE BESÒS,31,3,34
2021/2022,08034990,ESCOLA PARELLADA,08200,082009,SANT BOI DE LLOBREGAT,23,6,29
2021/2022,08035003,EA DE VIC,08298,082981,VIC,23,21,44
2021/2022,08035143,INSTITUT MIQUEL MARTÍ I POL,08073,080734,CORNELLÀ DE LLOBREGAT,63,44,107
2021/2022,08035155,INSTITUT ELS TRES TURONS,08006,080060,ARENYS DE MAR,40,24,64
2021/2022,08035167,INSTITUT BARCELONA-CONGRÉS,08019,080193,BARCELONA,31,17,48
2021/2022,08035209,INSTITUT PABLO R. PICASSO,08019,080193,BARCELONA,28,23,51
2021/2022,08035222,INSTITUT MANUEL BLANCAFORT,08088,080885,LA GARRIGA,37,15,52
2021/2022,08035234,INSTITUT VIL·LA ROMANA,08088,080885,LA GARRIGA,37,19,56
2021/2022,08035246,INSTITUT GELIDA,08091,080919,GELIDA,19,24,43
2021/2022,08035258,INSTITUT APEL·LES MESTRES,08101,081017,L'HOSPITALET DE LLOBREGAT,34,25,59
2021/2022,08035283,ESCOLA REIXAC,08125,081252,MONTCADA I REIXAC,32,3,35
2021/2022,08035295,INSTITUT PALAU AUSIT,08180,081803,RIPOLLET,40,55,95
2021/2022,08035301,INSTITUT DUC DE MONTBLANC,08184,081846,RUBÍ,48,30,78
2021/2022,08035313,INSTITUT QUERCUS,08218,082188,SANT JOAN DE VILATORRADA,45,23,68
2021/2022,08035325,INSTITUT TORRENT DE LES BRUIXES,08245,082457,SANTA COLOMA DE GRAMENET,36,21,57
2021/2022,08035349,INSTITUT LA ROMÀNICA,08252,082520,BARBERÀ DEL VALLÈS,62,36,98
2021/2022,08035350,ESCOLA SANT JOSEP,08263,082634,SANT VICENÇ DELS HORTS,25,3,28
2021/2022,08035362,INSTITUT ALT PENEDÈS,08305,083054,VILAFRANCA DEL PENEDÈS,46,42,88
2021/2022,08035398,ESCOLA MIGUEL HERNÁNDEZ,08015,080155,BADALONA,16,4,20
2021/2022,08035404,ESCOLA JOAN MIRÓ,08015,080155,BADALONA,14,4,18
2021/2022,08035416,ESCOLA JOSEP BOADA,08015,080155,BADALONA,30,4,34
2021/2022,08035428,ESCOLA LA FARIGOLA DEL CLOT,08019,080193,BARCELONA,25,6,31
2021/2022,08035431,ESCOLA BOGATELL,08019,080193,BARCELONA,26,4,30
2021/2022,08035441,ESCOLA CATALÒNIA,08019,080193,BARCELONA,26,5,31
2021/2022,08035453,ESCOLA TOMÀS MORO,08019,080193,BARCELONA,18,1,19
2021/2022,08035465,ESCOLA MARE NOSTRUM,08019,080193,BARCELONA,29,2,31
2021/2022,08035477,ESCOLA SANTIAGO RUSIÑOL,08019,080193,BARCELONA,29,2,31
2021/2022,08035519,ESCOLA ANTONI GAUDÍ,08245,082457,SANTA COLOMA DE GRAMENET,34,3,37
2021/2022,08035544,CEE JOSEP PLA,08019,080193,BARCELONA,10,4,14
2021/2022,08035623,CEE JERONI DE MORAGAS,08266,082665,CERDANYOLA DEL VALLÈS,18,0,18
2021/2022,08035684,ESCOLA MARIÀ MANENT,08230,082303,PREMIÀ DE DALT,28,3,31
2021/2022,08035696,ESCOLA SANT JULIÀ,08187,081878,SABADELL,20,2,22
2021/2022,08035854,ESCOLA LLORENS I ARTIGAS,08015,080155,BADALONA,27,3,30
2021/2022,08035878,ESCOLA PERE DE TERA,08015,080155,BADALONA,26,6,32
2021/2022,08035881,ESCOLA L'ARENY,08073,080734,CORNELLÀ DE LLOBREGAT,29,4,33
2021/2022,08035945,ESCOLA LA CARPA,08101,081017,L'HOSPITALET DE LLOBREGAT,44,8,52
2021/2022,08035957,ESCOLA CAN DEU,08187,081878,SABADELL,14,4,18
2021/2022,08035969,ESCOLA JOAQUIM BLUME,08187,081878,SABADELL,26,4,30
2021/2022,08035994,ESCOLA SALVADOR ESPRIU,08211,082114,SANT FELIU DE LLOBREGAT,24,5,29
2021/2022,08036007,ESCOLA PAU VILA,08211,082114,SANT FELIU DE LLOBREGAT,15,4,19
2021/2022,08036044,ESCOLA PAU VILA,08076,080765,ESPARREGUERA,26,4,30
2021/2022,08036056,ESCOLA FOLCH I TORRES,08077,080771,ESPLUGUES DE LLOBREGAT,30,2,32
2021/2022,08036101,ESCOLA SAGRADA FAMÍLIA,08245,082457,SANTA COLOMA DE GRAMENET,29,1,30
2021/2022,08036111,ESCOLA MAS I PERERA,08305,083054,VILAFRANCA DEL PENEDÈS,30,4,34
2021/2022,08036135,ESCOLA JOAN CORET,08015,080155,BADALONA,25,4,29
2021/2022,08036147,ESCOLA PAU PICASSO,08015,080155,BADALONA,22,6,28
2021/2022,08036330,INSTITUT J.V. FOIX,08184,081846,RUBÍ,27,31,58
2021/2022,08036342,ESCOLA JOAN LLONGUERAS,08015,080155,BADALONA,17,3,20
2021/2022,08036366,ESCOLA LOLA ANGLADA,08101,081017,L'HOSPITALET DE LLOBREGAT,20,3,23
2021/2022,08036378,ESCOLA CHARLIE RIVEL,08101,081017,L'HOSPITALET DE LLOBREGAT,16,8,24
2021/2022,08036391,INSTITUT ARQUITECTE MANUEL RASPALL,08046,080462,CARDEDEU,32,21,53
2021/2022,08036411,ESCOLA SALTELLS,08266,082665,CERDANYOLA DEL VALLÈS,22,4,26
2021/2022,08037152,INSTITUT JOAN ORÓ,08114,081141,MARTORELL,74,49,123
2021/2022,08037176,INSTITUT LA BASTIDA,08245,082457,SANTA COLOMA DE GRAMENET,60,30,90
2021/2022,08037206,INSTITUT LLUÍS COMPANYS,08180,081803,RIPOLLET,44,26,70
2021/2022,08037292,CEE CENTRE DE FORMACIÓ I TREBALL FLOR DE MAIG,08266,082665,CERDANYOLA DEL VALLÈS,17,7,24
2021/2022,08037504,ESCOLA MONTNEGRE,08202,082021,SANT CELONI,13,1,14
2021/2022,08037528,ESCOLA SANT DOMÈNEC,08251,082515,SANTA MARGARIDA I ELS MONJOS,14,2,16
2021/2022,08037814,ESCOLA ALEXANDRE GALÍ,08019,080193,BARCELONA,30,3,33
2021/2022,08037841,ESCOLA SPLAI,08019,080193,BARCELONA,17,1,18
2021/2022,08037863,ESCOLA SEAT,08019,080193,BARCELONA,30,2,32
2021/2022,08037875,ESCOLA RAFAEL CASANOVA,08015,080155,BADALONA,30,3,33
2021/2022,08037887,ESCOLA BALDIRI REIXAC,08015,080155,BADALONA,19,6,25
2021/2022,08037899,ESCOLA FOLCH I TORRES,08015,080155,BADALONA,18,4,22
2021/2022,08037917,ESCOLA JOAN MIRÓ,08041,080410,CANOVELLES,15,4,19
2021/2022,08037929,ESCOLA TORRE BARONA,08056,080569,CASTELLDEFELS,25,4,29
2021/2022,08037930,ESCOLA MARGALLÓ,08056,080569,CASTELLDEFELS,27,2,29
2021/2022,08037966,ESCOLA IGNASI IGLÉSIAS,08073,080734,CORNELLÀ DE LLOBREGAT,29,4,33
2021/2022,08037978,ESCOLA SURIS,08073,080734,CORNELLÀ DE LLOBREGAT,26,3,29
2021/2022,08037981,ESCOLA DE L'ESTANY - ZER EL MOIANÈS LLEVANT,08079,080790,L'ESTANY,2,3,5
2021/2022,08037991,ESCOLA MARCEL·LÍ MORAGAS,08089,080898,GAVÀ,25,4,29
2021/2022,08038004,ESCOLA JOSEP JANÉS,08101,081017,L'HOSPITALET DE LLOBREGAT,26,7,33
2021/2022,08038031,ESCOLA ROSA SENSAT,08118,081189,EL MASNOU,14,3,17
2021/2022,08038041,ESCOLA FEDERICO GARCÍA LORCA,08124,081249,MOLLET DEL VALLÈS,8,3,11
2021/2022,08038065,ESCOLA MONTSENY,08124,081249,MOLLET DEL VALLÈS,26,3,29
2021/2022,08038077,ESCOLA CAN PARERA,08136,081363,MONTORNÈS DEL VALLÈS,21,3,24
2021/2022,08038089,ESCOLA SANT ESTEVE - ZER EL CARDENER,08229,082299,SANT MATEU DE BAGES,5,1,6
2021/2022,08038090,ESCOLA SANT JAUME,08169,081691,EL PRAT DE LLOBREGAT,27,8,35
2021/2022,08038156,ESCOLA ESCURSELL I BARTALOT,08180,081803,RIPOLLET,31,3,34
2021/2022,08038168,ESCOLA LA TORRETA,08181,081810,LA ROCA DEL VALLÈS,16,3,19
2021/2022,08038171,ESCOLA MONTESSORI,08184,081846,RUBÍ,31,4,35
2021/2022,08038181,ESCOLA SERRA I HÚNTER,08113,081136,MANRESA,28,7,35
2021/2022,08038201,ESCOLA LA BAUMETA - ZER ELS CASTELLS,08253,082536,SANTA MARIA DE BESORA,2,0,2
2021/2022,08038211,ESCOLA JOSÉ JUAN ORTIZ,08196,081960,SANT ANDREU DE LA BARCA,24,4,28
2021/2022,08038223,ESCOLA BENVIURE,08200,082009,SANT BOI DE LLOBREGAT,24,6,30
2021/2022,08038247,ESCOLA POMPEU FABRA,08302,083020,VILANOVA DEL CAMÍ,23,5,28
2021/2022,08038259,ESCOLA ANTONI TÀPIES,08200,082009,SANT BOI DE LLOBREGAT,25,6,31
2021/2022,08038260,ESCOLA JOAN MARAGALL,08205,082055,SANT CUGAT DEL VALLÈS,32,2,34
2021/2022,08038272,ESCOLA GARCÍA LORCA,08250,082508,SANTA MARGARIDA DE MONTBUI,30,6,36
2021/2022,08038284,ESCOLA LA GUÀRDIA,08263,082634,SANT VICENÇ DELS HORTS,14,3,17
2021/2022,08038314,ESCOLA MARE DE DÉU DE MONTSERRAT,08279,082798,TERRASSA,19,2,21
2021/2022,08038326,ESCOLA EL VALLÈS,08279,082798,TERRASSA,21,2,23
2021/2022,08038351,ESCOLA XARAU,08266,082665,CERDANYOLA DEL VALLÈS,14,3,17
2021/2022,08038570,EOI DE BARCELONA,08019,080193,BARCELONA,77,22,99
2021/2022,08038582,ESCOLA CATALUNYA,08187,081878,SABADELL,34,2,36
2021/2022,08039057,INSTITUT L'ALZINA,08019,080193,BARCELONA,38,13,51
2021/2022,08039069,INSTITUT MARGARIDA XIRGU,08101,081017,L'HOSPITALET DE LLOBREGAT,41,17,58
2021/2022,08039203,INSTITUT AGUSTÍ SERRA I FONTANET,08187,081878,SABADELL,70,65,135
2021/2022,08039264,ESCOLA MESTRES MUNGUET-CORTÉS,08902,089024,VILANOVA DEL VALLÈS,23,3,26
2021/2022,08039288,ESCOLA RENAIXENÇA,08122,081228,MEDIONA,7,2,9
2021/2022,08039291,ESCOLA CRISTÒFOR MESTRE,08305,083054,VILAFRANCA DEL PENEDÈS,25,7,32
2021/2022,08039306,ESCOLA ELS PINS - ZER EL MOIANÈS PONENT,08191,081918,SALLENT,4,1,5
2021/2022,08039318,ESCOLA PUIGBERENGUER,08113,081136,MANRESA,32,3,35
2021/2022,08039343,ESCOLA JOSEP FERRÀ I ESTEVA,08147,081477,OLESA DE MONTSERRAT,27,5,32
2021/2022,08039355,ESCOLA RAMON LLULL,08169,081691,EL PRAT DE LLOBREGAT,27,3,30
2021/2022,08039367,ESCOLA JOSEP PLA,08196,081960,SANT ANDREU DE LA BARCA,26,5,31
2021/2022,08039379,ESCOLA RAFAEL CASANOVA,08200,082009,SANT BOI DE LLOBREGAT,20,5,25
2021/2022,08039380,ESCOLA GERMANS AMAT I TARGA,08301,083015,VILADECANS,25,4,29
2021/2022,08039434,ESCOLA DOCTOR FERRAN I CLUA,08019,080193,BARCELONA,30,3,33
2021/2022,08039471,ESCOLA MERCÈ RODOREDA,08019,080193,BARCELONA,26,5,31
2021/2022,08039483,ESCOLA ELS HORTS,08019,080193,BARCELONA,16,2,18
2021/2022,08039495,ESCOLA LA PALMERA,08019,080193,BARCELONA,28,4,32
2021/2022,08039525,ESCOLA LA SEDETA,08019,080193,BARCELONA,13,3,16
2021/2022,08039537,ESCOLA TORRENT D'EN MELIS,08019,080193,BARCELONA,24,5,29
2021/2022,08039562,ESCOLA PRAT DE LA MANTA,08101,081017,L'HOSPITALET DE LLOBREGAT,15,3,18
2021/2022,08039574,ESCOLA PAU SANS,08101,081017,L'HOSPITALET DE LLOBREGAT,16,1,17
2021/2022,08039586,ESCOLA L'ARJAU,08307,083073,VILANOVA I LA GELTRÚ,26,5,31
2021/2022,08039598,ESCOLA SANT MIQUEL DEL CROS,08009,080095,ARGENTONA,12,1,13
2021/2022,08039604,ESCOLA FRANCESC FERRER I GUÀRDIA,08118,081189,EL MASNOU,14,3,17
2021/2022,08039616,ESCOLA CAMÍ DEL CROS,08121,081213,MATARÓ,30,4,34
2021/2022,08039628,ESCOLA POMPEU FABRA,08112,081120,MANLLEU,33,5,38
2021/2022,08039631,ESCOLA L'AGULLOLA,08901,089019,RUPIT I PRUIT,4,0,4
2021/2022,08039641,ESCOLA PABLO PICASSO,08252,082520,BARBERÀ DEL VALLÈS,21,4,25
2021/2022,08039653,ESCOLA AGUSTÍ BARTRA,08279,082798,TERRASSA,31,4,35
2021/2022,08039665,ESCOLA LANASPA-GIRALT,08279,082798,TERRASSA,14,5,19
2021/2022,08039677,ESCOLA CONGOST,08041,080410,CANOVELLES,33,5,38
2021/2022,08039690,ESCOLA GERMANS CORBELLA,08046,080462,CARDEDEU,28,3,31
2021/2022,08039707,ESCOLA TAGAMANENT,08088,080885,LA GARRIGA,12,4,16
2021/2022,08039719,ESCOLA LES PLANES,08105,081056,LA LLAGOSTA,24,4,28
2021/2022,08039744,ESCOLA DEL PONT TRENCAT - ZER BAIX MONTSENY,08259,082592,SANTA MARIA DE PALAUTORDERA,5,0,5
2021/2022,08039835,ESCOLA DE LES AIGÜES,08019,080193,BARCELONA,30,3,33
2021/2022,08039896,ESCOLA BELLATERRA,08266,082665,CERDANYOLA DEL VALLÈS,29,4,33
2021/2022,08040047,CEE JOSEP SOL I RODRÍGUEZ,08245,082457,SANTA COLOMA DE GRAMENET,32,6,38
2021/2022,08040059,ESCOLA JOAN SALVAT I PAPASSEIT,08245,082457,SANTA COLOMA DE GRAMENET,32,3,35
2021/2022,08040060,ESCOLA DEL MAR,08219,082191,VILASSAR DE MAR,28,4,32
2021/2022,08040138,INSTITUT LA SEDETA,08019,080193,BARCELONA,22,14,36
2021/2022,08040141,INSTITUT ICÀRIA,08019,080193,BARCELONA,43,21,64
2021/2022,08040333,ESCOLA BERNAT METGE,08169,081691,EL PRAT DE LLOBREGAT,15,2,17
2021/2022,08040345,ESCOLA MERCÈ RODOREDA,08015,080155,BADALONA,14,3,17
2021/2022,08040357,CEE FOLCH I CAMARASA,08019,080193,BARCELONA,9,0,9
2021/2022,08040382,ESCOLA MERCÈ RODOREDA,08245,082457,SANTA COLOMA DE GRAMENET,32,7,39
2021/2022,08040400,ESCOLA AMADEU VIVES,08187,081878,SABADELL,29,7,36
2021/2022,08040412,ESCOLA EL MARGALLÓ,08307,083073,VILANOVA I LA GELTRÚ,20,4,24
2021/2022,08040527,INSTITUT LA LLAUNA,08015,080155,BADALONA,37,24,61
2021/2022,08040539,INSTITUT LES MARINES,08056,080569,CASTELLDEFELS,37,17,54
2021/2022,08040540,INSTITUT EL CAIRAT,08076,080765,ESPARREGUERA,46,19,65
2021/2022,08040552,INSTITUT ANTONI POUS I ARGILA,08112,081120,MANLLEU,59,23,82
2021/2022,08040564,INSTITUT JAUME ALMERA,08214,082140,VILASSAR DE DALT,28,18,46
2021/2022,08040618,ESCOLA CAN VIDALET,08077,080771,ESPLUGUES DE LLOBREGAT,17,1,18
2021/2022,08040849,INSTITUT FORT PIUS,08019,080193,BARCELONA,27,16,43
2021/2022,08041131,ESCOLA SANT ANTONI,08263,082634,SANT VICENÇ DELS HORTS,17,1,18
2021/2022,08041167,ESCOLA JOSEP CARNER,08015,080155,BADALONA,36,2,38
2021/2022,08041179,ESCOLA MESTRE ENRIC GIBERT I CAMINS,08019,080193,BARCELONA,29,4,33
2021/2022,08041180,ESCOLA ROSSELLÓ PÒRCEL,08245,082457,SANTA COLOMA DE GRAMENET,15,3,18
2021/2022,08041210,ESCOLA DEL BOSC,08252,082520,BARBERÀ DEL VALLÈS,30,2,32
2021/2022,08041222,ESCOLA CAN CLADELLAS,08156,081568,PALAU-SOLITÀ I PLEGAMANS,29,2,31
2021/2022,08041234,ESCOLA COLLSEROLA,08205,082055,SANT CUGAT DEL VALLÈS,29,4,33
2021/2022,08041246,ESCOLA FRANCESC ALDEA I PÉREZ,08279,082798,TERRASSA,15,2,17
2021/2022,08041374,INSTITUT LA MALLOLA,08077,080771,ESPLUGUES DE LLOBREGAT,33,17,50
2021/2022,08041519,INSTITUT MARTÍ DOT,08211,082114,SANT FELIU DE LLOBREGAT,56,33,89
2021/2022,08041556,ESCOLA MONTSENY,08221,082212,SANT JUST DESVERN,21,0,21
2021/2022,08041568,ESCOLA JUNGFRAU,08015,080155,BADALONA,27,7,34
2021/2022,08041571,ESCOLA ARTUR MARTORELL,08015,080155,BADALONA,15,3,18
2021/2022,08041581,ESCOLA GITANJALI,08015,080155,BADALONA,15,1,16
2021/2022,08041601,ESCOLA TORRE DE LA LLEBRE,08184,081846,RUBÍ,16,3,19
2021/2022,08041611,ESCOLA JOANOT ALISANDA,08187,081878,SABADELL,32,2,34
2021/2022,08041647,ESCOLA PONENT,08096,080961,GRANOLLERS,31,5,36
2021/2022,08041659,ESCOLA MESTRES MONTAÑA,08096,080961,GRANOLLERS,28,3,31
2021/2022,08041660,ESCOLA PONT DE LA CADENA,08123,081234,MOLINS DE REI,16,1,17
2021/2022,08041672,ESCOLA CREU ALTA,08187,081878,SABADELL,16,2,18
2021/2022,08041684,ESCOLA ESPAI 3,08217,082172,SANT JOAN DESPÍ,32,0,32
2021/2022,08041696,ESCOLA VAIXELL BURRIAC,08219,082191,VILASSAR DE MAR,25,5,30
2021/2022,08041714,ESCOLA LES BASSEROLES,08269,082690,SEVA,13,2,15
2021/2022,08041726,ESCOLA ROC BLANC,08300,083008,VILADECAVALLS,19,2,21
2021/2022,08041751,ESCOLA LA CAIXA,08019,080193,BARCELONA,19,2,21
2021/2022,08041866,INSTITUT EL CALAMOT,08089,080898,GAVÀ,64,49,113
2021/2022,08042019,INSTITUT BADALONA VII,08015,080155,BADALONA,38,34,72
2021/2022,08042020,INSTITUT VALLÈS,08187,081878,SABADELL,42,21,63
2021/2022,08042044,INSTITUT MIG-MÓN,08274,082747,SÚRIA,35,17,52
2021/2022,08042056,INSTITUT CAN PUIG,08231,082310,SANT PERE DE RIBES,46,24,70
2021/2022,08042093,INSTITUT VINYES VELLES,08136,081363,MONTORNÈS DEL VALLÈS,36,24,60
2021/2022,08042101,INSTITUT MANUEL VÁZQUEZ MONTALBÁN,08194,081944,SANT ADRIÀ DE BESÒS,34,25,59
2021/2022,08042287,ESCOLA SALVADOR ESPRIU,08096,080961,GRANOLLERS,30,3,33
2021/2022,08042299,ESCOLA SANT MIQUEL,08073,080734,CORNELLÀ DE LLOBREGAT,28,4,32
2021/2022,08042305,ESCOLA JOAN MIRÓ,08019,080193,BARCELONA,29,2,31
2021/2022,08042329,ESCOLA ELS XIPRERS,08019,080193,BARCELONA,12,4,16
2021/2022,08042330,INSTITUT SANT RAMON,08047,080478,CARDONA,10,8,18
2021/2022,08042342,INSTITUT DE BADIA DEL VALLÈS,08904,089045,BADIA DEL VALLÈS,39,44,83
2021/2022,08042780,ESCOLA JOSEP MARIA JUJOL,08019,080193,BARCELONA,27,5,32
2021/2022,08042792,ESCOLA DAMIÀ MATEU,08106,081069,LLINARS DEL VALLÈS,17,1,18
2021/2022,08042809,ESCOLA GALILEO GALILEI,08169,081691,EL PRAT DE LLOBREGAT,26,4,30
2021/2022,08042810,ESCOLA CHARLES DARWIN,08169,081691,EL PRAT DE LLOBREGAT,33,3,36
2021/2022,08042834,ESCOLA CAN PALMER,08301,083015,VILADECANS,21,3,24
2021/2022,08042846,CFA CORNELLÀ DE LLOBREGAT,08073,080734,CORNELLÀ DE LLOBREGAT,10,4,14
2021/2022,08042858,CFA ELS TARONGERS,08121,081213,MATARÓ,6,5,11
2021/2022,08042861,ESCOLA LOLA ANGLADA,08077,080771,ESPLUGUES DE LLOBREGAT,16,2,18
2021/2022,08042871,ESCOLA PATUFET SANT JORDI-FRANCESC BATALLÉ I ARA,08101,081017,L'HOSPITALET DE LLOBREGAT,33,1,34
2021/2022,08042883,ESCOLA SANT JOSEP - EL PI,08101,081017,L'HOSPITALET DE LLOBREGAT,14,3,17
2021/2022,08042895,ESCOLA SCHOLA,08184,081846,RUBÍ,18,0,18
2021/2022,08043103,ESCOLA ANTONI BALMANYA,08019,080193,BARCELONA,26,4,30
2021/2022,08043115,ESCOLA PROVENÇALS,08019,080193,BARCELONA,25,5,30
2021/2022,08043255,ESCOLA ÍTACA,08019,080193,BARCELONA,26,4,30
2021/2022,08043267,ESCOLA PAU CASALS-GRÀCIA,08019,080193,BARCELONA,26,5,31
2021/2022,08043279,ESCOLA POMPEU FABRA,08019,080193,BARCELONA,13,5,18
2021/2022,08043292,ESCOLA TABOR,08019,080193,BARCELONA,27,5,32
2021/2022,08043310,ESCOLA EDUMAR,08056,080569,CASTELLDEFELS,29,4,33
2021/2022,08043334,ESCOLA ALEXANDRE GALÍ,08073,080734,CORNELLÀ DE LLOBREGAT,17,3,20
2021/2022,08043346,ESCOLA MONTSERRAT,08076,080765,ESPARREGUERA,15,2,17
2021/2022,08043361,ESCOLA EL TURÓ,08125,081252,MONTCADA I REIXAC,16,2,18
2021/2022,08043371,ESCOLA LA LIÓ,08172,081727,PREMIÀ DE MAR,13,3,16
2021/2022,08043383,ESCOLA NOSTRA LLAR,08187,081878,SABADELL,30,3,33
2021/2022,08043395,INSTITUT ALEXANDRE DE RIQUER,08031,080312,CALAF,20,13,33
2021/2022,08043401,ESCOLA BARRUFET,08200,082009,SANT BOI DE LLOBREGAT,17,8,25
2021/2022,08043437,ESCOLA FONT DE L'ALBA,08279,082798,TERRASSA,22,4,26
2021/2022,08043462,INSTITUT ERNEST LLUCH,08019,080193,BARCELONA,36,26,62
2021/2022,08043474,ESCOLA L'ESTEL,08019,080193,BARCELONA,17,2,19
2021/2022,08043486,INSTITUT MANOLO HUGUÉ,08033,080333,CALDES DE MONTBUI,45,29,74
2021/2022,08043504,INSTITUT PERE CALDERS,08266,082665,CERDANYOLA DEL VALLÈS,23,18,41
2021/2022,08043516,INSTITUT SANTA EULÀLIA,08279,082798,TERRASSA,48,67,115
2021/2022,08043589,INSTITUT SALVADOR DALÍ,08169,081691,EL PRAT DE LLOBREGAT,43,19,62
2021/2022,08043644,INSTITUT CARLES VALLBONA,08096,080961,GRANOLLERS,54,52,106
2021/2022,08043656,INSTITUT MARINA,08105,081056,LA LLAGOSTA,45,43,88
2021/2022,08043668,INSTITUT L'ESTATUT,08184,081846,RUBÍ,42,32,74
2021/2022,08043671,INSTITUT EL PALAU,08196,081960,SANT ANDREU DE LA BARCA,55,52,107
2021/2022,08043681,INSTITUT MARIANAO,08200,082009,SANT BOI DE LLOBREGAT,48,41,89
2021/2022,08043693,INSTITUT JOAQUIM MIR,08307,083073,VILANOVA I LA GELTRÚ,61,46,107
2021/2022,08043747,ESCOLA BALOO,08019,080193,BARCELONA,16,1,17
2021/2022,08043760,ESCOLA COLÒNIA GÜELL,08244,082444,SANTA COLOMA DE CERVELLÓ,29,3,32
2021/2022,08043784,ESCOLA ÀNGELS GARRIGA,08019,080193,BARCELONA,14,3,17
2021/2022,08043796,ESCOLA BARRUFET,08019,080193,BARCELONA,26,5,31
2021/2022,08043814,ESCOLA CARLIT,08019,080193,BARCELONA,17,2,19
2021/2022,08043838,ESCOLA TURÓ DEL CARGOL,08019,080193,BARCELONA,18,1,19
2021/2022,08043841,ESCOLA LAVÍNIA,08019,080193,BARCELONA,15,2,17
2021/2022,08043851,ESCOLA NABÍ,08019,080193,BARCELONA,11,5,16
2021/2022,08043863,ESCOLA ORLANDAI,08019,080193,BARCELONA,15,1,16
2021/2022,08043875,ESCOLA PIT-ROIG,08019,080193,BARCELONA,14,3,17
2021/2022,08043887,ESCOLA SAGRADA FAMÍLIA,08019,080193,BARCELONA,29,1,30
2021/2022,08043899,ESCOLA TÀBER,08019,080193,BARCELONA,25,5,30
2021/2022,08043905,ESCOLA EL DOFÍ,08172,081727,PREMIÀ DE MAR,13,2,15
2021/2022,08043917,ESCOLA COSSETÀNIA,08307,083073,VILANOVA I LA GELTRÚ,14,2,16
2021/2022,08043929,ESCOLA LLEBETX,08307,083073,VILANOVA I LA GELTRÚ,18,4,22
2021/2022,08043930,ESCOLA MARINADA,08118,081189,EL MASNOU,14,3,17
2021/2022,08043942,ESCOLA MONTBUI,08033,080333,CALDES DE MONTBUI,29,2,31
2021/2022,08043954,ESCOLA RIBATALLADA,08187,081878,SABADELL,15,2,17
2021/2022,08043966,ESCOLA HEURA,08019,080193,BARCELONA,13,3,16
2021/2022,08043978,INSTITUT DANIEL BLANXART I PEDRALS,08147,081477,OLESA DE MONTSERRAT,59,44,103
2021/2022,08043981,INSTITUT JOAN RAMON BENAPRÈS,08270,082704,SITGES,47,40,87
2021/2022,08044016,ESCOLA FLAMA,08213,082135,SANT FRUITÓS DE BAGES,32,3,35
2021/2022,08044028,CEE HORITZÓ,08163,081635,PINEDA DE MAR,22,6,28
2021/2022,08044053,INSTITUT SALVADOR SEGUÍ,08019,080193,BARCELONA,105,21,126
2021/2022,08044065,INSTITUT GALILEO GALILEI,08019,080193,BARCELONA,28,18,46
2021/2022,08044077,EA JOSEP SERRA I ABELLA,08101,081017,L'HOSPITALET DE LLOBREGAT,25,19,44
2021/2022,08044120,CFA FREIRE,08019,080193,BARCELONA,5,4,9
2021/2022,08044156,EA DEIÀ,08019,080193,BARCELONA,24,18,42
2021/2022,08044168,INSTITUT PLA DE LES MORERES,08302,083020,VILANOVA DEL CAMÍ,45,28,73
2021/2022,08044201,ESCOLA DOVELLA,08019,080193,BARCELONA,17,0,17
2021/2022,08044223,CEE L'ESTEL- CAN BORI,08101,081017,L'HOSPITALET DE LLOBREGAT,25,7,32
2021/2022,08044247,ESCOLA ESTEL,08123,081234,MOLINS DE REI,15,1,16
2021/2022,08044296,ESCOLA SALVADOR ESPRIU,08015,080155,BADALONA,26,4,30
2021/2022,08044302,ESCOLA JOAN ABELLÓ,08124,081249,MOLLET DEL VALLÈS,31,2,33
2021/2022,08044314,ESCOLA ANDREU CASTELLS,08187,081878,SABADELL,28,7,35
2021/2022,08044430,ESCOLA LA GARALDA,08157,081574,PALLEJÀ,32,1,33
2021/2022,08044454,ESCOLA PILARÍN BAYÉS,08238,082384,SANT QUIRZE DEL VALLÈS,27,4,31
2021/2022,08044508,ESCOLA ÍTACA,08015,080155,BADALONA,22,0,22
2021/2022,08044511,EOI BARCELONA-VALL D'HEBRON,08019,080193,BARCELONA,32,7,39
2021/2022,08044521,ESCOLA ELS PINETONS,08088,080885,LA GARRIGA,26,5,31
2021/2022,08044533,INSTITUT LA FERRERIA,08125,081252,MONTCADA I REIXAC,65,49,114
2021/2022,08044545,ESCOLA COLLBAIX,08218,082188,SANT JOAN DE VILATORRADA,12,4,16
2021/2022,08044569,INSTITUT PERE BARNILS,08067,080673,CENTELLES,42,19,61
2021/2022,08044570,INSTITUT VALL D'ARÚS,08295,082956,VALLIRANA,44,26,70
2021/2022,08044582,EOI DE L'HOSPITALET DE LLOBREGAT,08101,081017,L'HOSPITALET DE LLOBREGAT,20,7,27
2021/2022,08044594,INSTITUT GIOLA,08106,081069,LLINARS DEL VALLÈS,41,23,64
2021/2022,08044600,INSTITUT MOIANÈS,08138,081385,MOIÀ,26,23,49
2021/2022,08044612,INSTITUT TORRE DE MALLA,08159,081593,PARETS DEL VALLÈS,46,32,78
2021/2022,08044624,INSTITUT SABADELL,08187,081878,SABADELL,50,35,85
2021/2022,08044715,INSTITUT JAUME MIMÓ,08266,082665,CERDANYOLA DEL VALLÈS,47,44,91
2021/2022,08044910,ESCOLA EL TURONET,08238,082384,SANT QUIRZE DEL VALLÈS,16,1,17
2021/2022,08044922,INSTITUT DR. PUIGVERT,08019,080193,BARCELONA,40,25,65
2021/2022,08044934,INSTITUT ESCOLA D'HOTELERIA I TURISME DE BARCELONA,08019,080193,BARCELONA,41,32,73
2021/2022,08044958,INSTITUT JOSEP PLA,08019,080193,BARCELONA,30,16,46
2021/2022,08044961,ESCRBC DE CATALUNYA,08019,080193,BARCELONA,15,8,23
2021/2022,08044971,INSTITUT PERE FONTDEVILA,08092,080924,GIRONELLA,29,10,39
2021/2022,08044983,INSTITUT LLUÍS COMPANYS,08284,082845,TORDERA,37,21,58
2021/2022,08044995,INSTITUT BARRES I ONES,08015,080155,BADALONA,43,23,66
2021/2022,08045011,INSTITUT TORRE DEL PALAU,08279,082798,TERRASSA,48,21,69
2021/2022,08045021,INSTITUT ESTELA IBÈRICA,08260,082606,SANTA PERPÈTUA DE MOGODA,43,31,74
2021/2022,08045033,ESCOLA MONTPALAU,08163,081635,PINEDA DE MAR,14,5,19
2021/2022,08045045,ESCOLA MEDITERRÀNIA,08163,081635,PINEDA DE MAR,18,2,20
2021/2022,08045057,ESCOLA EL SAGRER,08019,080193,BARCELONA,30,2,32
2021/2022,08045070,INSTITUT EUROPA,08101,081017,L'HOSPITALET DE LLOBREGAT,22,13,35
2021/2022,08045203,INSTITUT OBERT DE CATALUNYA,08019,080193,BARCELONA,74,59,133
2021/2022,08045227,CEE LES AIGÜES,08121,081213,MATARÓ,43,2,45
2021/2022,08045306,INSTITUT RAMON CASAS I CARBÓ,08156,081568,PALAU-SOLITÀ I PLEGAMANS,42,27,69
2021/2022,08045471,INSTITUT POMPEU FABRA,08015,080155,BADALONA,47,55,102
2021/2022,08045483,INSTITUT VILA DE GRÀCIA,08019,080193,BARCELONA,26,12,38
2021/2022,08045513,INSTITUT FLOS I CALCAT,08019,080193,BARCELONA,30,13,43
2021/2022,08045525,INSTITUT MANUEL CARRASCO I FORMIGUERA,08019,080193,BARCELONA,24,13,37
2021/2022,08045537,INSTITUT JOSEP LLUÍS SERT,08056,080569,CASTELLDEFELS,37,26,63
2021/2022,08045549,INSTITUT BANÚS,08266,082665,CERDANYOLA DEL VALLÈS,39,20,59
2021/2022,08045562,INSTITUT CAN PLANAS,08252,082520,BARBERÀ DEL VALLÈS,38,27,65
2021/2022,08045574,ESCOLA SERRA DE MARINA,08245,082457,SANTA COLOMA DE GRAMENET,24,10,34
2021/2022,08045586,ESCOLA LES PRUNERES,08115,081154,MARTORELLES,13,2,15
2021/2022,08045598,ESCOLA MIL·LENARI,08046,080462,CARDEDEU,31,1,32
2021/2022,08045604,INSTITUT ENRIC BORRÀS,08015,080155,BADALONA,55,27,82
2021/2022,08045628,INSTITUT CELESTÍ BELLERA,08096,080961,GRANOLLERS,46,14,60
2021/2022,08045641,INSTITUT LLUÍS DOMÈNECH I MONTANER,08040,080403,CANET DE MAR,45,25,70
2021/2022,08045653,INSTITUT DOLORS MALLAFRÈ I ROS,08307,083073,VILANOVA I LA GELTRÚ,36,21,57
2021/2022,08045665,INSTITUT RAMON TURRÓ I DARDER,08110,081108,MALGRAT DE MAR,43,25,68
2021/2022,08045677,INSTITUT THALASSA,08126,081265,MONTGAT,27,18,45
2021/2022,08045689,INSTITUT VOLTRERA,08001,080018,ABRERA,41,25,66
2021/2022,08045859,INSTITUT DE CORBERA DE LLOBREGAT,08072,080728,CORBERA DE LLOBREGAT,25,27,52
2021/2022,08045860,INSTITUT MIRAMAR,08301,083015,VILADECANS,31,23,54
2021/2022,08046281,ESCOLA ESTEL-GUINARDÓ,08019,080193,BARCELONA,13,4,17
2021/2022,08046293,ESCOLA CAVALL BERNAT,08019,080193,BARCELONA,14,4,18
2021/2022,08046581,INSTITUT LLUÍS VIVES,08019,080193,BARCELONA,29,12,41
2021/2022,08046608,INSTITUT PRÍNCEP DE VIANA,08019,080193,BARCELONA,32,20,52
2021/2022,08046645,INSTITUT MOLÍ DE LA VILA,08044,080446,CAPELLADES,38,17,55
2021/2022,08046657,INSTITUT JOAQUIM BLUME,08077,080771,ESPLUGUES DE LLOBREGAT,12,14,26
2021/2022,08046669,INSTITUT RIBOT I SERRA,08187,081878,SABADELL,55,17,72
2021/2022,08046670,INSTITUT ANGELETA FERRER I SENSAT,08205,082055,SANT CUGAT DEL VALLÈS,42,25,67
2021/2022,08046682,INSTITUT DE CASTELLAR,08051,080517,CASTELLAR DEL VALLÈS,44,33,77
2021/2022,08046694,INSTITUT CENTRE D'ALT RENDIMENT ESPORTIU,08205,082055,SANT CUGAT DEL VALLÈS,17,33,50
2021/2022,08046724,INSTITUT MONTSERRAT ROIG,08279,082798,TERRASSA,72,34,106
2021/2022,08046736,INSTITUT MILÀ I FONTANALS,08305,083054,VILAFRANCA DEL PENEDÈS,52,26,78
2021/2022,08046748,INSTITUT THOS I CODINA,08121,081213,MATARÓ,64,45,109
2021/2022,08046751,INSTITUT VENTURA GASSOL,08015,080155,BADALONA,32,17,49
2021/2022,08046761,INSTITUT GUILLEM CATÀ,08113,081136,MANRESA,70,45,115
2021/2022,08046785,INSTITUT D'ALELLA,08003,080039,ALELLA,36,22,58
2021/2022,08046797,INSTITUT LAIA L'ARQUERA,08121,081213,MATARÓ,37,24,61
2021/2022,08046803,INSTITUT VILATZARA,08219,082191,VILASSAR DE MAR,41,32,73
2021/2022,08046840,INSTITUT CASTELLET,08262,082628,SANT VICENÇ DE CASTELLET,46,36,82
2021/2022,08046852,INSTITUT LLAVANERES,08197,081976,SANT ANDREU DE LLAVANERES,33,19,52
2021/2022,08046864,INSTITUT BELLULLA,08041,080410,CANOVELLES,42,20,62
2021/2022,08046876,INSTITUT MIQUEL BOSCH I JOVER,08010,080109,ARTÉS,28,12,40
2021/2022,08047364,INSTITUT JOAN MERCADER,08102,081022,IGUALADA,42,26,68
2021/2022,08047376,INSTITUT LLOBREGAT,08191,081918,SALLENT,26,20,46
2021/2022,08047421,INSTITUT MONTSERRAT ROIG,08019,080193,BARCELONA,28,17,45
2021/2022,08047431,INSTITUT XXV OLIMPÍADA,08019,080193,BARCELONA,36,22,58
2021/2022,08047467,INSTITUT ALEXANDRE GALÍ,08231,082310,SANT PERE DE RIBES,44,20,64
2021/2022,08047479,INSTITUT ALBA DEL VALLÈS,08209,082093,SANT FOST DE CAMPSENTELLES,46,22,68
2021/2022,08047480,INSTITUT MEDITERRÀNIA,08056,080569,CASTELLDEFELS,61,40,101
2021/2022,08047492,INSTITUT RIBERA BAIXA,08169,081691,EL PRAT DE LLOBREGAT,31,24,55
2021/2022,08047509,INSTITUT ÍTACA,08200,082009,SANT BOI DE LLOBREGAT,30,22,52
2021/2022,08047583,INSTITUT SANT QUIRZE DEL VALLÈS,08238,082384,SANT QUIRZE DEL VALLÈS,44,31,75
2021/2022,08047820,INSTITUT GUINOVARDA,08161,081614,PIERA,55,21,76
2021/2022,08047832,INSTITUT JOAN COROMINES,08163,081635,PINEDA DE MAR,58,21,79
2021/2022,08051240,ESCOLA MEDITERRÀNIA,08073,080734,CORNELLÀ DE LLOBREGAT,31,2,33
2021/2022,08051264,INSTITUT EDUARD FONTSERÈ,08101,081017,L'HOSPITALET DE LLOBREGAT,26,19,45
2021/2022,08051306,ESCOLA ABAT MARCET,08279,082798,TERRASSA,30,1,31
2021/2022,08051318,ESCOLA SANT LLORENÇ DEL MUNT,08279,082798,TERRASSA,26,6,32
2021/2022,08051471,ESCOLA JOSEP MARIA FOLCH I TORRES,08101,081017,L'HOSPITALET DE LLOBREGAT,25,11,36
2021/2022,08052165,ESCOLA OCTAVIO PAZ,08019,080193,BARCELONA,14,3,17
2021/2022,08052207,INSTITUT DE PUIG-REIG,08175,081751,PUIG-REIG,21,17,38
2021/2022,08052581,INSTITUT MIQUEL TARRADELL,08019,080193,BARCELONA,49,14,63
2021/2022,08052608,INSTITUT PAU CLARIS,08019,080193,BARCELONA,21,17,38
2021/2022,08052621,ESCOLA PAU ROMEVA,08019,080193,BARCELONA,31,1,32
2021/2022,08052657,ESCOLA FORT PIENC,08019,080193,BARCELONA,27,2,29
2021/2022,08052669,ESCOLA FERRAN SUNYER,08019,080193,BARCELONA,31,4,35
2021/2022,08052670,ESCOLA AURÓ,08019,080193,BARCELONA,34,2,36
2021/2022,08052700,INSTITUT VALL D'HEBRON,08019,080193,BARCELONA,86,41,127
2021/2022,08052724,INSTITUT FRANCISCO DE GOYA,08019,080193,BARCELONA,29,15,44
2021/2022,08052761,INSTITUT JOSEP COMAS I SOLÀ,08019,080193,BARCELONA,9,4,13
2021/2022,08052785,ESCOLA VILA OLÍMPICA,08019,080193,BARCELONA,28,4,32
2021/2022,08052797,INSTITUT SALVADOR ESPRIU,08019,080193,BARCELONA,36,25,61
2021/2022,08052827,INSTITUT LLUÍS DOMÈNECH I MONTANER,08019,080193,BARCELONA,26,22,48
2021/2022,08052839,INSTITUT CONSELL DE CENT,08019,080193,BARCELONA,26,15,41
2021/2022,08052876,INSTITUT D'ARGENTONA,08009,080095,ARGENTONA,49,22,71
2021/2022,08052888,INSTITUT JÚLIA MINGUELL,08015,080155,BADALONA,38,23,61
2021/2022,08052891,INSTITUT L'ALT BERGUEDÀ,08016,080168,BAGÀ,19,18,37
2021/2022,08052906,INSTITUT LAURO,08086,080863,LES FRANQUESES DEL VALLÈS,50,21,71
2021/2022,08052918,INSTITUT BISBE BERENGUER,08101,081017,L'HOSPITALET DE LLOBREGAT,34,18,52
2021/2022,08052921,INSTITUT EUGENI D'ORS,08101,081017,L'HOSPITALET DE LLOBREGAT,34,13,47
2021/2022,08052931,EOI DEL MARESME,08121,081213,MATARÓ,12,1,13
2021/2022,08052955,INSTITUT DE LLIÇÀ,08107,081075,LLIÇÀ D'AMUNT,44,28,72
2021/2022,08052979,INSTITUT JOSEP PUIG I CADAFALCH,08121,081213,MATARÓ,52,27,79
2021/2022,08052980,INSTITUT MONTMELÓ,08135,081350,MONTMELÓ,32,21,53
2021/2022,08052992,INSTITUT EUCLIDES,08163,081635,PINEDA DE MAR,38,20,58
2021/2022,08053005,INSTITUT CASTELL DE QUER,08171,081712,PRATS DE LLUÇANÈS,24,9,33
2021/2022,08053017,INSTITUT VALERIÀ PUJOL I BOSCH,08230,082303,PREMIÀ DE DALT,25,18,43
2021/2022,08053029,EOI BADALONA,08015,080155,BADALONA,8,3,11
2021/2022,08053030,INSTITUT DE LA ROCA DEL VALLÈS,08181,081810,LA ROCA DEL VALLÈS,34,17,51
2021/2022,08053042,INSTITUT MIQUEL MARTÍ I POL,08183,081831,RODA DE TER,37,9,46
2021/2022,08053054,INSTITUT GERBERT D'AURILLAC,08213,082135,SANT FRUITÓS DE BAGES,38,14,52
2021/2022,08053078,INSTITUT NUMÀNCIA,08245,082457,SANTA COLOMA DE GRAMENET,39,21,60
2021/2022,08067600,ESCOLA VALLDAURA,08113,081136,MANRESA,21,1,22
2021/2022,08053091,INSTITUT EL FOIX,08251,082515,SANTA MARGARIDA I ELS MONJOS,44,19,63
2021/2022,08053108,INSTITUT REGUISSOL,08259,082592,SANTA MARIA DE PALAUTORDERA,32,15,47
2021/2022,08053111,INSTITUT D'AURO,08192,081923,SANTPEDOR,37,14,51
2021/2022,08053121,INSTITUT TARADELL,08278,082785,TARADELL,33,22,55
2021/2022,08053145,INSTITUT CASTELLBISBAL,08054,080543,CASTELLBISBAL,44,26,70
2021/2022,08053157,INSTITUT GORGS,08266,082665,CERDANYOLA DEL VALLÈS,34,18,52
2021/2022,08053169,INSTITUT MATADEPERA,08120,081206,MATADEPERA,39,22,61
2021/2022,08053170,INSTITUT POLINYÀ,08167,081672,POLINYÀ,36,22,58
2021/2022,08053182,INSTITUT LA SERRETA,08184,081846,RUBÍ,60,36,96
2021/2022,08053194,EOI DE TERRASSA,08279,082798,TERRASSA,15,9,24
2021/2022,08053200,INSTITUT MIQUEL CRUSAFONT I PAIRÓ,08187,081878,SABADELL,32,15,47
2021/2022,08053212,INSTITUT JONQUERES,08187,081878,SABADELL,38,21,59
2021/2022,08053224,INSTITUT LES TERMES,08187,081878,SABADELL,33,15,48
2021/2022,08053236,INSTITUT ROVIRA-FORNS,08260,082606,SANTA PERPÈTUA DE MOGODA,36,26,62
2021/2022,08053248,INSTITUT DE SENTMENAT,08267,082671,SENTMENAT,33,18,51
2021/2022,08053251,INSTITUT CAVALL BERNAT,08279,082798,TERRASSA,51,37,88
2021/2022,08053261,INSTITUT DE VILADECAVALLS,08300,083008,VILADECAVALLS,42,24,66
2021/2022,08053285,INSTITUT EL CASTELL,08076,080765,ESPARREGUERA,45,29,74
2021/2022,08053297,INSTITUT DE PALLEJÀ,08157,081574,PALLEJÀ,35,24,59
2021/2022,08053315,INSTITUT MONTSERRAT ROIG,08196,081960,SANT ANDREU DE LA BARCA,37,25,62
2021/2022,08053340,INSTITUT GABRIELA MISTRAL,08263,082634,SANT VICENÇ DELS HORTS,53,40,93
2021/2022,08053352,INSTITUT MONTBUI,08250,082508,SANTA MARGARIDA DE MONTBUI,41,25,66
2021/2022,08053364,INSTITUT JOSEP MESTRES I BUSQUETS,08301,083015,VILADECANS,36,19,55
2021/2022,08053391,ESCOLA LLEDONER,08096,080961,GRANOLLERS,24,9,33
2021/2022,08053406,ESCOLA CAN BESORA,08124,081249,MOLLET DEL VALLÈS,25,3,28
2021/2022,08053421,ESCOLA ALOC,08163,081635,PINEDA DE MAR,18,5,23
2021/2022,08053431,ESCOLA EL ROURE,08168,081688,PONTONS,3,2,5
2021/2022,08053443,EOI SANTA COLOMA,08245,082457,SANTA COLOMA DE GRAMENET,7,7,14
2021/2022,08053455,ESCOLA LES AIGÜES,08046,080462,CARDEDEU,28,4,32
2021/2022,08053467,ESCOLA PALAU,08156,081568,PALAU-SOLITÀ I PLEGAMANS,25,5,30
2021/2022,08053492,ESCOLA TERESA CLARAMUNT,08187,081878,SABADELL,30,3,33
2021/2022,08053510,ESCOLA PUIG D'AGULLES,08072,080728,CORBERA DE LLOBREGAT,15,3,18
2021/2022,08053522,ESCOLA LA GINESTA,08295,082956,VALLIRANA,16,1,17
2021/2022,08053571,INST-ESC ART. ORIOL MARTORELL,08019,080193,BARCELONA,91,49,140
2021/2022,08053583,ESCOLA MARIA OSSÓ,08270,082704,SITGES,31,1,32
2021/2022,08053601,ESCOLA LOLA ANGLADA,08114,081141,MARTORELL,31,4,35
2021/2022,08053650,ESCOLA TURÓ DE GUIERA,08266,082665,CERDANYOLA DEL VALLÈS,25,7,32
2021/2022,08054022,ESCOLA MARINADA,08019,080193,BARCELONA,18,1,19
2021/2022,08054034,INSTITUT GALLECS,08124,081249,MOLLET DEL VALLÈS,71,47,118
2021/2022,08054058,ESCOLA TORRE DE LA MIRANDA,08073,080734,CORNELLÀ DE LLOBREGAT,34,5,39
2021/2022,08054061,ESCOLA MONTBAIG,08200,082009,SANT BOI DE LLOBREGAT,16,5,21
2021/2022,08054113,ESCOLA ANXANETA,08121,081213,MATARÓ,28,5,33
2021/2022,08054174,INSTITUT LA RIBERA,08125,081252,MONTCADA I REIXAC,29,14,43
2021/2022,08054186,INSTITUT CAN MAS,08180,081803,RIPOLLET,36,18,54
2021/2022,08054198,INSTITUT ESTANY DE LA RICARDA,08169,081691,EL PRAT DE LLOBREGAT,29,15,44
2021/2022,08054228,INSTITUT JOAN FUSTER,08019,080193,BARCELONA,33,11,44
2021/2022,08054241,INSTITUT EUGENI XAMMAR,08005,080057,L'AMETLLA DEL VALLÈS,27,16,43
2021/2022,08054277,INSTITUT DE TONA,08283,082830,TONA,42,24,66
2021/2022,08054344,EOI ESPLUGUES,08077,080771,ESPLUGUES DE LLOBREGAT,12,3,15
2021/2022,08054368,CEE CA N'ORIOL,08184,081846,RUBÍ,19,2,21
2021/2022,08054401,INSTITUT EL SUI,08046,080462,CARDEDEU,36,20,56
2021/2022,08054411,ESCOLA VALLGORGUINA,08294,082943,VALLGORGUINA,12,2,14
2021/2022,08054824,ESCOLA MESTRE PLA,08051,080517,CASTELLAR DEL VALLÈS,14,2,16
2021/2022,08054873,INSTITUT JOAQUIMA PLA I FARRERAS,08205,082055,SANT CUGAT DEL VALLÈS,47,15,62
2021/2022,08054903,ESCOLA MEDITERRÀNIA,08019,080193,BARCELONA,18,5,23
2021/2022,08055002,CFA BARRI GÒTIC,08019,080193,BARCELONA,6,2,8
2021/2022,08055041,CFA CANOVELLES,08041,080410,CANOVELLES,5,4,9
2021/2022,08055051,CFA CASTELLDEFELS,08056,080569,CASTELLDEFELS,4,4,8
2021/2022,08055063,CFA CANYELLES,08019,080193,BARCELONA,4,2,6
2021/2022,08055075,CFA TORRE ROMEU,08187,081878,SABADELL,5,1,6
2021/2022,08055105,ESCOLA ARRAONA,08187,081878,SABADELL,21,4,25
2021/2022,08055385,CFA MOLLET DEL VALLÈS,08124,081249,MOLLET DEL VALLÈS,6,3,9
2021/2022,08055397,CFA JAUME TUSET,08180,081803,RIPOLLET,8,4,12
2021/2022,08055403,CFA SANT ROC,08015,080155,BADALONA,5,3,8
2021/2022,08055439,CFA MESTRE ESTEVE,08211,082114,SANT FELIU DE LLOBREGAT,4,4,8
2021/2022,08055440,CFA GARROSA,08263,082634,SANT VICENÇ DELS HORTS,6,4,10
2021/2022,08055683,CFA MANUEL SACRISTÁN,08019,080193,BARCELONA,6,6,12
2021/2022,08055695,CFA RAFAEL FARRÉ,08123,081234,MOLINS DE REI,2,4,6
2021/2022,08055713,CFA SANT CUGAT DEL VALLÈS,08205,082055,SANT CUGAT DEL VALLÈS,6,1,7
2021/2022,08055889,ESCOLA MIQUEL MARTÍ I POL,08187,081878,SABADELL,30,3,33
2021/2022,08055890,ESCOLA SOBIRANS,08007,080076,ARENYS DE MUNT,25,2,27
2021/2022,08055907,ESCOLA MIQUEL MARTÍ I POL,08107,081075,LLIÇÀ D'AMUNT,12,5,17
2021/2022,08055932,ESCOLA TORRENT DE CAN CARABASSA,08019,080193,BARCELONA,26,6,32
2021/2022,08055944,INSTITUT RUBIÓ I ORS,08101,081017,L'HOSPITALET DE LLOBREGAT,27,17,44
2021/2022,08056109,INSTITUT CAN VILUMARA,08101,081017,L'HOSPITALET DE LLOBREGAT,64,27,91
2021/2022,08056560,CFA BARBERÀ,08252,082520,BARBERÀ DEL VALLÈS,6,3,9
2021/2022,08056572,CFA TERRA BAIXA,08169,081691,EL PRAT DE LLOBREGAT,5,7,12
2021/2022,08056584,CFA L'ALZINA DE CERDANYOLA,08266,082665,CERDANYOLA DEL VALLÈS,7,3,10
2021/2022,08056614,ESCOLA CIRERA,08121,081213,MATARÓ,22,3,25
2021/2022,08056729,ZER EL MOIANÈS PONENT,08034,080348,CALDERS,3,1,4
2021/2022,08056742,ZER ALT LLUÇANÈS,08201,082016,SANT BOI DE LLUÇANÈS,1,2,3
2021/2022,08056766,ZER SUBIRATS,08273,082732,SUBIRATS,3,0,3
2021/2022,08056781,ZER SERRA D'ANCOSA,08104,081043,LA LLACUNA,2,2,4
2021/2022,08056791,ZER VENT D'AVALL,08170,081705,ELS PRATS DE REI,3,1,4
2021/2022,08056811,ZER ALT BERGUEDÀ,08293,082938,VALLCEBRE,2,1,3
2021/2022,08056833,ZER BAIX MONTSENY,08259,082592,SANTA MARIA DE PALAUTORDERA,3,1,4
2021/2022,08056857,ZER GAVARRESA,08212,082129,SANT FELIU SASSERRA,4,0,4
2021/2022,08056985,INSTITUT RAMON BERENGUER IV,08245,082457,SANTA COLOMA DE GRAMENET,45,28,73
2021/2022,08056997,CFA LA CONCÒRDIA,08187,081878,SABADELL,9,7,16
2021/2022,08057001,CFA LA CREU DE BARBERÀ,08187,081878,SABADELL,5,3,8
2021/2022,08057011,CFA CAN RULL,08187,081878,SABADELL,6,3,9
2021/2022,08057096,ESCOLA GUILLEM DE MONT-RODON,08298,082981,VIC,31,5,36
2021/2022,08057102,ESCOLA ANDERSEN,08298,082981,VIC,34,4,38
2021/2022,08057163,CFA TERESA MAÑÉ,08307,083073,VILANOVA I LA GELTRÚ,8,6,14
2021/2022,08057229,ESCOLA ELS ARENYS,08054,080543,CASTELLBISBAL,16,3,19
2021/2022,08057230,INSTITUT CUBELLES,08074,080749,CUBELLES,42,14,56
2021/2022,08057242,ESCOLA SERENA VALL,08197,081976,SANT ANDREU DE LLAVANERES,28,3,31
2021/2022,08057254,INSTITUT PERE RIBOT,08219,082191,VILASSAR DE MAR,30,15,45
2021/2022,08057266,ESCOLA ELS CINGLES,08005,080057,L'AMETLLA DEL VALLÈS,19,2,21
2021/2022,08057281,ZER CEP DE SIS,08249,082495,SANTA FE DEL PENEDÈS,3,1,4
2021/2022,08057540,INSTITUT JOAN BROSSA,08019,080193,BARCELONA,44,38,82
2021/2022,08057667,CFA TRINITAT VELLA,08019,080193,BARCELONA,2,3,5
2021/2022,08057679,CFA BELLVITGE-GORNAL,08101,081017,L'HOSPITALET DE LLOBREGAT,8,3,11
2021/2022,08057734,ESCOLA ANTONI GAUDÍ,08250,082508,SANTA MARGARIDA DE MONTBUI,31,5,36
2021/2022,08057874,CFA CATALÒNIA,08101,081017,L'HOSPITALET DE LLOBREGAT,7,2,9
2021/2022,08057965,CFA CAN SERRA,08101,081017,L'HOSPITALET DE LLOBREGAT,9,2,11
2021/2022,08058076,ZER ELS CASTELLS,08131,081311,MONTESQUIU,3,1,4
2021/2022,08058088,ZER BERGUEDÀ CENTRE,08299,082994,VILADA,3,0,3
2021/2022,08058091,ZER BAIX BERGUEDÀ,08144,081445,OLVAN,4,0,4
2021/2022,08058209,CFA SANT BOI,08200,082009,SANT BOI DE LLOBREGAT,7,5,12
2021/2022,08058210,CFA BADIA DEL VALLÈS,08904,089045,BADIA DEL VALLÈS,2,0,2
2021/2022,08058362,ESCOLA RIERA DE RIBES,08231,082310,SANT PERE DE RIBES,25,5,30
2021/2022,08058374,ESCOLA ELS ALOCS,08219,082191,VILASSAR DE MAR,16,2,18
2021/2022,08058404,INSTITUT CIRVIÀNUM DE TORELLÓ,08285,082858,TORELLÓ,46,26,72
2021/2022,08058416,ESCOLA L'ARENAL DE LLEVANT,08019,080193,BARCELONA,27,4,31
2021/2022,08058428,INSTITUT BISAURA,08237,082378,SANT QUIRZE DE BESORA,13,6,19
2021/2022,08058441,ESCOLA GIROI,08088,080885,LA GARRIGA,20,3,23
2021/2022,08058465,ESCOLA ENXANETA,08279,082798,TERRASSA,42,5,47
2021/2022,08058519,ESCOLA SINERA,08006,080060,ARENYS DE MAR,25,5,30
2021/2022,08058520,INSTITUT PUIG DE LA CREU,08051,080517,CASTELLAR DEL VALLÈS,37,14,51
2021/2022,08058775,INSTITUT FRONT MARÍTIM,08019,080193,BARCELONA,33,15,48
2021/2022,08058817,ZER TRES BRANQUES,08063,080636,CASTELLOLÍ,2,2,4
2021/2022,08058957,ESCOLA ELS COSTERETS,08231,082310,SANT PERE DE RIBES,26,2,28
2021/2022,08058969,INSTITUT EL VERN,08108,081081,LLIÇÀ DE VALL,27,6,33
2021/2022,08059044,CFA LA LLAGOSTA,08105,081056,LA LLAGOSTA,8,2,10
2021/2022,08059093,ESCOLA D'HORTSAVINYÀ,08284,082845,TORDERA,4,3,7
2021/2022,08059287,ZER GUILLERIES,17220,172207,VILADRAU,2,2,4
2021/2022,08059329,INSTITUT CAN PEIXAUET,08245,082457,SANTA COLOMA DE GRAMENET,36,30,66
2021/2022,08059354,ESCOLA LES ROQUES BLAVES,08076,080765,ESPARREGUERA,20,2,22
2021/2022,08059524,INSTITUT DE NAVARCLES,08140,081402,NAVARCLES,13,11,24
2021/2022,08059551,EOI DE MANRESA,08113,081136,MANRESA,12,1,13
2021/2022,08059639,ESCOLA PROGRÉS,08015,080155,BADALONA,28,5,33
2021/2022,08059688,INSTITUT MARIA AURÈLIA CAPMANY,08073,080734,CORNELLÀ DE LLOBREGAT,40,21,61
2021/2022,08059691,CFA ANNA MURIÀ,08279,082798,TERRASSA,10,2,12
2021/2022,08059706,CFA SALVADOR ESPRIU,08279,082798,TERRASSA,4,2,6
2021/2022,08059721,ESCOLA MARTA MATA,08301,083015,VILADECANS,33,2,35
2021/2022,08059731,CFA ARQUITECTE JUJOL,08217,082172,SANT JOAN DESPÍ,10,3,13
2021/2022,08059755,ESCOLA LA FONT,08113,081136,MANRESA,30,7,37
2021/2022,08059767,ESCOLA TANIT,08245,082457,SANTA COLOMA DE GRAMENET,20,2,22
2021/2022,08059780,ESCOLA BELLAVISTA-JOAN CAMPS I GIRÓ,08086,080863,LES FRANQUESES DEL VALLÈS,24,5,29
2021/2022,08059792,ESCOLA MOGENT,08136,081363,MONTORNÈS DEL VALLÈS,28,4,32
2021/2022,08059809,ESCOLA EL ROURE,08209,082093,SANT FOST DE CAMPSENTELLES,16,0,16
2021/2022,08059810,ESCOLA VINYA DEL SASTRET,08208,082080,SANT ESTEVE SESROVIRES,14,3,17
2021/2022,08059822,ESCOLA ERNEST LLUCH,08001,080018,ABRERA,28,3,31
2021/2022,08059871,ESCOLA GERBERT D'ORLHAC,08205,082055,SANT CUGAT DEL VALLÈS,30,4,34
2021/2022,08059998,ESCOLA LA PAU,08240,082401,SANT SADURNÍ D'ANOIA,29,3,32
2021/2022,08060009,INSTITUT MANUEL CARRASCO I FORMIGUERA,08210,082107,SANT FELIU DE CODINES,12,10,22
2021/2022,08060095,CFA MONTSENY,08298,082981,VIC,7,3,10
2021/2022,08060113,CFA JACINT CARRIÓ I VILASECA,08113,081136,MANRESA,8,5,13
2021/2022,08060137,CFA EDÈLIA HERNÁNDEZ,08301,083015,VILADECANS,7,4,11
2021/2022,08060204,CFA GRAN SOL,08015,080155,BADALONA,7,5,12
2021/2022,08060216,CFA MORERA POMAR,08015,080155,BADALONA,9,2,11
2021/2022,08060228,CFA EL CLOT,08019,080193,BARCELONA,6,5,11
2021/2022,08060231,CFA PEGASO,08019,080193,BARCELONA,8,2,10
2021/2022,08060253,CFA CAN MARFÀ,08121,081213,MATARÓ,10,2,12
2021/2022,08060265,CFA PREMIÀ DE MAR,08172,081727,PREMIÀ DE MAR,2,5,7
2021/2022,08060277,CFA PAU CASALS,08184,081846,RUBÍ,6,5,11
2021/2022,08060289,CFA FONDO,08245,082457,SANTA COLOMA DE GRAMENET,6,7,13
2021/2022,08060290,CFA SINGUERLÍN,08245,082457,SANTA COLOMA DE GRAMENET,6,4,10
2021/2022,08060319,ESCOLA LES FONTS,08009,080095,ARGENTONA,22,3,25
2021/2022,08060411,CFA SANTS-SANT RAIMON DE PENYAFORT,08019,080193,BARCELONA,2,4,6
2021/2022,08060423,ESCOLA MAS PRATS,08155,081555,PALAFOLLS,28,2,30
2021/2022,08060484,ESCOLA TAULA RODONA,08238,082384,SANT QUIRZE DEL VALLÈS,26,5,31
2021/2022,08060514,INSTITUT DE MASQUEFA,08119,081192,MASQUEFA,36,22,58
2021/2022,08060526,ESCOLA CREIXÀ,08161,081614,PIERA,8,5,13
2021/2022,08060538,EOI DEL PRAT DE LLOBREGAT,08169,081691,EL PRAT DE LLOBREGAT,9,2,11
2021/2022,08060599,ESCOLA GARIGOT,08056,080569,CASTELLDEFELS,25,4,29
2021/2022,08060605,ESCOLA FONT DEL ROURE,08119,081192,MASQUEFA,26,5,31
2021/2022,08060629,ESCOLA EL CORB,08072,080728,CORBERA DE LLOBREGAT,17,1,18
2021/2022,08060757,ESCOLA JOAN TORREDEMER CANELA,08120,081206,MATADEPERA,31,1,32
2021/2022,08060836,ESCOLA TURÓ DEL DRAC,08040,080403,CANET DE MAR,27,5,32
2021/2022,08060848,ESCOLA DE SANT ANDREU DE LA BARCA,08196,081960,SANT ANDREU DE LA BARCA,24,6,30
2021/2022,08060851,ESCOLA L'OLIVERA,08295,082956,VALLIRANA,21,6,27
2021/2022,08060873,ESCOLA EULÀLIA BOTA,08019,080193,BARCELONA,28,5,33
2021/2022,08060903,ESCOLA EL COLOMER,08023,080235,BIGUES I RIELLS,26,4,30
2021/2022,08060915,INSTITUT MARIA DE BELL-LLOC,08023,080235,BIGUES I RIELLS,28,20,48
2021/2022,08060927,ESCOLA VORA DEL MAR,08074,080749,CUBELLES,32,2,34
2021/2022,08060939,ESCOLA GUERAU DE LIOST,08086,080863,LES FRANQUESES DEL VALLÈS,25,6,31
2021/2022,08060940,ESCOLA ROSA ORIOL ANGUERA,08107,081075,LLIÇÀ D'AMUNT,25,3,28
2021/2022,08060952,ESCOLA ELS VINYALS,08108,081081,LLIÇÀ DE VALL,14,2,16
2021/2022,08060964,ESCOLA QUATRE VENTS,08112,081120,MANLLEU,39,4,43
2021/2022,08060976,INSTITUT DEL VOLTREGANÈS,08117,081173,LES MASIES DE VOLTREGÀ,27,10,37
2021/2022,08060988,ESCOLA CAL MÚSIC,08124,081249,MOLLET DEL VALLÈS,20,4,24
2021/2022,08060991,ESCOLA MOGENT,08181,081810,LA ROCA DEL VALLÈS,25,2,27
2021/2022,08061002,ESCOLA LES PARELLADES,08231,082310,SANT PERE DE RIBES,11,7,18
2021/2022,08061014,INSTITUT VINYET,08270,082704,SITGES,33,16,49
2021/2022,08061026,ESCOLA LA FALGUERA,08902,089024,VILANOVA DEL VALLÈS,15,2,17
2021/2022,08061038,INSTITUT DE VILANOVA DEL VALLÈS,08902,089024,VILANOVA DEL VALLÈS,25,24,49
2021/2022,08061041,ESCOLA SANT JORDI,08307,083073,VILANOVA I LA GELTRÚ,29,5,34
2021/2022,08061051,ESCOLA ÍTACA,08307,083073,VILANOVA I LA GELTRÚ,24,5,29
2021/2022,08061063,ESCOLA LA SERRETA,08003,080039,ALELLA,16,2,18
2021/2022,08061087,ESCOLA MARINA,08126,081265,MONTGAT,27,3,30
2021/2022,08061099,INSTITUT FONT DEL FERRO,08155,081555,PALAFOLLS,42,17,59
2021/2022,08061105,ESCOLA SOT DEL CAMP,08264,082649,SANT VICENÇ DE MONTALT,25,0,25
2021/2022,08061117,INSTITUT TURÓ D'EN BALDIRI,08281,082819,TEIÀ,16,9,25
2021/2022,08061129,INSTITUT MONTSERRAT COLOMER,08208,082080,SANT ESTEVE SESROVIRES,39,15,54
2021/2022,08061142,ESCOLA MIQUEL MARTÍ I POL,08252,082520,BARBERÀ DEL VALLÈS,29,3,32
2021/2022,08061154,ESCOLA CA N'ALZAMORA,08184,081846,RUBÍ,32,3,35
2021/2022,08061166,ESCOLA DE CAN LLONG,08187,081878,SABADELL,26,6,32
2021/2022,08061178,ESCOLA TURÓ DE CAN MATES,08205,082055,SANT CUGAT DEL VALLÈS,30,3,33
2021/2022,08061191,ESCOLA FONT DE L'ORPINA,08291,082917,VACARISSES,15,2,17
2021/2022,08061208,INSTITUT VACARISSES,08291,082917,VACARISSES,27,22,49
2021/2022,08061221,CFA VALLÈS,08096,080961,GRANOLLERS,8,4,12
2021/2022,08061348,ESCOLA BUFALÀ,08015,080155,BADALONA,32,3,35
2021/2022,08061361,INSTITUT TORRELLES DE LLOBREGAT,08289,082896,TORRELLES DE LLOBREGAT,14,13,27
2021/2022,08061521,ESCOLA VALL DE NÉSPOLA - ZER EL MOIANÈS PONENT,08139,081398,MURA,6,0,6
2021/2022,08061543,ESCOLA ROSER CAPDEVILA,08167,081672,POLINYÀ,24,5,29
2021/2022,08061555,CFA CAN FOLGUERA,08260,082606,SANTA PERPÈTUA DE MOGODA,5,2,7
2021/2022,08061580,CFA LLOREDA-LA PAU,08015,080155,BADALONA,4,2,6
2021/2022,08061609,ESCOLA MERCÈ RODOREDA,08114,081141,MARTORELL,35,1,36
2021/2022,08061610,ESCOLA LA SÍNIA,08123,081234,MOLINS DE REI,23,7,30
2021/2022,08061622,ESCOLA CAN COLL,08289,082896,TORRELLES DE LLOBREGAT,16,2,18
2021/2022,08061683,CFA PALAU DE MAR,08019,080193,BARCELONA,4,4,8
2021/2022,08061701,CFA MARIA RUBIES,08019,080193,BARCELONA,6,3,9
2021/2022,08061725,EOI BARCELONA III,08019,080193,BARCELONA,7,4,11
2021/2022,08061762,ESCOLA MAS MARIA,08030,080305,CABRILS,21,4,25
2021/2022,08061774,ESCOLA LES ARENES,08279,082798,TERRASSA,26,8,34
2021/2022,08061907,CFA BARCELONETA,08019,080193,BARCELONA,6,1,7
2021/2022,08061919,CFA RIUS I TAULET,08019,080193,BARCELONA,7,2,9
2021/2022,08061932,CFA BON PASTOR,08019,080193,BARCELONA,4,4,8
2021/2022,08061944,CFA MADRID,08019,080193,BARCELONA,5,0,5
2021/2022,08061956,CFA PROSPERITAT,08019,080193,BARCELONA,3,2,5
2021/2022,08061968,CFA LES CORTS,08019,080193,BARCELONA,6,1,7
2021/2022,08061971,CFA BERGUEDÀ,08022,080229,BERGA,5,1,6
2021/2022,08061993,CFA EUGENI D'ORS,08077,080771,ESPLUGUES DE LLOBREGAT,7,3,10
2021/2022,08062018,CFA ANOIA,08102,081022,IGUALADA,1,3,4
2021/2022,08062021,CFA MONTCADA I REIXAC,08125,081252,MONTCADA I REIXAC,4,3,7
2021/2022,08062031,CFA MARE DE DÉU DE MONTSERRAT,08147,081477,OLESA DE MONTSERRAT,4,1,5
2021/2022,08062043,CFA PARETS DEL VALLÈS,08159,081593,PARETS DEL VALLÈS,1,3,4
2021/2022,08062055,CFA SANT JUST DESVERN,08221,082212,SANT JUST DESVERN,1,3,4
2021/2022,08062079,CFA RAMON LLULL,08279,082798,TERRASSA,4,1,5
2021/2022,08062080,CFA EGARA,08279,082798,TERRASSA,8,2,10
2021/2022,08062092,CFA VILAFRANCA DEL PENEDÈS,08305,083054,VILAFRANCA DEL PENEDÈS,4,5,9
2021/2022,08062109,AFA CIUTAT MERIDIANA,08019,080193,BARCELONA,3,4,7
2021/2022,08062110,CFA SANFELIU,08101,081017,L'HOSPITALET DE LLOBREGAT,2,4,6
2021/2022,08062122,CFA MARTORELL,08114,081141,MARTORELL,3,5,8
2021/2022,08062146,CFA LA VERNEDA,08019,080193,BARCELONA,4,4,8
2021/2022,08062158,EOI DE MARTORELL,08114,081141,MARTORELL,5,3,8
2021/2022,08062161,EOI DE SANT CUGAT DEL VALLÈS,08205,082055,SANT CUGAT DEL VALLÈS,7,2,9
2021/2022,08062171,EOI D'IGUALADA,08102,081022,IGUALADA,7,1,8
2021/2022,08062183,EOI OSONA,08298,082981,VIC,5,2,7
2021/2022,08062195,EOI BARCELONA IV,08019,080193,BARCELONA,9,4,13
2021/2022,08062201,EOI BARCELONA V,08019,080193,BARCELONA,7,1,8
2021/2022,08062213,EOI VALLÈS ORIENTAL,08096,080961,GRANOLLERS,4,4,8
2021/2022,08062225,EOI GARRAF,08307,083073,VILANOVA I LA GELTRÚ,6,3,9
2021/2022,08062249,CFA EL CARMEL,08019,080193,BARCELONA,5,4,9
2021/2022,08062250,CFA TORRENT D'EN MELIS,08019,080193,BARCELONA,4,1,5
2021/2022,08062262,CFA MONTSERRAT ROIG,08019,080193,BARCELONA,6,1,7
2021/2022,08062331,CFA PERE CALDERS,08019,080193,BARCELONA,5,4,9
2021/2022,08062468,CFA BELLAVISTA,08086,080863,LES FRANQUESES DEL VALLÈS,2,2,4
2021/2022,08062471,CFA GAVÀ,08089,080898,GAVÀ,3,3,6
2021/2022,08062481,CFA SANT JOSEP,08101,081017,L'HOSPITALET DE LLOBREGAT,5,1,6
2021/2022,08062493,CFA SANT RAMON,08101,081017,L'HOSPITALET DE LLOBREGAT,5,2,7
2021/2022,08062511,CFA ALARONA,08121,081213,MATARÓ,4,2,6
2021/2022,08062523,CFA MARINADA,08136,081363,MONTORNÈS DEL VALLÈS,2,2,4
2021/2022,08062614,ESCOLA JOAN BLANQUER,08051,080517,CASTELLAR DEL VALLÈS,16,2,18
2021/2022,08062626,ESCOLA COLLSEROLA,08266,082665,CERDANYOLA DEL VALLÈS,15,1,16
2021/2022,08062638,ESCOLA LA TRAMA,08187,081878,SABADELL,23,3,26
2021/2022,08062641,ESCOLA L'OLIVERA,08205,082055,SANT CUGAT DEL VALLÈS,30,4,34
2021/2022,08062675,ESCOLA PERE IV,08019,080193,BARCELONA,29,3,32
2021/2022,08062687,ESCOLA PONENT,08279,082798,TERRASSA,29,3,32
2021/2022,08062705,ESCOLA LA CABANA,08027,080272,LES CABANYES,12,3,15
2021/2022,08062717,INSTITUT CABRILS,08030,080305,CABRILS,21,15,36
2021/2022,08062729,INSTITUT PLA MARCELL,08046,080462,CARDEDEU,49,16,65
2021/2022,08062730,INSTITUT ELS ROURES,08075,080752,DOSRIUS,16,9,25
2021/2022,08062742,ESCOLA BENVIURE,08054,080543,CASTELLBISBAL,16,2,18
2021/2022,08062754,ESCOLA LES FONTS,08091,080919,GELIDA,24,4,28
2021/2022,08062778,ESCOLA AMETLLERS,08218,082188,SANT JOAN DE VILATORRADA,26,1,27
2021/2022,08062781,ESCOLA MEDITERRÀNIA,08231,082310,SANT PERE DE RIBES,24,3,27
2021/2022,08062791,INSTITUT VILAMAJOR,08234,082346,SANT PERE DE VILAMAJOR,31,17,48
2021/2022,08062808,INSTITUT ESTEVE ALBERT,08264,082649,SANT VICENÇ DE MONTALT,29,19,48
2021/2022,08062811,ESCOLA MATAGALLS,08259,082592,SANTA MARIA DE PALAUTORDERA,14,3,17
2021/2022,08062833,ESCOLA AGNÈS DE SITGES,08270,082704,SITGES,16,1,17
2021/2022,08062857,INSTITUT TIANA,08282,082824,TIANA,31,10,41
2021/2022,08062869,ESCOLA SERRA DE MIRALLES,08284,082845,TORDERA,17,2,19
2021/2022,08062870,INSTITUT LA PLANA,08298,082981,VIC,38,17,55
2021/2022,08062924,ESCOLA JOSEP GUINOVART,08056,080569,CASTELLDEFELS,15,3,18
2021/2022,08062948,ESCOLA MIQUEL MARTÍ I POL,08301,083015,VILADECANS,35,5,40
2021/2022,08063072,ESCOLA FRUCTUÓS GELABERT,08019,080193,BARCELONA,29,2,31
2021/2022,08063229,INSTITUT MONTPEDRÓS,08244,082444,SANTA COLOMA DE CERVELLÓ,38,21,59
2021/2022,08063394,ESCOLA MIQUEL MARTÍ I POL,08211,082114,SANT FELIU DE LLOBREGAT,30,2,32
2021/2022,08063618,CFA ESPARREGUERA,08076,080765,ESPARREGUERA,3,2,5
2021/2022,08063621,CFA MARTÍ I POL,08112,081120,MANLLEU,3,2,5
2021/2022,08063643,CFA LA COOPERATIVA,08285,082858,TORELLÓ,1,2,3
2021/2022,08063710,ESCOLA ESCOLA NOVA,08068,080689,CERVELLÓ,17,2,19
2021/2022,08063734,ESCOLA PUIGVENTÓS,08147,081477,OLESA DE MONTSERRAT,25,5,30
2021/2022,08063758,ESCOLA CAN SALVI,08196,081960,SANT ANDREU DE LA BARCA,29,3,32
2021/2022,08063761,ESCOLA VICENTE FERRER,08200,082009,SANT BOI DE LLOBREGAT,15,3,18
2021/2022,08063771,ESCOLA PLA DE LES VINYES,08244,082444,SANTA COLOMA DE CERVELLÓ,20,3,23
2021/2022,08063783,ESCOLA MEDITERRÀNIA,08301,083015,VILADECANS,15,3,18
2021/2022,08063795,ESCOLA MARTA MATA,08302,083020,VILANOVA DEL CAMÍ,13,3,16
2021/2022,08063801,INSTITUT DE COLLBATÓ,08069,080692,COLLBATÓ,24,10,34
2021/2022,08063813,INSTITUT CREU DE SABA,08147,081477,OLESA DE MONTSERRAT,33,17,50
2021/2022,08063837,INSTITUT LES MARGUES,08037,080370,CALLDETENES,29,9,38
2021/2022,08063862,ESCOLA L'OLIVAR,08062,080620,CASTELLNOU DE BAGES,12,4,16
2021/2022,08063874,ESCOLA ANTONIO MACHADO,08121,081213,MATARÓ,26,5,31
2021/2022,08063886,ESCOLA ARRELS,08251,082515,SANTA MARGARIDA I ELS MONJOS,17,1,18
2021/2022,08063898,ESCOLA LA SÈQUIA,08113,081136,MANRESA,28,6,34
2021/2022,08063904,INSTITUT MONTGRÒS,08231,082310,SANT PERE DE RIBES,28,16,44
2021/2022,08063916,ESCOLA VILA PARIETES,08159,081593,PARETS DEL VALLÈS,15,3,18
2021/2022,08063928,ESCOLA MUNTANYOLA,08129,081290,MUNTANYOLA,7,1,8
2021/2022,08063931,ESCOLA LES FALGUERES,08082,080826,FOGARS DE LA SELVA,14,1,15
2021/2022,08063965,ESCOLA CAU DE LA GUINEU,08072,080728,CORBERA DE LLOBREGAT,13,2,15
2021/2022,08064003,INSTITUT CAN MARGARIT,08072,080728,CORBERA DE LLOBREGAT,24,13,37
2021/2022,08064027,ESCOLA EL SOL I LA LLUNA,08051,080517,CASTELLAR DEL VALLÈS,20,4,24
2021/2022,08064076,ESCOLA RIVO RUBEO,08184,081846,RUBÍ,27,6,33
2021/2022,08064088,ESCOLA MAS BOADELLA,08187,081878,SABADELL,30,3,33
2021/2022,08064118,ESCOLA CIUTAT D'ALBA,08205,082055,SANT CUGAT DEL VALLÈS,31,3,34
2021/2022,08064131,ESCOLA ELS AIGÜEROLS,08260,082606,SANTA PERPÈTUA DE MOGODA,13,5,18
2021/2022,08064143,ESCOLA LA NOVA ELECTRA,08279,082798,TERRASSA,36,6,42
2021/2022,08064155,INSTITUT QUATRE CANTONS,08019,080193,BARCELONA,29,19,48
2021/2022,08064167,ESCOLA SANT MARTÍ,08019,080193,BARCELONA,28,3,31
2021/2022,08064179,ESCOLA LA LLACUNA DEL POBLENOU,08019,080193,BARCELONA,27,3,30
2021/2022,08064192,INSTITUT ANGELETA FERRER,08019,080193,BARCELONA,5,3,8
2021/2022,08064222,ESCOLA LA ROUREDA,08284,082845,TORDERA,27,3,30
2021/2022,08064623,CFA CONCEPCIÓ ARENAL,08019,080193,BARCELONA,3,1,4
2021/2022,08064635,CFA SANTIAGO RUSIÑOL,08181,081810,LA ROCA DEL VALLÈS,10,4,14
2021/2022,08064647,CFA ARTUR MARTORELL,08208,082080,SANT ESTEVE SESROVIRES,17,6,23
2021/2022,08064659,CFA SALVADOR DALÍ,08181,081810,LA ROCA DEL VALLÈS,16,7,23
2021/2022,08064738,ESCOLA DOLORS PIERA,08305,083054,VILAFRANCA DEL PENEDÈS,33,5,38
2021/2022,08064741,ESCOLA ÍTACA,08113,081136,MANRESA,29,4,33
2021/2022,08064751,ESCOLA MAR I CEL,08074,080749,CUBELLES,17,3,20
2021/2022,08064787,ESCOLA EMILI TEIXIDOR,08183,081831,RODA DE TER,18,0,18
2021/2022,08064805,ESCOLA ELS QUATRE VENTS,08041,080410,CANOVELLES,29,7,36
2021/2022,08064817,ESCOLA CAMINS,08086,080863,LES FRANQUESES DEL VALLÈS,29,3,32
2021/2022,08064829,ESCOLA VALLDENEU,08224,082248,SANT MARTÍ DE CENTELLES,8,0,8
2021/2022,08064830,INSTITUT SERRA DE NOET,08022,080229,BERGA,26,7,33
2021/2022,08064854,ESCOLA MARTINET,08073,080734,CORNELLÀ DE LLOBREGAT,22,8,30
2021/2022,08064866,ESCOLA DOLORS MARTÍ I BADIA,08102,081022,IGUALADA,26,3,29
2021/2022,08064881,ESCOLA CAMPDERRÓS,08295,082956,VALLIRANA,19,3,22
2021/2022,08064908,INSTITUT BEGUES,08020,080207,BEGUES,24,3,27
2021/2022,08064911,INSTITUT VALÈRIA HALINÉ,08056,080569,CASTELLDEFELS,18,16,34
2021/2022,08064921,INSTITUT DE SANT ANDREU,08196,081960,SANT ANDREU DE LA BARCA,24,9,33
2021/2022,08064945,ESCOLA MANSUET,08069,080692,COLLBATÓ,15,2,17
2021/2022,08064970,INSTITUT NOU DE VILAFRANCA DEL PENEDÈS,08305,083054,VILAFRANCA DEL PENEDÈS,28,24,52
2021/2022,08064982,ESCOLA DE SANT QUIRZE SAFAJA - ZER EL MOIANÈS LLEVANT,08239,082397,SANT QUIRZE SAFAJA,5,0,5
2021/2022,08064994,ESCOLA MARIA-MERCÈ MARÇAL,08121,081213,MATARÓ,27,4,31
2021/2022,08065007,ESCOLA POBLENOU,08163,081635,PINEDA DE MAR,14,3,17
2021/2022,08065019,INSTITUT DE VALLBONA D'ANOIA,08292,082922,VALLBONA D'ANOIA,17,7,24
2021/2022,08065238,ESCOLA LA SAGRERA,08248,082482,SANTA EULÀLIA DE RONÇANA,24,6,30
2021/2022,08065251,ESCOLA PLA DEL PUIG,08213,082135,SANT FRUITÓS DE BAGES,13,2,15
2021/2022,08065263,ESCOLA PUIGSOLER,08262,082628,SANT VICENÇ DE CASTELLET,20,3,23
2021/2022,08065275,ESCOLA VOLERANY,08307,083073,VILANOVA I LA GELTRÚ,26,4,30
2021/2022,08065287,ESCOLA MARTA MATA,08121,081213,MATARÓ,30,3,33
2021/2022,08065299,ESCOLA EL CALDERÍ,08033,080333,CALDES DE MONTBUI,16,0,16
2021/2022,08065305,ESCOLA SOLER DE VILARDELL,08202,082021,SANT CELONI,20,0,20
2021/2022,08065329,INSTITUT DE L'ALT FOIX,08227,082270,SANT MARTÍ SARROCA,27,15,42
2021/2022,08065330,INSTITUT CAL GRAVAT,08113,081136,MANRESA,39,21,60
2021/2022,08065342,INSTITUT XALOC,08231,082310,SANT PERE DE RIBES,17,8,25
2021/2022,08065354,INSTITUT BAIX A MAR,08307,083073,VILANOVA I LA GELTRÚ,38,15,53
2021/2022,08065366,INSTITUT DE PINEDA DE MAR,08163,081635,PINEDA DE MAR,34,15,49
2021/2022,08065391,INSTITUT EL TIL·LER,08086,080863,LES FRANQUESES DEL VALLÈS,38,13,51
2021/2022,08065408,INSTITUT HIPÀTIA D'ALEXANDRIA,08107,081075,LLIÇÀ D'AMUNT,17,6,23
2021/2022,08065411,INSTITUT AIGUAVIVA,08124,081249,MOLLET DEL VALLÈS,33,16,49
2021/2022,08065421,INSTITUT MARTA MATA,08136,081363,MONTORNÈS DEL VALLÈS,31,21,52
2021/2022,08065433,INSTITUT LA SÍNIA,08159,081593,PARETS DEL VALLÈS,16,6,22
2021/2022,08065469,INSTITUT CAN RECORD,08207,082074,SANT ESTEVE DE PALAUTORDERA,19,6,25
2021/2022,08065482,ESCOLA ELS VENTETS - ZER EL MOIANÈS LLEVANT,08070,080706,COLLSUSPINA,3,2,5
2021/2022,08065512,ESCOLA SERRA DE L'OBAC,08279,082798,TERRASSA,27,6,33
2021/2022,08065652,EOI DE L'ALT PENEDÈS,08305,083054,VILAFRANCA DEL PENEDÈS,4,3,7
2021/2022,08065664,EOI DEL BERGUEDÀ,08022,080229,BERGA,5,0,5
2021/2022,08066048,ESCOLA ROSER CAPDEVILA,08279,082798,TERRASSA,31,3,34
2021/2022,08066322,INSTITUT CARDENER,08218,082188,SANT JOAN DE VILATORRADA,17,8,25
2021/2022,08066334,ESCOLA LA SERRETA,08192,081923,SANTPEDOR,12,4,16
2021/2022,08066413,ESCOLA COLORS,08086,080863,LES FRANQUESES DEL VALLÈS,17,1,18
2021/2022,08066437,INSTITUT MONT PERDUT,08279,082798,TERRASSA,44,25,69
2021/2022,08066462,ESCOLA DELS ENCANTS,08019,080193,BARCELONA,26,6,32
2021/2022,08066504,ESCOLA L'UNIVERS,08019,080193,BARCELONA,26,1,27
2021/2022,08066516,ESCOLA CONGRÉS-INDIANS,08019,080193,BARCELONA,26,5,31
2021/2022,08066528,INSTITUT MARTÍ POUS,08019,080193,BARCELONA,25,18,43
2021/2022,08066531,ESCOLA FLUVIÀ,08019,080193,BARCELONA,29,3,32
2021/2022,08066541,INSTITUT MARIA ESPINALT,08019,080193,BARCELONA,29,24,53
2021/2022,08066565,INSTITUT 22@,08019,080193,BARCELONA,21,13,34
2021/2022,08066851,EOI DE MOLLET DEL VALLÈS,08124,081249,MOLLET DEL VALLÈS,4,4,8
2021/2022,08066887,EOI DE VILADECANS,08301,083015,VILADECANS,9,3,12
2021/2022,08066905,INSTITUT VILADOMAT,08019,080193,BARCELONA,23,18,41
2021/2022,08067016,ESCOLA ERNEST LLUCH,08101,081017,L'HOSPITALET DE LLOBREGAT,18,4,22
2021/2022,08067041,ESCOLA XORIGUER,08067,080673,CENTELLES,13,1,14
2021/2022,08067090,ESCOLA CAN MANENT,08046,080462,CARDEDEU,28,3,31
2021/2022,08067120,ESCOLA SANTA AGNÈS DE MALANYANES,08181,081810,LA ROCA DEL VALLÈS,13,1,14
2021/2022,08067132,ESCOLA JOSEFINA IBÁÑEZ,08001,080018,ABRERA,17,1,18
2021/2022,08067144,INSTITUT DE CERVELLÓ,08068,080689,CERVELLÓ,25,16,41
2021/2022,08067181,ESCOLA DE RELLINARS,08179,081799,RELLINARS,10,3,13
2021/2022,08067193,ESCOLA DEL BOSC,08184,081846,RUBÍ,17,3,20
2021/2022,08067201,ESCOLA LOLA ANGLADA,08238,082384,SANT QUIRZE DEL VALLÈS,26,2,28
2021/2022,08067211,INSTITUT SALAS I XANDRI,08238,082384,SANT QUIRZE DEL VALLÈS,16,7,23
2021/2022,08067235,ESCOLA ROC ALABERN,08279,082798,TERRASSA,31,6,37
2021/2022,08067247,ESCOLA EL VAPOR,08279,082798,TERRASSA,30,5,35
2021/2022,08067430,ESCOLA MONTSERRAT SOLÀ,08121,081213,MATARÓ,26,6,32
2021/2022,08067582,ESCOLA MARTA MATA,08252,082520,BARBERÀ DEL VALLÈS,15,3,18
2021/2022,08067594,INSTITUT ESCOLA LES VINYES,08054,080543,CASTELLBISBAL,37,11,48
2021/2022,08067636,INSTITUT MANRESA SIS,08113,081136,MANRESA,17,9,26
2021/2022,08067648,INSTITUT LES VINYES,08074,080749,CUBELLES,16,11,27
2021/2022,08067661,ESCOLA JOAN COROMINES,08121,081213,MATARÓ,30,2,32
2021/2022,08067752,INSTITUT SAGRERA SANT ANDREU,08019,080193,BARCELONA,17,9,26
2021/2022,08067764,ESCOLA LA MAQUINISTA,08019,080193,BARCELONA,27,5,32
2021/2022,08067818,ESCOLA LA SÍNIA,08298,082981,VIC,37,4,41
2021/2022,08068136,CFA VÍCTOR CATALÀ,08208,082080,SANT ESTEVE SESROVIRES,18,5,23
2021/2022,08068197,ZER EL CARDENER,08229,082299,SANT MATEU DE BAGES,3,1,4
2021/2022,08068331,ESCOLA BADALONA PORT,08015,080155,BADALONA,15,2,17
2021/2022,08068343,ESCOLA LES CIÈNCIES,08015,080155,BADALONA,12,5,17
2021/2022,08068379,ESCOLA MAR NOVA,08172,081727,PREMIÀ DE MAR,13,1,14
2021/2022,08068380,INSTITUT GURB,08100,081000,GURB,19,15,34
2021/2022,08068410,ESCOLA PALAU D'AMETLLA,08136,081363,MONTORNÈS DEL VALLÈS,11,6,17
2021/2022,08068495,INSTITUT JOSEFINA CASTELLVÍ I PIULACHS,08301,083015,VILADECANS,28,19,47
2021/2022,08068537,INSTITUT LES AIMERIGUES,08279,082798,TERRASSA,40,19,59
2021/2022,08068616,INSTITUT BAGES SUD,08053,080538,CASTELLBELL I EL VILAR,19,6,25
2021/2022,08069499,ESCOLA VIC-CENTRE,08298,082981,VIC,18,5,23
2021/2022,08069581,CFA CARME KARR,08218,082188,SANT JOAN DE VILATORRADA,14,1,15
2021/2022,08069736,ESCOLA PACO CANDEL,08101,081017,L'HOSPITALET DE LLOBREGAT,29,3,32
2021/2022,08069748,ESCOLA MONTIGALÀ,08015,080155,BADALONA,14,3,17
2021/2022,08069751,ESCOLA SANTA COLOMA,08245,082457,SANTA COLOMA DE GRAMENET,14,4,18
2021/2022,08070143,ESCOLA RIERA ALTA,08245,082457,SANTA COLOMA DE GRAMENET,27,5,32
2021/2022,08070234,ESCOLA CAN FABRA,08019,080193,BARCELONA,27,3,30
2021/2022,08070799,ESCOLA TIZIANA,08282,082824,TIANA,16,1,17
2021/2022,08070908,INSTITUT ESCOLA LA TORDERA,08259,082592,SANTA MARIA DE PALAUTORDERA,47,8,55
2021/2022,08071020,ESCOLA ENXANETA,08301,083015,VILADECANS,19,1,20
2021/2022,08071147,ESCOLA ROSER CAPDEVILA,08217,082172,SANT JOAN DESPÍ,20,4,24
2021/2022,08071196,INSTITUT CAN ROCA,08279,082798,TERRASSA,47,27,74
2021/2022,08071214,INSTITUT ESCOLA CASTELLTERÇOL,08064,080641,CASTELLTERÇOL,29,7,36
2021/2022,08071226,INSTITUT ESCOLA COSTA I LLOBERA,08019,080193,BARCELONA,45,20,65
2021/2022,08071238,INSTITUT ESCOLA JACINT VERDAGUER,08240,082401,SANT SADURNÍ D'ANOIA,43,19,62
2021/2022,08071421,ZER EL MOIANÈS LLEVANT,08239,082397,SANT QUIRZE SAFAJA,3,1,4
2021/2022,08071573,ESC.SUP.DISSENY ESDAP - CATALUNYA,08019,080193,BARCELONA,2,2,4
2021/2022,08071691,INSTITUT ESCOLA DEL PRAT,08169,081691,EL PRAT DE LLOBREGAT,22,9,31
2021/2022,08072176,INSTITUT DEL TER,08112,081120,MANLLEU,22,8,30
2021/2022,08072188,INSTITUT ESCOLA SANT JORDI,08141,081419,NAVÀS,45,10,55
2021/2022,08072255,INSTITUT PREMIÀ DE MAR,08172,081727,PREMIÀ DE MAR,47,62,109
2021/2022,08072292,INSTITUT ESCOLA TURÓ DE ROQUETES,08019,080193,BARCELONA,49,14,63
2021/2022,08072310,INSTITUT ESCOLA REC COMTAL,08019,080193,BARCELONA,43,8,51
2021/2022,08072383,INSTITUT DOMUS D'OLIVET,08041,080410,CANOVELLES,21,6,27
2021/2022,08072395,ESCOLA POLINYÀ,08167,081672,POLINYÀ,17,2,19
2021/2022,08072401,INSTITUT TORRENT DELS ALOUS,08184,081846,RUBÍ,46,20,66
2021/2022,08072589,EOI GUINARDÓ,08019,080193,BARCELONA,7,4,11
2021/2022,08072590,EOI DE RUBÍ,08184,081846,RUBÍ,6,1,7
2021/2022,08072607,EOI DE CORNELLÀ DE LLOBREGAT,08073,080734,CORNELLÀ DE LLOBREGAT,8,2,10
2021/2022,08072978,INSTITUT SUNSI MÓRA,08040,080403,CANET DE MAR,18,13,31
2021/2022,08073028,INSTITUT DE SANT POL DE MAR,08235,082359,SANT POL DE MAR,30,17,47
2021/2022,08073031,INSTITUT NEUS CATALÀ,08073,080734,CORNELLÀ DE LLOBREGAT,15,11,26
2021/2022,08073077,INSTITUT MARIA CANELA,08114,081141,MARTORELL,21,10,31
2021/2022,08073119,INSTITUT CAN PERIQUET,08156,081568,PALAU-SOLITÀ I PLEGAMANS,22,5,27
2021/2022,08073171,INSTITUT LA RIERA,08015,080155,BADALONA,18,10,28
2021/2022,08073193,INSTITUT BADIA I MARGARIT,08102,081022,IGUALADA,21,21,42
2021/2022,08073651,INSTITUT PIC DEL VENT,08033,080333,CALDES DE MONTBUI,17,7,24
2021/2022,08073843,INSTITUT TORDÀRIA,08284,082845,TORDERA,17,6,23
2021/2022,08073958,ESCOLA NOVA D'ARGENTONA,08009,080095,ARGENTONA,19,5,24
2021/2022,08073961,INSTITUT PLA DEL BOSC,08043,080431,CANYELLES,20,11,31
2021/2022,08074070,EOI DE CALELLA,08035,080351,CALELLA,4,3,7
2021/2022,08074380,ESCOLA CASTELL DE DOSRIUS,08075,080752,DOSRIUS,25,8,33
2021/2022,08074410,INSTITUT LA SERRA,08187,081878,SABADELL,18,9,27
2021/2022,08074628,INSTITUT EL PRAT DE LLOBREGAT,08169,081691,EL PRAT DE LLOBREGAT,10,11,21
2021/2022,08074631,INSTITUT LES SALINES,08169,081691,EL PRAT DE LLOBREGAT,56,47,103
2021/2022,08074641,ESCOLA 30 PASSOS,08019,080193,BARCELONA,20,4,24
2021/2022,08074801,INSTITUT MARTA ESTRADA,08096,080961,GRANOLLERS,19,7,26
2021/2022,08074811,ESCOLA TURÓ DE CAN GILI,08096,080961,GRANOLLERS,22,4,26
2021/2022,08074823,ESCOLA ELS PICOTS,08107,081075,LLIÇÀ D'AMUNT,24,4,28
2021/2022,08074835,ESCOLA JAUME LLULL,08197,081976,SANT ANDREU DE LLAVANERES,26,3,29
2021/2022,08074847,INSTITUT DE NÀUTICA DE BARCELONA,08019,080193,BARCELONA,8,21,29
2021/2022,08075074,INSTITUT DE SANTA COLOMA DE GRAMENET,08245,082457,SANTA COLOMA DE GRAMENET,23,13,36
2021/2022,08075207,ESCOLA ENTENÇA,08019,080193,BARCELONA,21,2,23
2021/2022,08075244,ESCOLA LES BASES,08113,081136,MANRESA,14,4,18
2021/2022,08075256,INSTITUT ESCOLA MARTA MATA,08285,082858,TORELLÓ,47,7,54
2021/2022,08075268,ESCOLA LA MIRADA,08205,082055,SANT CUGAT DEL VALLÈS,23,2,25
2021/2022,08075281,INSTITUT BITÀCOLA,08252,082520,BARBERÀ DEL VALLÈS,17,9,26
2021/2022,08075293,INSTITUT ESCOLA GAVÀ MAR,08089,080898,GAVÀ,48,11,59
2021/2022,08075384,INSTITUT ESCOLA LA MINA,08194,081944,SANT ADRIÀ DE BESÒS,47,27,74
2021/2022,08075608,ESCOLA 9 GRAONS,08019,080193,BARCELONA,11,6,17
2021/2022,08075611,ESCOLA GAIA,08019,080193,BARCELONA,21,2,23
2021/2022,08075621,ESCOLA TEIXIDORES DE GRÀCIA,08019,080193,BARCELONA,16,1,17
2021/2022,08075633,ESCOLA ANGLESOLA,08019,080193,BARCELONA,18,5,23
2021/2022,08075645,ESCOLA LA FLOR DE MAIG,08019,080193,BARCELONA,17,3,20
2021/2022,08075657,INSTITUT ESCOLA ANTAVIANA,08019,080193,BARCELONA,49,19,68
2021/2022,08075669,INSTITUT ESCOLA EL TIL·LER,08019,080193,BARCELONA,26,10,36
2021/2022,08075670,INSTITUT ESCOLA TRINITAT NOVA,08019,080193,BARCELONA,49,18,67
2021/2022,08075682,INSTITUT OLÍMPIA,08301,083015,VILADECANS,20,14,34
2021/2022,08075700,ESCOLA XIRINACS,08019,080193,BARCELONA,16,1,17
2021/2022,08075712,INSTITUT LES CINC SÉNIES,08121,081213,MATARÓ,38,11,49
2021/2022,08075724,ESCOLA NORAI,08126,081265,MONTGAT,9,0,9
2021/2022,08076078,ESCOLA AUDITORI,08019,080193,BARCELONA,12,2,14
2021/2022,08076091,INSTITUT CA N'ORIAC,08187,081878,SABADELL,19,11,30
2021/2022,08076108,INSTITUT JAUME CABRÉ,08279,082798,TERRASSA,17,11,28
2021/2022,08076111,INSTITUT JAUME BOTEY,08101,081017,L'HOSPITALET DE LLOBREGAT,31,11,42
2021/2022,08076145,INSTITUT ESCOLA MAR MEDITERRÀNIA,08121,081213,MATARÓ,46,12,58
2021/2022,08076157,INSTITUT ESCOLA ÀNGELA BRANSUELA,08121,081213,MATARÓ,36,13,49
2021/2022,08076169,INSTITUT ESCOLA GORNAL,08101,081017,L'HOSPITALET DE LLOBREGAT,23,9,32
2021/2022,08076194,INSTITUT TECNOLÒGIC DE BARCELONA,08019,080193,BARCELONA,13,39,52
2021/2022,08076391,INSTITUT PEDRALBES,08019,080193,BARCELONA,79,52,131
2021/2022,08076406,INSTITUT NARCISA FREIXAS I CRUELLS,08187,081878,SABADELL,17,7,24
2021/2022,08076421,INSTITUT ESCOLA PEPA COLOMER,08169,081691,EL PRAT DE LLOBREGAT,47,10,57
2021/2022,08076431,INSTITUT ESCOLA BALDOMER SOLÀ,08015,080155,BADALONA,35,10,45
2021/2022,08076443,INSTITUT ESCOLA RAFAEL ALBERTI,08015,080155,BADALONA,36,11,47
2021/2022,08076455,INSTITUT ESCOLA SANT JORDI,08015,080155,BADALONA,21,5,26
2021/2022,08076467,INSTITUT ESCOLA PERE LLISCART,08101,081017,L'HOSPITALET DE LLOBREGAT,45,13,58
2021/2022,08076479,INSTITUT ESCOLA SANT QUINTÍ DE MEDIONA,08236,082362,SANT QUINTÍ DE MEDIONA,35,9,44
2021/2022,08076480,INSTITUT ESCOLA PALLARESA,08245,082457,SANTA COLOMA DE GRAMENET,39,11,50
2021/2022,08076492,INSTITUT ESCOLA POMPEU FABRA,08182,081825,EL PONT DE VILOMARA I ROCAFORT,36,12,48
2021/2022,08076509,INSTITUT ESCOLA ARTS,08019,080193,BARCELONA,33,11,44
2021/2022,08076510,INSTITUT ESCOLA PLA DE L'AVELLÀ,08029,080291,CABRERA DE MAR,38,8,46
2021/2022,08076522,INSTITUT ESCOLA PALLEROLA,08202,082021,SANT CELONI,52,8,60
2021/2022,08076534,INSTITUT ESCOLA MONTAGUT,08261,082613,SANTA SUSANNA,32,8,40
2021/2022,17002831,ESCOLA SANT JAUME,17138,171387,PORTBOU,8,0,8
2021/2022,08076546,INSTITUT ESCOLA CAN LLOBET,08252,082520,BARBERÀ DEL VALLÈS,41,9,50
2021/2022,08076558,INSTITUT ESCOLA SANT ESTEVE,08051,080517,CASTELLAR DEL VALLÈS,33,14,47
2021/2022,08076561,INSTITUT ESCOLA EL VIVER,08125,081252,MONTCADA I REIXAC,47,12,59
2021/2022,08076571,INSTITUT ESCOLA EL MARTINET,08180,081803,RIPOLLET,42,8,50
2021/2022,08076583,INSTITUT ESCOLA ELS PINETONS,08180,081803,RIPOLLET,45,18,63
2021/2022,08076595,INSTITUT ESCOLA TERESA ALTET,08184,081846,RUBÍ,37,10,47
2021/2022,08076601,INSTITUT ESCOLA PERE VIVER,08279,082798,TERRASSA,44,12,56
2021/2022,08076613,INSTITUT ESCOLA BARNOLA,08012,080121,AVINYÓ,19,5,24
2021/2022,08076637,INSTITUT FP SANT CUGAT DEL VALLÈS,08205,082055,SANT CUGAT DEL VALLÈS,35,22,57
2021/2022,08076649,INSTITUT DE JARDINERIA I AGRICULTURA LES GARBERES,08051,080517,CASTELLAR DEL VALLÈS,6,10,16
2021/2022,08076650,CFA SANT ADRIÀ DE BESÒS,08194,081944,SANT ADRIÀ DE BESÒS,9,7,16
2021/2022,08076820,INSTITUT ESCOLA SALA I BADRINAS,08279,082798,TERRASSA,37,7,44
2021/2022,08076893,INSTITUT VILAFRANCA 2,08305,083054,VILAFRANCA DEL PENEDÈS,6,5,11
2021/2022,08076901,INSTITUT ESCOLA DE BADALONA,08015,080155,BADALONA,46,16,62
2021/2022,08076923,INSTITUT ESCOLA LLIBERTAT,08015,080155,BADALONA,26,4,30
2021/2022,08076935,INSTITUT ESCOLA PUIG I GAIRALT,08101,081017,L'HOSPITALET DE LLOBREGAT,41,14,55
2021/2022,08076947,INSTITUT ESCOLA LLUÍS MILLET,08245,082457,SANTA COLOMA DE GRAMENET,18,7,25
2021/2022,08076959,INSTITUT ESCOLA CARLES CAPDEVILA,08017,080174,BALENYÀ,30,8,38
2021/2022,08076960,INSTITUT ESCOLA RENAIXENÇA,08162,081629,ELS HOSTALETS DE PIEROLA,29,9,38
2021/2022,08076972,INSTITUT ESCOLA PIERA,08161,081614,PIERA,41,19,60
2021/2022,08076984,INSTITUT ESCOLA JOSEP MARIA XANDRI,08233,082331,SANT PERE DE TORELLÓ,20,3,23
2021/2022,08076996,INSTITUT ESCOLA MOSSEN CINTO,08083,080832,FOLGUEROLES,26,4,30
2021/2022,08077009,INSTITUT ESCOLA CASTELL D'ÒDENA,08143,081430,ÒDENA,27,6,33
2021/2022,08077010,INSTITUT ESCOLA COVES D'EN CIMANY,08019,080193,BARCELONA,26,5,31
2021/2022,08077022,INSTITUT ESCOLA ELS TRES PINS,08296,082969,VALLROMANES,23,3,26
2021/2022,08077034,INSTITUT ESCOLA EL PI GROS,08203,082037,SANT CEBRIÀ DE VALLALTA,22,7,29
2021/2022,08077046,INSTITUT ESCOLA JOAN SALLARÈS I PLA,08187,081878,SABADELL,27,11,38
2021/2022,08077058,INSTITUT ESCOLA CATALUNYA,08205,082055,SANT CUGAT DEL VALLÈS,39,6,45
2021/2022,08077061,INSTITUT ESCOLA ONZE DE SETEMBRE,08238,082384,SANT QUIRZE DEL VALLÈS,25,5,30
2021/2022,08077071,INSTITUT ESCOLA MAS RAMPINYO,08125,081252,MONTCADA I REIXAC,36,6,42
2021/2022,08077083,INSTITUT VAPOR DEL FIL,08019,080193,BARCELONA,10,2,12
2021/2022,08077095,INSTITUT ESCOLA MIRADES,08019,080193,BARCELONA,35,10,45
2021/2022,08077101,INSTITUT ESCOLA TRES FONTS DE LES CORTS,08019,080193,BARCELONA,38,5,43
2021/2022,08077113,ESCOLA VOLTREGÀ,08215,082153,SANT HIPÒLIT DE VOLTREGÀ,26,2,28
2021/2022,08077125,INSTITUT ESCOLA ANTONI UBACH I SOLER,08279,082798,TERRASSA,41,8,49
2021/2022,08077137,INSTITUT D'ENSENYAMENTS ESPORTIUS DE BARCELONA,08019,080193,BARCELONA,19,18,37
2021/2022,08077149,INSTITUT ESCOLA EIXAMPLE,08019,080193,BARCELONA,27,15,42
2021/2022,08077162,ESCOLA ATENEU IGUALADÍ,08102,081022,IGUALADA,17,3,20
2021/2022,08077228,INSTITUT PROFESSIONAL DE TURISME EQÜESTRE DEL MARESME,08261,082613,SANTA SUSANNA,5,4,9
2021/2022,08077356,ESCOLA NOVA,08267,082671,SENTMENAT,2,0,2
2021/2022,08077371,INSTITUT ESCOLA EL MORSELL,08148,081483,OLIVELLA,22,5,27
2021/2022,08077381,INSTITUT ESCOLA VIROLET,08187,081878,SABADELL,32,8,40
2021/2022,08077393,INSTITUT ESCOLA LLUÍS MILLET,08118,081189,EL MASNOU,29,4,33
2021/2022,08077401,INSTITUT ESCOLA GUILLEM DE BALSARENY,08018,080180,BALSARENY,14,4,18
2021/2022,08077435,INSTITUT DELS ALIMENTS DE BARCELONA,08019,080193,BARCELONA,23,8,31
2021/2022,08077459,INSTITUT ESCOLA SANTIGA,08260,082606,SANTA PERPÈTUA DE MOGODA,20,7,27
2021/2022,08077460,INSTITUT ESCOLA SANTA ANNA,08230,082303,PREMIÀ DE DALT,36,3,39
2021/2022,08077502,INSTITUT ESCOLA LONDRES,08019,080193,BARCELONA,37,14,51
2021/2022,17000019,ESCOLA LLUÍS MARIÀ VIDAL - ZER LES SALINES,17001,170010,AGULLANA,7,1,8
2021/2022,17000032,ESCOLA VILADEMANY,17002,170025,AIGUAVIVA,10,2,12
2021/2022,17000056,ESCOLA LA BRANCA - ZER MONTGRÍ,17004,170046,ALBONS,7,0,7
2021/2022,17000068,ESCOLA DEL FAR D'EMPORDÀ,17005,170059,EL FAR D'EMPORDÀ,13,0,13
2021/2022,17000071,ESCOLA BAC DE CERDANYA,17006,170062,ALP,14,1,15
2021/2022,17000093,ESCOLA GASPAR DE QUERALT,17007,170078,AMER,15,2,17
2021/2022,17000123,ESCOLA SANT JORDI,17903,179032,SANT JULIÀ DEL LLOR I BONMATÍ,15,1,16
2021/2022,17000135,ESCOLA POMPEU FABRA,17008,170084,ANGLÈS,25,6,31
2021/2022,17000160,ESCOLA DOCTOR CARULLA,17009,170097,ARBÚCIES,30,4,34
2021/2022,17000241,ESCOLA FLUVIANETS,17011,170118,L'ARMENTERA,12,4,16
2021/2022,17000251,ESCOLA GONÇAL COMELLAS,17012,170123,AVINYONET DE PUIGVENTÓS,13,1,14
2021/2022,17000263,ESCOLA DOCTOR ARRUGA,17013,170139,BEGUR,14,3,17
2021/2022,17000305,INSTITUT PERE ALSIUS I TORRENT,17015,170157,BANYOLES,46,28,74
2021/2022,17000329,ESCOLA PLA DE L'AMETLLER,17015,170157,BANYOLES,30,1,31
2021/2022,17000330,INSTITUT JOSEP BRUGULAT,17015,170157,BANYOLES,58,35,93
2021/2022,17000342,ESCOLA DE LA VILA BALDIRI REIXAC,17015,170157,BANYOLES,28,4,32
2021/2022,17000354,ESCOLA JOAN REGLÀ,17016,170160,BÀSCARA,12,2,14
2021/2022,17000381,ESCOLA EL RAJARET - ZER MONTGRÍ,17018,170182,BELLCAIRE D'EMPORDÀ,7,0,7
2021/2022,17000408,ESCOLA DOCTOR SOBREQUÉS,17020,170209,BESCANÓ,32,4,36
2021/2022,17000411,ESCOLA JOAN DE MARGARIT,17022,170221,LA BISBAL D'EMPORDÀ,23,7,30
2021/2022,17000469,ESCOLA JOAQUIM RUYRA,17023,170237,BLANES,18,0,18
2021/2022,17000470,ESCOLA CARLES FAUST,17023,170237,BLANES,10,7,17
2021/2022,17000548,ESCOLA MOSSÈN JOAN BATLLE,17023,170237,BLANES,19,7,26
2021/2022,17000551,INSTITUT SA PALOMERA,17023,170237,BLANES,47,37,84
2021/2022,17000561,ESCOLA DE BORDILS,17025,170255,BORDILS,15,4,19
2021/2022,17000573,ESCOLA SANT ANDREU DE BORRASSÀ,17026,170268,BORRASSÀ,10,0,10
2021/2022,17000603,ESCOLA SANTA CECÍLIA - ZER LES SALINES,17029,170293,BOADELLA I LES ESCAULES,3,0,3
2021/2022,17000676,ESCOLA SANT ESTEVE,17033,170335,CALDES DE MALAVELLA,29,3,32
2021/2022,17000688,ESCOLA PERE ROSSELLÓ,17034,170340,CALONGE I SANT ANTONI,29,1,30
2021/2022,17000706,INSTITUT PUIG CARGOL,17034,170340,CALONGE I SANT ANTONI,33,21,54
2021/2022,17000718,ESCOLA LLEVANTÍ DE MAR,17034,170340,CALONGE I SANT ANTONI,16,1,17
2021/2022,17000731,ESCOLA PIRINEU,17036,170366,CAMPDEVÀNOL,19,0,19
2021/2022,17000779,ESCOLA DOCTOR ROBERT,17039,170391,CAMPRODON,16,3,19
2021/2022,17000822,ESCOLA ELS DÒLMENS - ZER REQUESENS,17042,170427,CAPMANY,3,1,4
2021/2022,17000846,ESCOLA PUIG D'ARQUES,17044,170448,CASSÀ DE LA SELVA,30,3,33
2021/2022,17000861,ESCOLA CASTELLROC,17046,170464,CASTELLFOLLIT DE LA ROCA,11,1,12
2021/2022,17000871,ESCOLA RUIZ AMADO,17047,170470,CASTELLÓ D'EMPÚRIES,28,4,32
2021/2022,17000883,ESCOLA VALL D'ARO,17048,170486,CASTELL-PLATJA D'ARO,14,2,16
2021/2022,17000895,ESCOLA ELS ESTANYS,17048,170486,CASTELL-PLATJA D'ARO,23,7,30
2021/2022,17000913,ESCOLA L'AULET,17049,170499,CELRÀ,22,1,23
2021/2022,17000925,ESCOLA L'AIXART,17050,170502,CERVIÀ DE TER,11,2,13
2021/2022,17000937,ESCOLA MOSSÈN JOSEP MARIA ALBERT - ZER EMPORDÀ,17051,170519,CISTELLA,2,0,2
2021/2022,17000950,ESCOLA PUIG D'ESQUERS - ZER CAP DE CREUS,17054,170545,COLERA,2,1,3
2021/2022,17000986,ESCOLA LA VALL DEL TERRI,17056,170561,CORNELLÀ DEL TERRI,21,2,23
2021/2022,17000998,ESCOLA EL RODONELL,17057,170577,CORÇÀ,13,3,16
2021/2022,17001024,ESCOLA LES GAVARRES - ZER EMPORDANET-GAVARRES,17901,179011,"CRUÏLLES, MONELLS I SANT SADURNÍ L'HEURA",6,0,6
2021/2022,17001036,ESCOLA MONT-ROIG - ZER REQUESENS,17060,170600,DARNIUS,3,1,4
2021/2022,17001048,ESCOLA EMPÚRIES,17062,170622,L'ESCALA,34,5,39
2021/2022,17001085,ESCOLA ANTONI BALMANYA - ZER REQUESENS,17064,170643,ESPOLLA,3,0,3
2021/2022,17001097,ESCOLA CARLES DE FORTUNY,17065,170656,ESPONELLÀ,6,1,7
2021/2022,17001103,ESCOLA SALVADOR DALÍ,17066,170669,FIGUERES,34,3,37
2021/2022,17001115,ESCOLA JOSEP POUS I PAGÈS,17066,170669,FIGUERES,16,3,19
2021/2022,17001218,INSTITUT RAMON MUNTANER,17066,170669,FIGUERES,46,23,69
2021/2022,17001221,INSTITUT NARCÍS MONTURIOL,17066,170669,FIGUERES,54,38,92
2021/2022,17001279,ESCOLA SANT PAU,17066,170669,FIGUERES,31,3,34
2021/2022,17001280,ESCOLA JOAQUIM CUSÍ I FURTUNET,17066,170669,FIGUERES,29,6,35
2021/2022,17001292,ESCOLA LES MORERES,17067,170675,FLAÇÀ,12,3,15
2021/2022,17001346,ESCOLA FORN D'ANELLS,17073,170736,FORNELLS DE LA SELVA,21,3,24
2021/2022,17001361,ESCOLA TERESA DE PALLEJÀ,17074,170741,FORTIÀ,11,0,11
2021/2022,25008111,ZER LA COMA,25211,252115,SUDANELL,3,0,3
2021/2022,17001371,ESCOLA DE GARRIGÀS - ZER EMPORDÀ,17075,170754,GARRIGÀS,4,0,4
2021/2022,17001383,ESCOLA JOAQUIM GIFRE,17077,170773,GARRIGUELLA,13,2,15
2021/2022,17001395,ESCOLA SANTA COLOMA - ZER CERDANYA,17078,170789,GER,8,1,9
2021/2022,17001425,ESCOLA EIXIMENIS,17079,170792,GIRONA,15,3,18
2021/2022,17001449,ESCOLA ANNEXA - JOAN PUIGBERT,17079,170792,GIRONA,24,6,30
2021/2022,17001450,ESCOLA JOAN BRUGUERA,17079,170792,GIRONA,13,4,17
2021/2022,17001462,ESCOLA VERD,17079,170792,GIRONA,15,3,18
2021/2022,17001486,ESCOLA MONTJUÏC,17079,170792,GIRONA,16,2,18
2021/2022,17001516,ESCOLA PLA DE GIRONA,17079,170792,GIRONA,27,4,31
2021/2022,17001693,CEE FONT DE L'ABELLA,17079,170792,GIRONA,36,8,44
2021/2022,17001723,INSTITUT JAUME VICENS VIVES,17079,170792,GIRONA,57,19,76
2021/2022,17001735,INSTITUT MONTILIVI,17079,170792,GIRONA,90,66,156
2021/2022,17001759,INSTITUT ESCOLA D'HOSTALERIA I TURISME DE GIRONA,17079,170792,GIRONA,23,18,41
2021/2022,17001838,ESCOLA ÀGORA,17079,170792,GIRONA,16,2,18
2021/2022,17001887,ESCOLA CARME AUGUET,17079,170792,GIRONA,15,1,16
2021/2022,17001930,ESCOLA JOSEP DALMAU I CARLES,17079,170792,GIRONA,24,7,31
2021/2022,17001954,ESCOLA DE VILA-ROJA,17079,170792,GIRONA,11,1,12
2021/2022,17001981,ESCOLA MARE DE DÉU DELS SOCORS,17083,170834,HOSTALRIC,32,3,35
2021/2022,17002004,ESCOLA JOSEP PEÑUELAS DEL RIO,17086,170865,LA JONQUERA,24,7,31
2021/2022,17002028,ESCOLA MONTSERRAT VAYREDA I TRULLOL,17088,170887,LLADÓ,11,1,12
2021/2022,17002031,ESCOLA LACUSTÀRIA,17089,170890,LLAGOSTERA,30,3,33
2021/2022,17002065,ESCOLA LES MORERES - ZER VALL DE TER,17091,170911,LLANARS,4,0,4
2021/2022,17002077,ESCOLA POMPEU FABRA,17092,170926,LLANÇÀ,24,4,28
2021/2022,17002089,ESCOLA DE LLERS,17093,170932,LLERS,12,3,15
2021/2022,17002090,ESCOLA JAUME I - ZER CERDANYA,17094,170947,LLÍVIA,8,1,9
2021/2022,17002107,ESCOLA PERE TORRENT,17095,170950,LLORET DE MAR,36,5,41
2021/2022,17002168,ESCOLA LES SALINES - ZER LES SALINES,17102,171024,MAÇANET DE CABRENYS,5,0,5
2021/2022,17002181,ESCOLA SANT JORDI,17103,171030,MAÇANET DE LA SELVA,21,9,30
2021/2022,17002193,ESCOLA SANTA FE,17169,171693,SANT JULIÀ DE RAMIS,9,3,12
2021/2022,17002201,ESCOLA FINESTRES,17105,171058,MIERES,7,0,7
2021/2022,17002247,ESCOLA MONT CÓS - ZER EL LLIERCA,17109,171096,MONTAGUT I OIX,6,0,6
2021/2022,17002259,ESCOLA TORRES JONAMA,17110,171100,MONT-RAS,11,4,15
2021/2022,17002260,ESCOLA JOAQUIM VALLMAJÓ,17111,171117,NAVATA,13,2,15
2021/2022,17002296,ESCOLA MALAGRIDA,17114,171143,OLOT,29,5,34
2021/2022,17002314,ESCOLA PLA DE DALT,17114,171143,OLOT,30,2,32
2021/2022,17002326,ESCOLA VOLCÀ BISAROQUES,17114,171143,OLOT,30,3,33
2021/2022,17002387,INSTITUT MONTSACOPA,17114,171143,OLOT,61,19,80
2021/2022,17002399,INSTITUT LA GARROTXA,17114,171143,OLOT,76,36,112
2021/2022,17002429,ESCOLA SANT ROC,17114,171143,OLOT,29,4,33
2021/2022,17002430,ESCOLA MARIA PAGÈS I TRAYTER,17115,171156,ORDIS,5,3,8
2021/2022,17002442,ESCOLA LA VALL,17116,171169,OSOR,4,2,6
2021/2022,17002481,ESCOLA TORRES JONAMA,17117,171175,PALAFRUGELL,33,4,37
2021/2022,17002491,ESCOLA JOSEP BARCELÓ I MATAS,17117,171175,PALAFRUGELL,28,7,35
2021/2022,17002545,INSTITUT FREDERIC MARTÍ I CARRERAS,17117,171175,PALAFRUGELL,40,28,68
2021/2022,17002557,INSTITUT BAIX EMPORDÀ,17117,171175,PALAFRUGELL,58,52,110
2021/2022,17002569,ESCOLA LA VILA,17118,171181,PALAMÓS,27,5,32
2021/2022,17002624,ESCOLA MARTÍ INGLÈS,17120,171208,PALAU-SAVERDERA,15,1,16
2021/2022,17002651,ESCOLA QUERMANY,17124,171241,PALS,12,3,15
2021/2022,17002703,ESCOLA PAU,17128,171289,PAU,6,2,8
2021/2022,17002715,ESCOLA PEDRA BLANCA - ZER EMPORDANET-GAVARRES,17130,171306,LA PERA,5,1,6
2021/2022,17002740,ESCOLA RAMON MUNTANER,17132,171328,PERALADA,17,0,17
2021/2022,17002752,ESCOLA SANT CRISTÒFOL,17133,171334,LES PLANES D'HOSTOLES,15,2,17
2021/2022,17002764,ESCOLA NÚRIA MORER I PI - ZER COMTE ARNAU,17134,171349,PLANOLES,3,0,3
2021/2022,17002776,ESCOLA TRAMUNTANA - ZER EMPORDÀ,17135,171352,PONT DE MOLINS,3,1,4
2021/2022,17002791,ESCOLA L'ENTORN,17137,171371,PORQUERES,27,3,30
2021/2022,17002818,ESCOLA FRIGOLET,17137,171371,PORQUERES,9,1,10
2021/2022,17002879,ESCOLA LES CLISQUES - ZER CAP DE CREUS,17140,171404,EL PORT DE LA SELVA,6,1,7
2021/2022,17002880,ESCOLA ALFONS I,17141,171411,PUIGCERDÀ,22,7,29
2021/2022,17002922,ESCOLA SANTA MARGARIDA,17142,171426,QUART,16,3,19
2021/2022,17002983,ESCOLA EL BRUC,17146,171463,RIELLS I VIABREA,17,2,19
2021/2022,17002995,ESCOLA JOAN MARAGALL,17147,171479,RIPOLL,20,3,23
2021/2022,17003070,ESCOLA JOSEP BOADA,17148,171485,RIUDARENES,16,0,16
2021/2022,17003082,ESCOLA LLUÍS CASTELLS,17149,171498,RIUDAURA,10,2,12
2021/2022,17003094,ESCOLA DE RIUDELLOTS DE LA SELVA,17150,171501,RIUDELLOTS DE LA SELVA,15,1,16
2021/2022,17003136,ESCOLA NARCÍS MONTURIOL,17152,171523,ROSES,15,5,20
2021/2022,17003151,ESCOLA SILVESTRE SANTALÓ,17155,171557,SALT,17,5,22
2021/2022,17003203,INSTITUT SALVADOR ESPRIU,17155,171557,SALT,60,23,83
2021/2022,17003215,ESCOLA LA FARGA,17155,171557,SALT,33,6,39
2021/2022,17003227,ESCOLA SANT SEBASTIÀ - ZER REQUESENS,17158,171582,SANT CLIMENT SESCEBES,5,0,5
2021/2022,17003264,ESCOLA GAZIEL,17160,171609,SANT FELIU DE GUÍXOLS,22,7,29
2021/2022,17003306,INSTITUT SANT ELM,17160,171609,SANT FELIU DE GUÍXOLS,33,16,49
2021/2022,17003318,INSTITUT DE SANT FELIU DE GUÍXOLS,17160,171609,SANT FELIU DE GUÍXOLS,63,32,95
2021/2022,17003321,ESCOLA MOSSÈN BALDIRI REIXACH,17160,171609,SANT FELIU DE GUÍXOLS,26,4,30
2021/2022,17003343,ESCOLA ROCALBA,17161,171616,SANT FELIU DE PALLEROLS,13,1,14
2021/2022,17003392,ESCOLA AGUSTÍ GIFRE,17163,171637,SANT GREGORI,30,7,37
2021/2022,17003422,ESCOLA TAIALÀ,17079,170792,GIRONA,33,4,37
2021/2022,17003434,ESCOLA GUILLERIES,17164,171642,SANT HILARI SACALM,26,4,30
2021/2022,17003461,ESCOLA LES ESCOMES,17165,171655,SANT JAUME DE LLIERCA,12,3,15
2021/2022,17003471,ESCOLA SANT JORDI,17166,171668,SANT JORDI DESVALLS,10,1,11
2021/2022,17003537,ESCOLA DE VALLFOGONA DE RIPOLLÈS - ZER COMTE ARNAU,17170,171707,VALLFOGONA DE RIPOLLÈS,2,0,2
2021/2022,17003598,ESCOLA VALLGARRIGA,17175,171753,SANT MIQUEL DE FLUVIÀ,8,2,10
2021/2022,17003616,ESCOLA ELS PINETS - ZER VALL DE TER,17177,171772,SANT PAU DE SEGÚRIES,7,0,7
2021/2022,17003628,ESCOLA LLAGUT,17178,171788,SANT PERE PESCADOR,14,6,20
2021/2022,17003631,ESCOLA LA PEDRA DRETA - ZER EMPORDANET-GAVARRES,17901,179011,"CRUÏLLES, MONELLS I SANT SADURNÍ L'HEURA",4,1,5
2021/2022,17003641,ESCOLA SANT SALVADOR D'HORTA,17180,171805,SANTA COLOMA DE FARNERS,33,4,37
2021/2022,17003689,ESCOLA PEDRALTA,17181,171812,SANTA CRISTINA D'ARO,24,6,30
2021/2022,17003719,ESCOLA JOAN MARAGALL,17184,171848,SANTA PAU,13,2,15
2021/2022,17003732,ESCOLA CASTANYER,17185,171851,SANT JOAN LES FONTS,19,3,22
2021/2022,17003756,ESCOLA MONTSERRAT,17186,171864,SARRIÀ DE TER,27,4,31
2021/2022,17003768,ESCOLA ELS TERRAPRIMS,17187,171870,"SAUS, CAMALLERA I LLAMPAIES",14,1,15
2021/2022,17003781,ESCOLA JUNCADELLA,17189,171899,LA CELLERA DE TER,13,3,16
2021/2022,17003801,ESCOLA BORA GRAN,17190,171903,SERINYÀ,11,3,14
2021/2022,17003823,ESCOLA VERDAGUER,17193,171931,SILS,25,5,30
2021/2022,17003860,ESCOLA PORTITXOL,17199,171997,TORROELLA DE MONTGRÍ,21,5,26
2021/2022,17003872,ESCOLA GUILLEM DE MONTGRÍ,17199,171997,TORROELLA DE MONTGRÍ,42,4,46
2021/2022,17003902,ESCOLA JOAN ROURA I PARELLA - ZER EL LLIERCA,17200,172001,TORTELLÀ,5,2,7
2021/2022,17003926,ESCOLA IGNASI MELÉ I FARRÉ,17202,172023,TOSSA DE MAR,26,6,32
2021/2022,17003938,ESCOLA PUIG RODÓ - ZER MONTGRÍ,17204,172044,ULLÀ,7,0,7
2021/2022,17003941,ESCOLA L'ESTANY - ZER EMPORDANET-GAVARRES,17205,172057,ULLASTRET,4,0,4
2021/2022,17003951,PARVULARI DE SANT ESTEVE D'EN BAS,17207,172076,LA VALL D'EN BAS,4,0,4
2021/2022,17004001,ESCOLA VERNTALLAT,17207,172076,LA VALL D'EN BAS,19,2,21
2021/2022,17004049,ESCOLA OLIVERES MIL·LENÀRIES - ZER TRAMUNTANA,17210,172109,VENTALLÓ,8,0,8
2021/2022,17004062,ESCOLA SANTA BÀRBARA - ZER ELS CASTELLS,17212,172121,VIDRÀ,2,0,2
2021/2022,17004074,ESCOLA SANT ISCLE,17213,172137,VIDRERES,18,3,21
2021/2022,17004098,ESCOLA TORRE D'EN REIG,17214,172142,VILABERTRAN,15,1,16
2021/2022,17004116,ESCOLA MADRENC,17215,172155,VILABLAREIX,25,2,27
2021/2022,17004128,ESCOLA PUIG SEGALAR - ZER TRAMUNTANA,17217,172174,VILADAMAT,4,0,4
2021/2022,17004153,ESCOLA DE SANT ESTEVE DE GUIALBES,17218,172180,VILADEMULS,11,2,13
2021/2022,17004189,ESCOLA ELS CASTANYERS - ZER GUILLERIES,17220,172207,VILADRAU,9,0,9
2021/2022,25008133,ZER PONENT,25120,251207,LLEIDA,3,1,4
2021/2022,17004190,ESCOLA SOL I VENT,17221,172214,VILAFANT,14,1,15
2021/2022,17004207,ESCOLA SANTIAGO RATÉS,17223,172235,VILAJUÏGA,11,1,12
2021/2022,17004219,ESCOLA LA DAINA - ZER VALL DE TER,17224,172240,VILALLONGA DE TER,3,0,3
2021/2022,17004220,ESCOLA ELS VALENTINS - ZER TRAMUNTANA,17225,172253,VILAMACOLUM,3,2,5
2021/2022,17004232,ESCOLA JOSEP DE RIBOT I OLIVAS,17226,172266,VILAMALLA,14,2,16
2021/2022,17004244,ESCOLA TRAMUNTANA - ZER EMPORDÀ,17228,172288,VILANANT,3,0,3
2021/2022,17004281,ESCOLA JOSEP MADRENYS,17233,172333,VILOBÍ D'ONYAR,24,1,25
2021/2022,17004293,ESCOLA MANUEL DE PEDROLO - ZER LES SALINES,17234,172348,BIURE,3,0,3
2021/2022,17004335,ESCOLA SANTA EUGÈNIA,17079,170792,GIRONA,18,0,18
2021/2022,17004347,ESCOLA FONT DE LA PÓLVORA,17079,170792,GIRONA,11,2,13
2021/2022,17004360,CEE LA MAÇANA,17155,171557,SALT,10,0,10
2021/2022,17004438,INSTITUT ALEXANDRE DEULOFEU,17066,170669,FIGUERES,55,24,79
2021/2022,17004451,ESCOLA JAUME VICENS I VIVES,17152,171523,ROSES,23,4,27
2021/2022,17004463,ESCOLA ANICET DE PAGÈS I DE PUIG,17066,170669,FIGUERES,26,6,32
2021/2022,17004487,INSTITUT RAFAEL CAMPALANS,17008,170084,ANGLÈS,36,26,62
2021/2022,17004499,INSTITUT NARCÍS XIFRA I MASMITJÀ,17079,170792,GIRONA,104,50,154
2021/2022,17004517,INSTITUT ANTON BUSQUETS I PUNSET,17164,171642,SANT HILARI SACALM,21,10,31
2021/2022,17004529,ESCOLA MIGDIA,17079,170792,GIRONA,28,4,32
2021/2022,17004530,INSTITUT SANTIAGO SOBREQUÉS I VIDAL,17079,170792,GIRONA,47,24,71
2021/2022,17004566,ESCOLA NAPOLEÓ SOLIVA,17023,170237,BLANES,21,2,23
2021/2022,17004578,INSTITUT CASTELL D'ESTELA,17007,170078,AMER,24,10,34
2021/2022,17004657,ESCOLA ESTEVE CARLES,17095,170950,LLORET DE MAR,20,4,24
2021/2022,17004682,ESCOLA L'ESTACIÓ,17160,171609,SANT FELIU DE GUÍXOLS,29,4,33
2021/2022,17004694,ESCOLA CASSIÀ COSTAL,17079,170792,GIRONA,27,3,30
2021/2022,17004712,CEE VENTIJOL,17023,170237,BLANES,26,2,28
2021/2022,17004724,CEE PALAU,17079,170792,GIRONA,15,2,17
2021/2022,17004736,CEE ELS ÀNGELS,17118,171181,PALAMÓS,26,1,27
2021/2022,17004748,CEE MARE DE DÉU DEL MONT,17221,172214,VILAFANT,26,2,28
2021/2022,17004751,ESCOLA TOMÀS RAGUER,17147,171479,RIPOLL,17,1,18
2021/2022,17004761,CEE DOCTOR RAMON SURIÑACH,17147,171479,RIPOLL,7,0,7
2021/2022,17004827,ESCOLA ALZINA RECLAMADORA,17071,170715,FONTCOBERTA,14,1,15
2021/2022,17004852,EOI DE GIRONA,17079,170792,GIRONA,33,7,40
2021/2022,17004864,ESCOLA EL PLA,17155,171557,SALT,30,9,39
2021/2022,17004876,ESCOLA L'OLIVAR VELL,17013,170139,BEGUR,10,2,12
2021/2022,17004888,ESCOLA SANTA CECÍLIA - ZER CERDANYA,17024,170242,BOLVIR,4,1,5
2021/2022,17004891,ESCOLA JOSEP PALLACH,17066,170669,FIGUERES,29,6,35
2021/2022,17004906,ESCOLA SALVADOR ESPRIU,17213,172137,VIDRERES,26,4,30
2021/2022,17004943,ESCOLA MONTFALGARS,17079,170792,GIRONA,28,4,32
2021/2022,17004955,ESCOLA POMPEU FABRA,17095,170950,LLORET DE MAR,36,8,44
2021/2022,17005017,ESCOLA QUATRE VENTS,17023,170237,BLANES,22,8,30
2021/2022,17005029,ESCOLA L'ESQUIROL - ZER VALL DE TER,17112,171122,OGASSA,3,0,3
2021/2022,17005042,INSTITUT CARLES RAHOLA I LLORENS,17079,170792,GIRONA,42,17,59
2021/2022,17005182,ESCOLA CAN PUIG,17015,170157,BANYOLES,26,5,31
2021/2022,17005248,ESCOLA MAS CLARÀ,17022,170221,LA BISBAL D'EMPORDÀ,24,5,29
2021/2022,17005251,INSTITUT EL PEDRÓ,17062,170622,L'ESCALA,33,24,57
2021/2022,17005261,ESCOLA MONTPALAU - ZER EL LLIERCA,17010,170101,ARGELAGUER,4,1,5
2021/2022,17005339,CFA LES BERNARDES,17155,171557,SALT,9,9,18
2021/2022,17005340,EA D'OLOT,17114,171143,OLOT,28,12,40
2021/2022,17005352,INSTITUT DE PALAMÓS,17118,171181,PALAMÓS,53,31,84
2021/2022,17005364,INSTITUT CAP NORFEU,17152,171523,ROSES,46,20,66
2021/2022,17005376,INSTITUT DE SANTA COLOMA DE FARNERS,17180,171805,SANTA COLOMA DE FARNERS,69,31,100
2021/2022,17005388,INSTITUT VALLVERA,17155,171557,SALT,79,24,103
2021/2022,17005522,ESCOLA VEÏNAT,17155,171557,SALT,20,2,22
2021/2022,17005649,INSTITUT CENDRASSOS,17066,170669,FIGUERES,60,40,100
2021/2022,17005650,INSTITUT DE CASSÀ DE LA SELVA,17044,170448,CASSÀ DE LA SELVA,46,16,62
2021/2022,17005662,INSTITUT SERRALLARGA,17023,170237,BLANES,67,44,111
2021/2022,17005704,INSTITUT ABAT OLIBA,17147,171479,RIPOLL,53,32,85
2021/2022,17005731,INSTITUT S'AGULLA,17023,170237,BLANES,50,23,73
2021/2022,17005741,INSTITUT PERE BORRELL,17141,171411,PUIGCERDÀ,62,18,80
2021/2022,17005893,INSTITUT BOSC DE LA COMA,17114,171143,OLOT,52,39,91
2021/2022,17005911,INSTITUT RAMON COLL I RODÉS,17095,170950,LLORET DE MAR,55,31,86
2021/2022,17005923,INSTITUT MONTGRÍ,17199,171997,TORROELLA DE MONTGRÍ,39,23,62
2021/2022,17006083,INSTITUT CASTELLÓ D'EMPÚRIES,17047,170470,CASTELLÓ D'EMPÚRIES,44,25,69
2021/2022,17006605,INSTITUT MONTSORIU,17009,170097,ARBÚCIES,37,20,57
2021/2022,17006666,INSTITUT PLA DE L'ESTANY,17015,170157,BANYOLES,49,28,77
2021/2022,17006681,INSTITUT GERMANS VILA-RIERA,17039,170391,CAMPRODON,15,6,21
2021/2022,17006691,INSTITUT RIDAURA,17048,170486,CASTELL-PLATJA D'ARO,44,16,60
2021/2022,17006708,INSTITUT DE CELRÀ,17049,170499,CELRÀ,45,18,63
2021/2022,17006711,ESCOLA M. ÀNGELS ANGLADA,17066,170669,FIGUERES,17,3,20
2021/2022,17006721,ESCOLA MARTA MATA,17079,170792,GIRONA,28,4,32
2021/2022,17006733,INSTITUT VESCOMTAT DE CABRERA,17083,170834,HOSTALRIC,40,18,58
2021/2022,17006745,INSTITUT DE LA JONQUERA,17086,170865,LA JONQUERA,26,9,35
2021/2022,17006757,INSTITUT DE LLAGOSTERA,17089,170890,LLAGOSTERA,34,15,49
2021/2022,17006769,INSTITUT DE LLANÇÀ,17092,170926,LLANÇÀ,30,18,48
2021/2022,17006770,INSTITUT ROCAGROSSA,17095,170950,LLORET DE MAR,34,34,68
2021/2022,17006782,ESCOLA CARRILET,17117,171175,PALAFRUGELL,33,4,37
2021/2022,17006800,ESCOLA ELS GRECS,17152,171523,ROSES,23,4,27
2021/2022,17006812,INSTITUT DE TOSSA DE MAR,17202,172023,TOSSA DE MAR,21,14,35
2021/2022,17006824,INSTITUT VIDRERES,17213,172137,VIDRERES,37,26,63
2021/2022,17006836,ESCOLA LES MÈLIES,17221,172214,VILAFANT,25,4,29
2021/2022,17006851,INSTITUT ILLA DE RODES,17152,171523,ROSES,43,25,68
2021/2022,17006873,ESCOLA CASTELLUM,17169,171693,SANT JULIÀ DE RAMIS,22,1,23
2021/2022,17006939,INSTITUT SANTA EUGÈNIA,17079,170792,GIRONA,61,51,112
2021/2022,17006940,ESCOLA DE LLIURONA,17003,170031,ALBANYÀ,2,1,3
2021/2022,17006952,ESCOLA LA DRAGA,17015,170157,BANYOLES,29,2,31
2021/2022,17007014,CFA LLORET DE MAR,17095,170950,LLORET DE MAR,6,2,8
2021/2022,17007129,CFA ES PITEUS,17023,170237,BLANES,7,6,13
2021/2022,17007178,CFA MARIA VERDAGUER,17066,170669,FIGUERES,9,2,11
2021/2022,17007181,CFA GIRONA,17079,170792,GIRONA,13,5,18
2021/2022,17007300,INSTITUT LA BISBAL,17022,170221,LA BISBAL D'EMPORDÀ,63,36,99
2021/2022,17007427,ZER TRAMUNTANA,17210,172109,VENTALLÓ,4,0,4
2021/2022,17007439,ZER CERDANYA,17094,170947,LLÍVIA,5,0,5
2021/2022,17007440,ZER VALL DE TER,17177,171772,SANT PAU DE SEGÚRIES,3,2,5
2021/2022,17007452,ZER EL LLIERCA,17200,172001,TORTELLÀ,3,1,4
2021/2022,17007464,ZER COMTE ARNAU,17170,171707,VALLFOGONA DE RIPOLLÈS,3,0,3
2021/2022,17007488,ZER REQUESENS,17042,170427,CAPMANY,3,1,4
2021/2022,17007518,ZER LES SALINES,17001,170010,AGULLANA,4,0,4
2021/2022,17007531,ZER MONTGRÍ,17018,170182,BELLCAIRE D'EMPORDÀ,3,0,3
2021/2022,17007609,INSTITUT OLIVAR GRAN,17066,170669,FIGUERES,47,35,82
2021/2022,17007658,CFA SANT FELIU DE GUÍXOLS,17160,171609,SANT FELIU DE GUÍXOLS,7,2,9
2021/2022,17007671,CFA LA GARROTXA,17114,171143,OLOT,8,4,12
2021/2022,17007695,ZER EMPORDÀ,17228,172288,VILANANT,4,1,5
2021/2022,17007828,ESCOLA PINYA DE ROSA,17023,170237,BLANES,27,4,31
2021/2022,17007907,ESCOLA JOANA D'EMPÚRIES,17047,170470,CASTELLÓ D'EMPÚRIES,24,4,28
2021/2022,17007919,ESCOLA MAS MASÓ,17155,171557,SALT,36,4,40
2021/2022,17007981,EOI D'OLOT,17114,171143,OLOT,6,3,9
2021/2022,17008006,ESCOLA AMISTAT,17066,170669,FIGUERES,28,4,32
2021/2022,17008018,ESCOLA ARDENYA,17160,171609,SANT FELIU DE GUÍXOLS,26,3,29
2021/2022,17008080,ESCOLA ÀNGELS ALEMANY I BORIS,17095,170950,LLORET DE MAR,44,6,50
2021/2022,17008110,EOI DE SANT FELIU DE GUÍXOLS,17160,171609,SANT FELIU DE GUÍXOLS,6,2,8
2021/2022,17008122,EOI DE BLANES,17023,170237,BLANES,7,1,8
2021/2022,17008134,EOI DE FIGUERES,17066,170669,FIGUERES,8,2,10
2021/2022,17008146,CFA PALAFRUGELL,17117,171175,PALAFRUGELL,4,3,7
2021/2022,17008237,ESCOLA MONTSERRAT VAYREDA,17152,171523,ROSES,24,4,28
2021/2022,17008249,ESCOLA CASTELL DE FARNERS,17180,171805,SANTA COLOMA DE FARNERS,31,3,34
2021/2022,17008274,ESCOLA SA FORCANERA,17023,170237,BLANES,26,2,28
2021/2022,17008286,ESCOLA DOMENY,17079,170792,GIRONA,30,2,32
2021/2022,17008298,ESCOLA EL GEGANT DEL REC,17155,171557,SALT,32,5,37
2021/2022,17008365,CFA PLA DE L'ESTANY,17015,170157,BANYOLES,6,2,8
2021/2022,17008377,CFA RIPOLLÈS,17147,171479,RIPOLL,2,1,3
2021/2022,17008389,CFA LA SELVA,17180,171805,SANTA COLOMA DE FARNERS,3,4,7
2021/2022,17008390,INSTITUT DE VILAFANT,17221,172214,VILAFANT,32,17,49
2021/2022,17008407,INSTITUT SALVADOR SUNYER I AIMERIC,17155,171557,SALT,33,10,43
2021/2022,17008419,ESCOLA LLUMS DEL NORD,17141,171411,PUIGCERDÀ,15,2,17
2021/2022,17008444,ESCOLA PARC DE LES AIGÜES,17066,170669,FIGUERES,28,6,34
2021/2022,17008468,ESCOLA LA SÍNIA,17034,170340,CALONGE I SANT ANTONI,14,1,15
2021/2022,17008471,ESCOLA LES FALGUERES,17049,170499,CELRÀ,28,0,28
2021/2022,17008481,ESCOLA L'ESCULAPI,17062,170622,L'ESCALA,17,3,20
2021/2022,17008493,ESCOLA VALL-LLOBREGA,17209,172095,VALL-LLOBREGA,14,0,14
2021/2022,17008501,ESCOLA ALDRIC,17044,170448,CASSÀ DE LA SELVA,30,1,31
2021/2022,17008523,ESCOLA PI VERD,17117,171175,PALAFRUGELL,29,7,36
2021/2022,17008547,ESCOLA LES ARRELS,17103,171030,MAÇANET DE LA SELVA,17,4,21
2021/2022,17008641,ESCOLA DE CABANES,17030,170307,CABANES,11,1,12
2021/2022,17008651,INSTITUT DE CALDES DE MALAVELLA,17033,170335,CALDES DE MALAVELLA,26,11,37
2021/2022,17008675,ESCOLA PERICOT,17079,170792,GIRONA,25,7,32
2021/2022,17008687,ESCOLA LES DEVESES,17155,171557,SALT,30,7,37
2021/2022,17008778,ESCOLA EL MORROT,17114,171143,OLOT,16,3,19
2021/2022,17008781,ESCOLA LA BENAULA,17033,170335,CALDES DE MALAVELLA,18,0,18
2021/2022,17008808,ESCOLA CARME GUASCH I DARNÉ,17066,170669,FIGUERES,30,3,33
2021/2022,17008821,EOI DE BANYOLES,17015,170157,BANYOLES,4,1,5
2021/2022,17008882,ESCOLA LA BÒBILA,17139,171390,LES PRESES,17,1,18
2021/2022,17008894,ESCOLA ALZINES BALLADORES,17159,171595,SANT FELIU DE BUIXALLEU,13,1,14
2021/2022,17008951,INSTITUT MAÇANET DE LA SELVA,17103,171030,MAÇANET DE LA SELVA,25,13,38
2021/2022,17008997,ESCOLA FORALLAC,17902,179026,FORALLAC,12,3,15
2021/2022,17009126,ESCOLA EL BOSC DE LA PABORDIA,17079,170792,GIRONA,29,2,31
2021/2022,17009138,ESCOLA PUIG DE LES CADIRETES,17089,170890,LLAGOSTERA,25,4,29
2021/2022,17009199,ESCOLA ELS ESTANYS,17193,171931,SILS,11,5,16
2021/2022,17009205,INSTITUT DE VILABLAREIX,17215,172155,VILABLAREIX,40,18,58
2021/2022,17009242,ESCOLA NOU DE QUART,17142,171426,QUART,16,1,17
2021/2022,17009278,ESCOLA FANALS D'ARO,17048,170486,CASTELL-PLATJA D'ARO,14,2,16
2021/2022,17009308,INSTITUT DE SILS,17193,171931,SILS,24,10,34
2021/2022,17009345,ESCOLA CAMINS,17015,170157,BANYOLES,18,3,21
2021/2022,17009473,ZER EMPORDANET-GAVARRES,17130,171306,LA PERA,4,0,4
2021/2022,17009631,ZER CAP DE CREUS,17140,171404,EL PORT DE LA SELVA,2,2,4
2021/2022,17009710,ESCOLA EMPORDANET,17022,170221,LA BISBAL D'EMPORDÀ,18,0,18
2021/2022,17009783,INSTITUT LA MIQUELA,17020,170209,BESCANÓ,27,9,36
2021/2022,17009795,INSTITUT ESCOLA FRANCESC CAMBÓ I BATLLE,17211,172116,VERGES,36,9,45
2021/2022,17009801,INSTITUT ESCOLA SALVADOR VILARRASA,17019,170195,BESALÚ,36,11,47
2021/2022,17009813,INSTITUT ESCOLA MESTRE ANDREU,17167,171674,SANT JOAN DE LES ABADESSES,35,7,42
2021/2022,17009850,ESCOLA LES ARRELS,17155,171557,SALT,32,6,38
2021/2022,17009898,INSTITUT ESCOLA LLORET DE MAR,17095,170950,LLORET DE MAR,56,12,68
2021/2022,17010037,INSTITUT EL BRUC,17146,171463,RIELLS I VIABREA,12,7,19
2021/2022,17010049,ESCOLA BALANDRAU,17079,170792,GIRONA,15,2,17
2021/2022,17010189,INSTITUT VALL DE LLÉMENA,17163,171637,SANT GREGORI,19,10,29
2021/2022,17010414,INSTITUT ERMESSENDA DE GIRONA,17079,170792,GIRONA,39,13,52
2021/2022,17010441,CFA NOU GIRONA,17079,170792,GIRONA,6,4,10
2021/2022,17010451,CFA TRAMUNTANA,17066,170669,FIGUERES,12,6,18
2021/2022,17010682,INSTITUT DE SARRIÀ DE TER,17186,171864,SARRIÀ DE TER,21,16,37
2021/2022,17010694,INSTITUT ESCOLA EL BRUEL-EMPURIABRAVA,17047,170470,CASTELLÓ D'EMPÚRIES,33,10,43
2021/2022,17010700,INSTITUT SANT QUIRZE,17095,170950,LLORET DE MAR,13,6,19
2021/2022,17010797,INSTITUT ESCOLA CARITAT SERINYANA - CAP DE CREUS,17032,170329,CADAQUÉS,26,8,34
2021/2022,17010803,INSTITUT ESCOLA RIBES DE FRESER,17145,171450,RIBES DE FRESER,23,6,29
2021/2022,17010815,INSTITUT ESCOLA VILA-ROMÀ,17118,171181,PALAMÓS,32,10,42
2021/2022,17010827,INSTITUT ESCOLA GREDA,17114,171143,OLOT,30,4,34
2021/2022,17010839,INSTITUT DE PERALADA,17132,171328,PERALADA,7,4,11
2021/2022,17010840,INSTITUT NOU PALAFRUGELL,17117,171175,PALAFRUGELL,15,3,18
2021/2022,17010921,INSTITUT ESCOLA MONTSENY,17027,170274,BREDA,39,9,48
2021/2022,17010931,ESCOLA DE PALAU DE SANTA EULÀLIA-ZER EMPORDÀ,17119,171194,PALAU DE SANTA EULÀLIA,2,0,2
2021/2022,25000031,ESCOLA ANDREU FARRAN - ZER MONTSEC,25002,250024,ÀGER,1,3,4
2021/2022,25000067,ESCOLA MACIÀ-COMPANYS,25003,250030,AGRAMUNT,22,5,27
2021/2022,25000110,ESCOLA ARRELS - ZER L'HORTA DE LLEIDA,25004,250045,ELS ALAMÚS,5,1,6
2021/2022,25000122,ESCOLA SANT ESTEVE - ZER URGELLET,25005,250058,ALÀS I CERC,3,0,3
2021/2022,25000146,ESCOLA MARE DE DÉU DE MONTSERRAT - ZER VALL DE L'ARANYÓ,25006,250061,L'ALBAGÉS,2,2,4
2021/2022,25000158,ESCOLA SANT SALVADOR,25007,250077,ALBATÀRREC,15,1,16
2021/2022,25000161,ESCOLA L'ÀLBER,25008,250083,ALBESA,10,2,12
2021/2022,25000171,ESCOLA ELS AUBIS - ZER RIU SET,25009,250096,L'ALBI,6,1,7
2021/2022,25000183,ESCOLA LA DULA - ZER L'ERAL,25010,250100,ALCANÓ,3,0,3
2021/2022,25000195,ESCOLA COMTES DE TORREGROSSA,25011,250117,ALCARRÀS,31,6,37
2021/2022,25000225,ESCOLA MARE DE DÉU DEL CARME,25012,250122,ALCOLETGE,19,10,29
2021/2022,25000274,ESCOLA D'ALFÉS - ZER L'ERAL,25014,250143,ALFÉS,3,0,3
2021/2022,25000286,ESCOLA SANT BLAI - ZER SERRA LLARGA,25015,250156,ALGERRI,3,1,4
2021/2022,25000316,ESCOLA D'ALINS - ZER ALT PALLARS SOBIRÀ,25017,250175,ALINS,3,0,3
2021/2022,25000341,ESCOLA ANTÒNIA SIMÓ ARNÓ,25019,250194,ALMACELLES,34,5,39
2021/2022,25000468,ESCOLA DOCTOR SERÉS,25023,250236,ALPICAT,29,4,33
2021/2022,25000481,ESCOLA SANT ISIDRE - ZER PONENT,25912,259123,GIMENELLS I EL PLA DE LA FONT,6,0,6
2021/2022,25000511,ESCOLA INOCENCIO PARDOS - ZER PONENT,25912,259123,GIMENELLS I EL PLA DE LA FONT,3,0,3
2021/2022,25000535,ESCOLA LOSERON - ZER VAL D'ARAN,25025,250254,NAUT ARAN,6,0,6
2021/2022,25000559,ESCOLA SANT MARTÍ - ZER VAL D'ARAN,25025,250254,NAUT ARAN,2,0,2
2021/2022,25000560,ESCOLA RUDA - ZER VAL D'ARAN,25025,250254,NAUT ARAN,8,0,8
2021/2022,25000584,ESCOLA SANTA CREU,25027,250273,ANGLESOLA,15,2,17
2021/2022,25000602,ESCOLA ALBIRKA,25029,250292,ARBECA,12,2,14
2021/2022,25000626,ESCOLA ELS TIL.LERS,25033,250334,ARTESA DE LLEIDA,12,4,16
2021/2022,25000638,ESCOLA ELS PLANELLS,25034,250349,ARTESA DE SEGRE,25,1,26
2021/2022,25000675,ESCOLA MARE DE DÉU DE LA GUARDIOLA - ZER EL ROMANÍ,25035,250352,LA SENTIU DE SIÓ,3,0,3
2021/2022,25000699,ESCOLA DE LES AVELLANES - ZER MONTSEC,25037,250371,LES AVELLANES I SANTA LINYA,2,1,3
2021/2022,25000717,ESCOLA DE TARTAREU - ZER MONTSEC,25037,250371,LES AVELLANES I SANTA LINYA,1,1,2
2021/2022,25000730,ESCOLA FRANCESC FELIU,25038,250387,AITONA,23,7,30
2021/2022,25000778,ESCOLA GASPAR DE PORTOLÀ,25040,250404,BALAGUER,29,7,36
2021/2022,25000781,ESCOLA ÀNGEL GUIMERÀ,25040,250404,BALAGUER,19,1,20
2021/2022,25000833,INSTITUT CIUTAT DE BALAGUER,25040,250404,BALAGUER,38,18,56
2021/2022,25000857,ESCOLA LA NOGUERA,25040,250404,BALAGUER,14,4,18
2021/2022,25000869,ESCOLA SANT ROC - ZER RIU ONDARA,25041,250411,BARBENS,8,1,9
2021/2022,25000951,ESCOLA PERE TEIXINÉ - ZER RIU CORB,25046,250463,BELIANES,3,1,4
2021/2022,25000961,ESCOLA BONAVISTA,25047,250479,BELLCAIRE D'URGELL,12,1,13
2021/2022,25000985,ESCOLA RAMON FARRERONS,25048,250485,BELL-LLOC D'URGELL,15,1,16
2021/2022,25001001,ESCOLA SANT BARTOMEU - ZER ESPERNALLAC,25049,250498,BELLMUNT D'URGELL,1,1,2
2021/2022,25001011,ESCOLA VALERI SERRA,25050,250501,BELLPUIG,20,1,21
2021/2022,25001059,ESCOLA MARE DE DÉU DE TALLÓ,25051,250518,BELLVER DE CERDANYA,14,2,16
2021/2022,25001084,ESCOLA JOAQUIM PALACÍN,25052,250523,BELLVÍS,13,3,16
2021/2022,25001096,ESCOLA SANT JOAN,25053,250539,BENAVENT DE SEGRIÀ,14,1,15
2021/2022,25001126,ESCOLA VALLMAJOR - ZER ELAIA,25056,250560,BOVERA,2,1,3
2021/2022,25001138,ESCOLA CASTETH LEON - ZER VAL D'ARAN,25057,250576,ES BÒRDES,4,0,4
2021/2022,25001141,ESCOLA JOAN XXIII,25058,250582,LES BORGES BLANQUES,27,4,31
2021/2022,25001199,ESCOLA SANT RÒC,25059,250595,BOSSÒST,8,2,10
2021/2022,25001229,ESCOLA DOS RIUS - ZER EL JONC,25062,250621,CAMARASA,5,1,6
2021/2022,25001242,ESCOLA CASTELL-CIUTAT - ZER URGELLET,25203,252038,LA SEU D'URGELL,4,0,4
2021/2022,25001254,ESCOLA TIMORELL - ZER VALL DE L'ARANYÓ,25067,250674,CASTELLDANS,6,1,7
2021/2022,25001266,ESCOLA L'ESTEL - ZER VENT SERÈ,25068,250680,CASTELLNOU DE SEANA,6,0,6
2021/2022,25001281,ESCOLA EL TERRALL - ZER ESPERNALLAC,25070,250707,CASTELLSERÀ,8,1,9
2021/2022,25001291,ESCOLA JAUME BALMES,25072,250729,CERVERA,30,2,32
2021/2022,25001311,INSTITUT ANTONI TORROJA,25072,250729,CERVERA,24,14,38
2021/2022,25001321,ESCOLA MOSSÈN JOSEP ARQUES,25072,250729,CERVERA,28,5,33
2021/2022,25001333,ESCOLA EL CÉRVOL - ZER RIU SET,25073,250735,CERVIÀ DE LES GARRIGUES,5,0,5
2021/2022,25001357,ESCOLA DE CIUTADILLA - ZER GUICIVERVI,25074,250740,CIUTADILLA,2,0,2
2021/2022,25001400,ESCOLA SANT CLIMENT - ZER NARIEDA,25077,250772,COLL DE NARGÓ,4,1,5
2021/2022,25001424,ESCOLA SOL IXENT,25078,250788,CORBINS,13,2,15
2021/2022,25001436,ESCOLA SOL NAIXENT - ZER EL ROMANÍ,25079,250791,CUBELLS,2,1,3
2021/2022,25001473,ESCOLA PORCEL DE CERVERA - ZER PEDRERA,25081,250812,L'ESPLUGA CALBA,3,0,3
2021/2022,25001539,ESCOLA LA CLOSA,25086,250864,ESTERRI D'ÀNEU,13,2,15
2021/2022,25001606,ESCOLA MINYONS D'URGELL,25093,250931,FONDARELLA,11,2,13
2021/2022,25001618,ESCOLA GUILLEM ISARN,25096,250962,LA FULIOLA,13,3,16
2021/2022,25001692,ESCOLA FRANCESC ARENES,25099,250997,GOLMÉS,14,1,15
2021/2022,25001709,ESCOLA SANTA MARGARIDA - ZER ALT BERGUEDÀ,25100,251001,GÓSOL,2,1,3
2021/2022,25001710,ESCOLA DE LA GRANADELLA - ZER ELAIA,25101,251018,LA GRANADELLA,5,0,5
2021/2022,25001722,ESCOLA SANT JAUME - ZER L'OLIVER,25102,251023,LA GRANJA D'ESCARP,6,2,8
2021/2022,25001758,ESCOLA DE GUIMERÀ - ZER GUICIVERVI,25109,251095,GUIMERÀ,2,0,2
2021/2022,25001761,ESCOLA RAMON FAUS I ESTEVE,25110,251109,GUISSONA,37,4,41
2021/2022,25001795,ESCOLA SANT SEBASTIÀ - ZER SERRA LLARGA,25112,251121,IVARS DE NOGUERA,3,1,4
2021/2022,25001801,ESCOLA MARE DE DÉU DE L'HORTA,25113,251137,IVARS D'URGELL,15,1,16
2021/2022,25001886,ESCOLA AESO - ZER PALLARS JUSSÀ,25115,251155,ISONA I CONCA DELLÀ,6,1,7
2021/2022,25001916,ESCOLA L'ESPÍGOL - ZER GARRIGUES ALTES,25118,251180,JUNCOSA,3,0,3
2021/2022,25001928,ESCOLA MANUEL ORTIZ I CASTELLÓ,25119,251193,JUNEDA,25,3,28
2021/2022,25001953,ESCOLA ENRIC FARRENY,25120,251207,LLEIDA,14,4,18
2021/2022,25001990,ESCOLA ANTONI BERGÓS - ZER L'HORTA DE LLEIDA,25120,251207,LLEIDA,2,1,3
2021/2022,25002003,ESCOLA SANTA MARIA DE GARDENY,25120,251207,LLEIDA,23,7,30
2021/2022,25002052,ESCOLA BALÀFIA,25120,251207,LLEIDA,18,4,22
2021/2022,25002064,ESCOLA CAMPS ELISIS,25120,251207,LLEIDA,22,3,25
2021/2022,25002076,ESCOLA CERVANTES,25120,251207,LLEIDA,14,2,16
2021/2022,25002088,ESCOLA RIU SEGRE,25120,251207,LLEIDA,28,7,35
2021/2022,25002091,ESCOLA MAGÍ MORERA I GALÍCIA,25120,251207,LLEIDA,16,5,21
2021/2022,25002106,ESCOLA PARDINYES,25120,251207,LLEIDA,20,2,22
2021/2022,25002121,ESCOLA PRÍNCEP DE VIANA,25120,251207,LLEIDA,20,2,22
2021/2022,25002131,ESCOLA CREU DEL BATLLE - ZER L'HORTA DE LLEIDA,25120,251207,LLEIDA,2,1,3
2021/2022,25002659,ESCOLA SANT JOSEP DE CALASSANÇ,25120,251207,LLEIDA,19,4,23
2021/2022,25002672,ESCOLA DE PRÀCTIQUES I,25120,251207,LLEIDA,17,3,20
2021/2022,25002684,INSTITUT SAMUEL GILI I GAYA,25120,251207,LLEIDA,42,19,61
2021/2022,25002696,INSTITUT MARIUS TORRES,25120,251207,LLEIDA,52,28,80
2021/2022,25002726,INSTITUT GUINDÀVOLS,25120,251207,LLEIDA,43,33,76
2021/2022,25002787,INSTITUT JOAN ORÓ,25120,251207,LLEIDA,50,24,74
2021/2022,25002799,INSTITUT CAPARRELLA,25120,251207,LLEIDA,51,70,121
2021/2022,25002854,ESCOLA EL SEGRIÀ - ZER L'HORTA DE LLEIDA,25120,251207,LLEIDA,7,1,8
2021/2022,25002921,ESCOLA EL VILOT - ZER PONENT,25120,251207,LLEIDA,7,1,8
2021/2022,25002957,ESCOLA ESTUDI ALEJANDRO CASONA,25121,251214,LES,11,0,11
2021/2022,25002970,ESCOLA EL SITJAR,25122,251229,LINYOLA,20,1,21
2021/2022,25002982,ESCOLA DE LLADURS - ZER EL SOLSONÈS,25124,251240,LLADURS,3,1,4
2021/2022,25003019,ESCOLA ARC D'ADÀ - ZER L'OLIVER,25125,251253,LLARDECANS,2,2,4
2021/2022,25003032,ESCOLA DE LLAVORSÍ - ZER ALT PALLARS SOBIRÀ,25126,251266,LLAVORSÍ,4,0,4
2021/2022,25003056,ESCOLA PORTELLA BLANCA - ZER BARIDÀ-BATLLIA,25127,251272,LLES DE CERDANYA,4,0,4
2021/2022,25003093,ESCOLA DE LLOBERA - ZER EL SOLSONÈS,25129,251291,LLOBERA,4,0,4
2021/2022,25003111,ESCOLA DE MASSALCOREIG - ZER L'OLIVER,25131,251312,MASSALCOREIG,4,1,5
2021/2022,25003123,ESCOLA OTOGESA - ZER L'OLIVER,25133,251333,MAIALS,7,1,8
2021/2022,25003135,ESCOLA JOAN ROS I PORTA - ZER EL JONC,25134,251348,MENÀRGUENS,5,0,5
2021/2022,25003147,ESCOLA SANT MIQUEL,25135,251351,MIRALCAMP,13,4,17
2021/2022,25003202,INSTITUT MOLLERUSSA,25137,251370,MOLLERUSSA,37,37,74
2021/2022,25003238,ESCOLA DE BUTSÈNIT - ZER EL SIÓ,25138,251386,MONTGAI,2,0,2
2021/2022,25003241,ESCOLA COLOMINA - ZER EL ROMANÍ,25138,251386,MONTGAI,3,0,3
2021/2022,25003263,ESCOLA PERE SARRET - ZER BARIDÀ-BATLLIA,25139,251399,MONTELLÀ I MARTINET,2,0,2
2021/2022,25003275,ESCOLA RIDOLAINA,25139,251399,MONTELLÀ I MARTINET,6,1,7
2021/2022,25003299,ESCOLA ROSA CAMPÀ,25140,251403,MONTFERRER I CASTELLBÒ,11,2,13
2021/2022,25003305,ESCOLA SANT ISIDRE - ZER LA COMA,25142,251425,MONTOLIU DE LLEIDA,2,2,4
2021/2022,25003330,ESCOLA AIGUADORA - ZER EL SOLSONÈS,25146,251462,NAVÈS,4,1,5
2021/2022,25003469,ESCOLA MIRET I SANS - ZER NARIEDA,25155,251556,ORGANYÀ,6,1,7
2021/2022,25003470,ESCOLA L'ESPÍGOL - ZER MONTSEC,25156,251569,OS DE BALAGUER,6,0,6
2021/2022,25003482,ESCOLA LEANDRE CRISTÒFOL - ZER MONTSEC,25156,251569,OS DE BALAGUER,3,1,4
2021/2022,25003494,ESCOLA ARNAU BERENGUER,25158,251581,EL PALAU D'ANGLESOLA,16,2,18
2021/2022,25003500,ESCOLA DE LES PALLARGUES - ZER LA SEGARRA,25911,259118,ELS PLANS DE SIÓ,3,1,4
2021/2022,25003536,ESCOLA DE LA COMA - ZER EL SOLSONÈS,25163,251636,LA COMA I LA PEDRA,3,0,3
2021/2022,25003551,ESCOLA RAMON GOMBAL - ZER ESPERNALLAC,25164,251641,PENELLES,3,0,3
2021/2022,25003585,ESCOLA SANT MIQUEL - ZER NARIEDA,25165,251654,PERAMOLA,3,0,3
2021/2022,25003627,ESCOLA DE SANT CLIMENÇ - ZER EL SOLSONÈS,25166,251667,PINELL DE SOLSONÈS,2,1,3
2021/2022,25003652,ESCOLA EL ROSER - ZER PLAURCÉN,25168,251689,EL POAL,6,0,6
2021/2022,25003676,ESCOLA ELS SET FOCS - ZER ELAIA,25170,251706,BELLAGUARDA,3,0,3
2021/2022,25003688,ESCOLA ELS RAIERS,25171,251713,LA POBLA DE SEGUR,22,2,24
2021/2022,25003718,ESCOLA DE PONTS,25172,251728,PONTS,19,3,22
2021/2022,25003755,ESCOLA RIBAGORÇANA,25173,251734,EL PONT DE SUERT,17,1,18
2021/2022,25003792,ESCOLA BLANCA DE VILLALONGA - ZER ALT SEGRIÀ,25174,251749,LA PORTELLA,5,0,5
2021/2022,25003809,ESCOLA MONTALBÀ - ZER RIU CORB,25176,251765,PREIXANA,3,1,4
2021/2022,25003810,ESCOLA DE PREIXENS - ZER EL SIÓ,25177,251771,PREIXENS,3,0,3
2021/2022,25003822,ESCOLA DE LES VENTOSES - ZER EL SIÓ,25177,251771,PREIXENS,2,0,2
2021/2022,25003846,ESCOLA EL PUIG - ZER BARIDÀ-BATLLIA,25179,251790,PRULLANS,4,0,4
2021/2022,25003858,ESCOLA DE PUIGVERD D'AGRAMUNT - ZER EL SIÓ,25181,251811,PUIGVERD D'AGRAMUNT,3,0,3
2021/2022,25003861,ESCOLA SANT JORDI,25182,251826,PUIGVERD DE LLEIDA,11,1,12
2021/2022,25003871,ESCOLA MONTSENT DE PALLARS - ZER ALT PALLARS SOBIRÀ,25183,251832,RIALP,6,0,6
2021/2022,25003895,ESCOLA ELS MINAIRONS - ZER ALT PALLARS SOBIRÀ,25901,259010,VALL DE CARDÓS,5,0,5
2021/2022,25003950,ESCOLA ARNAU MIR - ZER URGELLET,25185,251850,RIBERA D'URGELLET,3,1,4
2021/2022,25003974,ESCOLA DE FREIXINET DE SOLSONA - ZER EL SOLSONÈS,25186,251863,RINER,3,1,4
2021/2022,25004000,ESCOLA LA ROSELLA,25189,251898,ROSSELLÓ,22,3,25
2021/2022,25004024,ESCOLA DE SANAÜJA - ZER LA SEGARRA,25191,251919,SANAÜJA,2,1,3
2021/2022,25004036,ESCOLA L'ESTEL,25192,251924,SANT GUIM DE FREIXENET,10,4,14
2021/2022,25004073,ESCOLA MARE DE DÉU DE LA MERCÈ,25194,251945,SANT RAMON,9,3,12
2021/2022,25004085,ESCOLA VALL ONDARA - ZER LA SEGARRA,25905,259059,RIBERA D'ONDARA,3,2,5
2021/2022,25004103,ESCOLA EL TALLAT - ZER RIU CORB,25902,259025,SANT MARTÍ DE RIUCORB,4,1,5
2021/2022,25004115,ESCOLA LA ROCA - ZER L'ERAL,25200,252000,SARROCA DE LLEIDA,3,0,3
2021/2022,25004140,ESCOLA MOSSÈN ALBERT VIVES,25203,252038,LA SEU D'URGELL,27,4,31
2021/2022,25004188,INSTITUT JOAN BRUDIEU,25203,252038,LA SEU D'URGELL,55,32,87
2021/2022,25004218,ESCOLA MIQUEL BARÓ DABAN,25204,252043,SERÒS,19,0,19
2021/2022,25004221,ESCOLA EL TIMÓ - ZER PLAURCÉN,25205,252056,SIDAMON,5,1,6
2021/2022,25004231,ESCOLA DEL SOLERÀS - ZER GARRIGUES ALTES,25206,252069,EL SOLERÀS,3,0,3
2021/2022,25004243,ESCOLA SETELSIS,25207,252075,SOLSONA,30,6,36
2021/2022,25004395,ESCOLA JAUME MIRET,25210,252108,SOSES,19,0,19
2021/2022,25004401,ESCOLA EL ROSER - ZER LA COMA,25211,252115,SUDANELL,8,0,8
2021/2022,25004413,ESCOLA DE SUNYER - ZER L'ERAL,25212,252120,SUNYER,2,1,3
2021/2022,25004462,ESCOLA JACINT VERDAGUER,25217,252173,TÀRREGA,32,3,35
2021/2022,25004498,INSTITUT MANUEL DE PEDROLO,25217,252173,TÀRREGA,37,17,54
2021/2022,25004528,EA ONDARA,25217,252173,TÀRREGA,20,11,31
2021/2022,25004531,ESCOLA ÀNGEL GUIMERÀ,25217,252173,TÀRREGA,33,3,36
2021/2022,25004565,ESCOLA ALFRED POTRONY,25220,252206,TÉRMENS,11,0,11
2021/2022,25004577,ESCOLA DE TÍRVIA - ZER ALT PALLARS SOBIRÀ,25221,252213,TÍRVIA,2,0,2
2021/2022,25004607,ESCOLA SANT GIL,25223,252234,TORÀ,11,1,12
2021/2022,25004644,ESCOLA ESPÍGOL - ZER RIU ONDARA,25225,252252,TORNABOUS,7,0,7
2021/2022,25004656,ESCOLA DE TORREBESSES - ZER L'ERAL,25226,252265,TORREBESSES,2,1,3
2021/2022,25004711,ESCOLA LA CREU,25228,252287,TORREFARRERA,28,5,33
2021/2022,25004723,ESCOLA LA BASSA,25230,252304,TORREGROSSA,14,2,16
2021/2022,25004747,ESCOLA CARRASSUMADA,25232,252326,TORRES DE SEGRE,15,0,15
2021/2022,25004759,ESCOLA EL ROSER - ZER ALT SEGRIÀ,25233,252332,TORRE-SERONA,3,0,3
2021/2022,25004772,ESCOLA VALLDEFLORS,25234,252347,TREMP,28,2,30
2021/2022,25004826,ESCOLA DE TUIXENT - ZER URGELLET,25910,259101,JOSA I TUIXÉN,3,0,3
2021/2022,25004851,ESCOLA SALVADOR ESPRIU,25240,252402,VALLFOGONA DE BALAGUER,14,1,15
2021/2022,25004863,ESCOLA JARDÍ - ZER GUICIVERVI,25242,252424,VERDÚ,3,3,6
2021/2022,25004929,ESCOLA GARONA,25243,252430,VIELHA E MIJARAN,31,4,35
2021/2022,25004966,ESCOLA RAMON PERELLÓ - ZER GUICIVERVI,25244,252445,VILAGRASSA,6,1,7
2021/2022,25004981,ESCOLA VIDAL I ABAD - ZER ALTA RIBAGORÇA,25245,252458,VILALLER,5,0,5
2021/2022,25005016,ESCOLA MARINADA,25248,252483,VILANOVA DE BELLPUIG,12,3,15
2021/2022,25005053,ESCOLA MARE DE DÉU DEL PUIG DE MEIÀ - ZER EL ROMANÍ,25250,252509,VILANOVA DE MEIÀ,3,0,3
2021/2022,25005065,ESCOLA DE VILANOVA DE SEGRIÀ - ZER ALT SEGRIÀ,25251,252516,VILANOVA DE SEGRIÀ,8,0,8
2021/2022,25005077,ESCOLA MOSSÈN TON CLAVÉ - ZER VENT SERÈ,25252,252521,VILA-SANA,8,0,8
2021/2022,25005090,ESCOLA MESTRAL - ZER ARGELAGA,25254,252542,VILANOVA DE LA BARCA,6,1,7
2021/2022,25005107,ESCOLA SANT BONIFACI - ZER RIU SET,25255,252555,VINAIXA,2,1,3
2021/2022,25005119,ESCOLA PINYANA,25013,250138,ALFARRÀS,18,1,19
2021/2022,25005120,ESCOLA TERESA BERGADÀ,25016,250169,ALGUAIRE,20,1,21
2021/2022,25005144,ESCOLA ÀNGEL SERAFÍ I CASANOVAS,25209,252094,SORT,20,2,22
2021/2022,25005171,ESCOLA MESTRE IGNASI PERAIRE,25137,251370,MOLLERUSSA,27,7,34
2021/2022,25005260,INSTITUT RIBERA DEL SIÓ,25003,250030,AGRAMUNT,33,13,46
2021/2022,25005429,INSTITUT ELS PLANELLS,25034,250349,ARTESA DE SEGRE,29,7,36
2021/2022,25005430,ESCOLA JOAN XXIII,25120,251207,LLEIDA,19,8,27
2021/2022,25005442,INSTITUT ESCOLA DEL TREBALL,25120,251207,LLEIDA,42,34,76
2021/2022,25005454,INSTITUT FRANCESC RIBALTA,25207,252075,SOLSONA,37,19,56
2021/2022,25005533,ESCOLA PAU CLARIS,25203,252038,LA SEU D'URGELL,20,1,21
2021/2022,25005545,ESCOLA POMPEU FABRA,25137,251370,MOLLERUSSA,34,1,35
2021/2022,25005557,CEE SILOÉ,25137,251370,MOLLERUSSA,8,2,10
2021/2022,25005582,INSTITUT TERRES DE PONENT,25137,251370,MOLLERUSSA,41,11,52
2021/2022,25005673,ESCOLA JOAN MARAGALL,25120,251207,LLEIDA,19,5,24
2021/2022,25005685,INSTITUT LA SEGARRA,25072,250729,CERVERA,49,22,71
2021/2022,25005727,INSTITUT ALMATÀ,25040,250404,BALAGUER,46,20,66
2021/2022,25005880,ESCOLA FREDERIC GODAS,25120,251207,LLEIDA,27,6,33
2021/2022,25005892,ESCOLA MALDANELL - ZER RIU CORB,25130,251305,MALDÀ,2,1,3
2021/2022,25005909,ESCOLA MOSSÈN RAMON MUNTANYOLA - ZER RIU CORB,25154,251543,ELS OMELLS DE NA GAIA,0,2,2
2021/2022,25005910,ESCOLA ABAT RUERA - ZER PEDRERA,25180,251804,PUIGGRÒS,4,1,5
2021/2022,25005983,ESCOLA SANT SERNI - ZER BARIDÀ-BATLLIA,25175,251752,PRATS I SANSOR,5,0,5
2021/2022,25006069,ESCOLA D'ARDÈVOL - ZER EL SOLSONÈS,25167,251673,PINÓS,3,0,3
2021/2022,25006148,INSTITUT D'OSTALARIA DE LES-VAL D'ARAN,25121,251214,LES,5,6,11
2021/2022,43004256,ESCOLA FERRERIES,43155,431554,TORTOSA,29,7,36
2021/2022,25006227,INSTITUT D'ALMENAR,25021,250215,ALMENAR,29,17,46
2021/2022,25006239,INSTITUT D'ARAN,25243,252430,VIELHA E MIJARAN,39,16,55
2021/2022,25006240,INSTITUT EL PONT DE SUERT,25173,251734,EL PONT DE SUERT,29,17,46
2021/2022,25006252,EOI DE LLEIDA,25120,251207,LLEIDA,33,9,42
2021/2022,25006264,ESCOLA ESPIGA,25120,251207,LLEIDA,26,3,29
2021/2022,25006276,ESCOLA SANT JORDI,25120,251207,LLEIDA,14,2,16
2021/2022,25006288,INSTITUT DE TREMP,25234,252347,TREMP,36,24,60
2021/2022,25006291,INSTITUT HUG ROGER III,25209,252094,SORT,24,15,39
2021/2022,25006409,ESCOLA JOC DE LA BOLA,25120,251207,LLEIDA,31,4,35
2021/2022,25006410,CFA SEGRIÀ,25120,251207,LLEIDA,7,4,11
2021/2022,25006483,INSTITUT CANIGÓ,25019,250194,ALMACELLES,30,16,46
2021/2022,25006495,INSTITUT JOSEP LLADONOSA,25120,251207,LLEIDA,40,24,64
2021/2022,25006501,ESCOLA ALBA,25078,250788,CORBINS,26,3,29
2021/2022,25006513,INSTITUT MANUEL DE MONTSUAR,25120,251207,LLEIDA,37,14,51
2021/2022,25006525,INSTITUT JOSEP VALLVERDÚ,25058,250582,LES BORGES BLANQUES,49,17,66
2021/2022,25006549,ESCOLA D'ESPLUGA DE SERRA - ZER ALTA RIBAGORÇA,25234,252347,TREMP,1,0,1
2021/2022,25006574,INSTITUT DE PONTS,25172,251728,PONTS,17,8,25
2021/2022,25006598,INSTITUT LO PLA D'URGELL,25050,250501,BELLPUIG,35,19,54
2021/2022,25006720,INSTITUT D'HOTELERIA I TURISME,25120,251207,LLEIDA,11,17,28
2021/2022,25006732,INSTITUT TORREVICENS,25120,251207,LLEIDA,106,26,132
2021/2022,25006744,CEE ESPERANÇA,25120,251207,LLEIDA,10,3,13
2021/2022,25006771,INSTITUT RONDA,25120,251207,LLEIDA,75,12,87
2021/2022,25006781,INSTITUT ALFONS COSTAFREDA,25217,252173,TÀRREGA,55,28,83
2021/2022,25007025,INSTITUT MORELLÓ,25086,250864,ESTERRI D'ÀNEU,6,6,12
2021/2022,25007153,INSTITUT D'ALCARRÀS,25011,250117,ALCARRÀS,49,17,66
2021/2022,25007189,INSTITUT MARIA RÚBIES,25120,251207,LLEIDA,41,18,59
2021/2022,25007499,INSTITUT L'OLIVERA,25101,251018,LA GRANADELLA,9,3,12
2021/2022,25007505,INSTITUT DE GUISSONA,25110,251109,GUISSONA,49,21,70
2021/2022,25007517,INSTITUT LA SERRA,25137,251370,MOLLERUSSA,37,18,55
2021/2022,25007529,INSTITUT SERÒS,25204,252043,SERÒS,29,15,44
2021/2022,25007611,CFA JOAN CARLES I,25120,251207,LLEIDA,7,5,12
2021/2022,25007700,INSTITUT ERMENGOL IV,25047,250479,BELLCAIRE D'URGELL,27,7,34
2021/2022,25007761,ZER GUICIVERVI,25244,252445,VILAGRASSA,3,1,4
2021/2022,25007773,ZER LA SEGARRA,25905,259059,RIBERA D'ONDARA,2,2,4
2021/2022,25007797,ZER BARIDÀ-BATLLIA,25139,251399,MONTELLÀ I MARTINET,3,1,4
2021/2022,25007803,ZER ALT PALLARS SOBIRÀ,25126,251266,LLAVORSÍ,4,0,4
2021/2022,25007815,ZER ELAIA,25101,251018,LA GRANADELLA,1,2,3
2021/2022,25007827,ZER NARIEDA,25155,251556,ORGANYÀ,3,1,4
2021/2022,25007839,ZER PALLARS JUSSÀ,25115,251155,ISONA I CONCA DELLÀ,2,2,4
2021/2022,25007840,ZER MONTSEC,25037,250371,LES AVELLANES I SANTA LINYA,4,1,5
2021/2022,25007852,ZER EL SIÓ,25138,251386,MONTGAI,3,1,4
2021/2022,25007864,ZER URGELLET,25203,252038,LA SEU D'URGELL,3,1,4
2021/2022,25007876,ZER RIU CORB,25046,250463,BELIANES,4,1,5
2021/2022,25007888,ZER GARRIGUES ALTES,25118,251180,JUNCOSA,2,2,4
2021/2022,25007891,ZER ALTA RIBAGORÇA,25245,252458,VILALLER,4,2,6
2021/2022,25007906,ZER SERRA LLARGA,25015,250156,ALGERRI,2,2,4
2021/2022,25007918,ZER L'OLIVER,25133,251333,MAIALS,3,1,4
2021/2022,25007921,ZER L'HORTA DE LLEIDA,25120,251207,LLEIDA,4,0,4
2021/2022,25007931,ZER VAL D'ARAN,25025,250254,NAUT ARAN,4,0,4
2021/2022,25007943,ZER PLAURCÉN,25168,251689,EL POAL,4,1,5
2021/2022,25007992,ESCOLA D'ALMENAR,25021,250215,ALMENAR,17,4,21
2021/2022,25008042,ZER RIU SET,25009,250096,L'ALBI,3,2,5
2021/2022,25008054,ZER VALL DE L'ARANYÓ,25067,250674,CASTELLDANS,2,1,3
2021/2022,25008066,ZER ESPERNALLAC,25070,250707,CASTELLSERÀ,2,3,5
2021/2022,25008078,ZER EL ROMANÍ,25138,251386,MONTGAI,3,2,5
2021/2022,25008081,ZER EL JONC,25062,250621,CAMARASA,3,1,4
2021/2022,25008091,ZER VENT SERÈ,25068,250680,CASTELLNOU DE SEANA,4,1,5
2021/2022,25008108,ZER L'ERAL,25200,252000,SARROCA DE LLEIDA,4,0,4
2021/2022,25008145,ZER ALT SEGRIÀ,25251,252516,VILANOVA DE SEGRIÀ,3,1,4
2021/2022,25008157,ZER RIU ONDARA,25225,252252,TORNABOUS,3,1,4
2021/2022,25008212,ESCOLA PRÀCTIQUES II,25120,251207,LLEIDA,28,3,31
2021/2022,25008224,ZER ARGELAGA,25254,252542,VILANOVA DE LA BARCA,2,1,3
2021/2022,25008236,ZER PEDRERA,25081,250812,L'ESPLUGA CALBA,2,1,3
2021/2022,25008352,INSTITUT DE LA POBLA DE SEGUR,25171,251713,LA POBLA DE SEGUR,22,9,31
2021/2022,25008534,ESCOLA DE LA VALL DE BOÍ - ZER ALTA RIBAGORÇA,25043,250432,LA VALL DE BOÍ,7,1,8
2021/2022,25008546,EOI DE TÀRREGA,25217,252173,TÀRREGA,5,1,6
2021/2022,25008558,EOI DE LA SEU D'URGELL,25203,252038,LA SEU D'URGELL,6,2,8
2021/2022,25008561,CFA BALAGUER,25040,250404,BALAGUER,1,3,4
2021/2022,25008571,CFA JOAN COMORERA,25072,250729,CERVERA,1,3,4
2021/2022,25008583,CFA LA SEU D'URGELL,25203,252038,LA SEU D'URGELL,6,0,6
2021/2022,25008595,CFA TÀRREGA,25217,252173,TÀRREGA,4,3,7
2021/2022,25008625,CFA MOLLERUSSA,25137,251370,MOLLERUSSA,5,4,9
2021/2022,25008649,ESCOLA FRANCESCO TONUCCI,25120,251207,LLEIDA,18,2,20
2021/2022,25008741,CFA VAL D'ARAN,25243,252430,VIELHA E MIJARAN,2,1,3
2021/2022,25008753,CFA SOLSONÈS,25207,252075,SOLSONA,6,0,6
2021/2022,25008765,ESCOLA LA VALL FOSCA - ZER PALLARS JUSSÀ,25227,252271,LA TORRE DE CABDELLA,5,0,5
2021/2022,25008777,ESCOLA PARC DE L'AIGUA,25120,251207,LLEIDA,27,5,32
2021/2022,25008789,ESCOLA MONT-ROIG,25040,250404,BALAGUER,19,3,22
2021/2022,25008790,ESCOLA MARIA-MERCÈ MARÇAL,25217,252173,TÀRREGA,22,6,28
2021/2022,25008893,ESCOLA PARC DEL SALADAR,25011,250117,ALCARRÀS,36,6,42
2021/2022,25008923,CFA ENRIC GRANADOS,25120,251207,LLEIDA,8,6,14
2021/2022,25008935,ESCOLA LA RÀPITA - ZER EL JONC,25240,252402,VALLFOGONA DE BALAGUER,5,0,5
2021/2022,25008984,CFA TREMP,25234,252347,TREMP,3,0,3
2021/2022,25009009,ZER EL SOLSONÈS,25207,252075,SOLSONA,5,0,5
2021/2022,25009034,ESCOLA CIUTAT JARDÍ,25120,251207,LLEIDA,28,4,32
2021/2022,25009071,ESCOLA PAÏSOS CATALANS,25120,251207,LLEIDA,31,2,33
2021/2022,25009095,ESCOLA LES SAVINES,25072,250729,CERVERA,15,2,17
2021/2022,25009101,ESCOLA EL VINYET,25207,252075,SOLSONA,15,2,17
2021/2022,25009113,ESCOLA MESTRE RAMON ESTADELLA I TORRADEFLOT,25110,251109,GUISSONA,25,0,25
2021/2022,25009149,ESCOLA PINYANA,25120,251207,LLEIDA,19,5,24
2021/2022,25009186,INSTITUT LA VALIRA,25203,252038,LA SEU D'URGELL,13,9,22
2021/2022,25009344,ESCOLA LA MITJANA,25120,251207,LLEIDA,28,3,31
2021/2022,25009356,ESCOLA LES ARRELS,25137,251370,MOLLERUSSA,15,4,19
2021/2022,25009368,ESCOLA LA VALIRA,25203,252038,LA SEU D'URGELL,6,0,6
2021/2022,25009721,INSTITUT D'ALPICAT,25023,250236,ALPICAT,19,10,29
2021/2022,25009733,INSTITUT JOAN SOLÀ,25228,252287,TORREFARRERA,36,17,53
2021/2022,25009800,ESCOLA TORRELAMEU - ZER ARGELAGA,25231,252311,TORRELAMEU,5,0,5
2021/2022,25009836,INSTITUT LA MITJANA,25120,251207,LLEIDA,46,7,53
2021/2022,25010085,ESCOLA JOSEP MAÑÉ I GAVALDÀ - ZER PONENT,25120,251207,LLEIDA,5,0,5
2021/2022,25010127,INSTITUT CASTELL DELS TEMPLERS,25120,251207,LLEIDA,19,12,31
2021/2022,25010231,ESCOLA DE SALÀS DE PALLARS - ZER PALLARS JUSSÀ,25190,251902,SALÀS DE PALLARS,3,0,3
2021/2022,25010280,INSTITUT ESCOLA TORRE QUERALT,25120,251207,LLEIDA,35,6,41
2021/2022,25010310,INSTITUT DE MOLLERUSSA IV,25137,251370,MOLLERUSSA,23,4,27
2021/2022,25010334,INSTITUT ESCOLA MAGRANERS,25120,251207,LLEIDA,21,9,30
2021/2022,25010358,INSTITUT ESCOLA VALL DE LORD,25193,251930,SANT LLORENÇ DE MORUNYS,14,7,21
2021/2022,25010361,INSTITUT CENTRE D'ESPORTS DE MUNTANYA DEL PALLARS,25171,251713,LA POBLA DE SEGUR,6,10,16
2021/2022,25010383,INSTITUT ESCOLA D'OLIANA,25149,251497,OLIANA,26,5,31
2021/2022,43000020,ESCOLA SANT MIQUEL,43001,430017,AIGUAMÚRCIA,4,3,7
2021/2022,43000081,ESCOLA JOAN BAPTISTA SERRA,43004,430043,ALCANAR,42,6,48
2021/2022,43000135,ESCOLA MARE DE DÉU DEL REMEI,43005,430056,ALCOVER,30,4,34
2021/2022,43000184,ESCOLA TERESA SALVAT I LLAURADÓ - ZER BAIX CAMP NORD,43007,430075,L'ALEIXAR,5,1,6
2021/2022,43000214,ESCOLA JOSEP FUSTÉ,43009,430094,ALFORJA,16,0,16
2021/2022,43000226,ESCOLA LA BARQUERA - ZER ATZAVARA,43010,430108,ALIÓ,5,0,5
2021/2022,43000251,ESCOLA LA PORTALADA,43012,430120,ALTAFULLA,27,4,31
2021/2022,43000263,ESCOLA SANT JORDI,43013,430136,L'AMETLLA DE MAR,34,4,38
2021/2022,43000275,ESCOLA MIQUEL GRANELL,43014,430141,AMPOSTA,24,7,31
2021/2022,43000329,INSTITUT RAMON BERENGUER IV,43014,430141,AMPOSTA,51,30,81
2021/2022,43000378,ESCOLA SANT JULIÀ,43016,430167,L'ARBOÇ,29,8,37
2021/2022,43000421,ESCOLA LA MIRANDA - ZER PORTS-ALGARS,43018,430189,ARNES,5,1,6
2021/2022,43000433,ESCOLA SANT MIQUEL,43019,430192,ASCÓ,14,2,16
2021/2022,43000470,ESCOLA VALLDEMUR - ZER CONCA DE BARBERÀ,43021,430213,BARBERÀ DE LA CONCA,6,1,7
2021/2022,43000512,ESCOLA EL SARRAÍ - ZER BAIX PRIORAT,43023,430234,BELLMUNT DEL PRIORAT,1,2,3
2021/2022,43000548,ESCOLA LA MUNTANYETA,43024,430249,BELLVEI,16,4,20
2021/2022,43000551,ESCOLA LLORENÇ VALLESPÍ I VIDIELLA - ZER RIU I SERRA,43025,430252,BENIFALLET,3,2,5
2021/2022,43000561,ESCOLA ANTONI NAT - ZER BENISSANET-MIRAVET,43026,430265,BENISSANET,8,0,8
2021/2022,43000597,ESCOLA ULL DEL VENT,43028,430287,LA BISBAL DEL PENEDÈS,18,7,25
2021/2022,43000603,ESCOLA DE BLANCAFORT - ZER POBLET,43029,430290,BLANCAFORT,3,1,4
2021/2022,43000615,ESCOLA L'ESTEL - ZER ELS CEPS,43030,430304,BONASTRE,4,5,9
2021/2022,43000627,ESCOLA ROCABRUNA,43031,430311,LES BORGES DEL CAMP,12,4,16
2021/2022,43000639,ESCOLA SANT BLAI - ZER TERRA ALTA-CENTRE,43032,430326,BOT,4,2,6
2021/2022,43000640,ESCOLA MARE DE DÉU DE LA CANDELA,43033,430332,BOTARELL,15,0,15
2021/2022,43000652,ESCOLA SANT JAUME DE BRÀFIM - ZER ATZAVARA,43034,430347,BRÀFIM,8,2,10
2021/2022,43000676,ESCOLA EL CASTELL - ZER MONTSANT,43035,430350,CABACÉS,4,0,4
2021/2022,43000688,ESCOLA DE CABRA DEL CAMP - ZER LA PARELLADA,43036,430363,CABRA DEL CAMP,3,2,5
2021/2022,43000706,ESCOLA SANTA CREU DE CALAFELL,43037,430379,CALAFELL,36,7,43
2021/2022,43000721,ESCOLA MOSSÈN JACINT VERDAGUER,43037,430379,CALAFELL,27,5,32
2021/2022,43000779,INSTITUT RAMON BERENGUER IV,43038,430385,CAMBRILS,42,28,70
2021/2022,43000792,ESCOLA SANT ISIDRE - ZER LES VINYES,43040,430402,CAPÇANES,3,1,4
2021/2022,43000809,ESCOLA LA GESSERA - ZER PORTS-ALGARS,43041,430419,CASERES,1,2,3
2021/2022,43000871,ESCOLA JAUME I,43044,430445,LA SÉNIA,31,6,37
2021/2022,43000895,ESCOLA MOSSÈN RAMON BERGADÀ,43047,430477,CONSTANTÍ,27,9,36
2021/2022,43000950,ESCOLA DOCTOR FERRAN - ZER TERRA ALTA-CENTRE,43048,430483,CORBERA D'EBRE,6,1,7
2021/2022,43000998,ESCOLA POMPEU FABRA,43051,430516,CUNIT,22,5,27
2021/2022,43001000,ESCOLA DE XERTA,43052,430521,XERTA,9,1,10
2021/2022,43001036,ESCOLA MARTÍ POCH,43054,430542,L'ESPLUGA DE FRANCOLÍ,13,2,15
2021/2022,43001051,ESCOLA ANTONI VILANOVA,43055,430555,FALSET,22,3,25
2021/2022,43001097,ESCOLA LOS CASTELLETS - ZER TERRA ALTA NORD,43056,430568,LA FATARELLA,6,0,6
2021/2022,43001115,ESCOLA MARE DE DÉU DE L'ESPERANÇA - ZER LA PARELLADA,43059,430593,FIGUEROLA DEL CAMP,5,0,5
2021/2022,43001127,ESCOLA ENRIC GRAU I FONTSERÈ,43060,430607,FLIX,19,3,22
2021/2022,43001231,ESCOLA PUIG CAVALLER,43064,430640,GANDESA,22,5,27
2021/2022,43001280,ESCOLA PÀMIES - ZER LA FONT DE L'AIGUADÍ,43067,430672,GINESTAR,6,1,7
2021/2022,43001310,ESCOLA LLICORELLA - ZER L'AGLÀ,43069,430691,GRATALLOPS,4,0,4
2021/2022,43001334,ESCOLA SANT FELIU - ZER LES VINYES,43070,430705,ELS GUIAMETS,2,1,3
2021/2022,43001346,ESCOLA MONTSAGRE,43071,430712,HORTA DE SANT JOAN,7,2,9
2021/2022,43001361,ESCOLA LES COMETES,43074,430748,LLORENÇ DEL PENEDÈS,19,6,25
2021/2022,43001383,ESCOLA ANICET VILLAR - ZER LES VINYES,43076,430764,MARÇÀ,3,1,4
2021/2022,43001395,ESCOLA TERESA SUBIRATS I MESTRE - ZER MONTSIÀ,43077,430770,MAS DE BARBERANS,3,2,5
2021/2022,43001437,ESCOLA ROSA GISBERT - ZER MONTSIÀ,43078,430786,MASDENVERGE,6,2,8
2021/2022,43001462,ESCOLA ELS TIL·LERS - ZER EL FRANCOLÍ,43080,430803,LA MASÓ,4,0,4
2021/2022,43001498,ESCOLA ONZE DE SETEMBRE - ZER BAIX PRIORAT,43082,430825,EL MASROIG,4,1,5
2021/2022,43001553,ESCOLA LES MURALLES,43086,430862,MONTBLANC,30,3,33
2021/2022,43001607,ESCOLA JOSEP M. SOLER I GENÉ,43088,430884,MONTBRIÓ DEL CAMP,19,6,25
2021/2022,43001656,ESCOLA TERESA GODES I DOMÈNECH,43090,430901,EL MONTMELL,11,4,15
2021/2022,43001668,ESCOLA MARE DE DÉU DE LA ROCA,43092,430923,MONT-ROIG DEL CAMP,24,7,31
2021/2022,43001681,ESCOLA LLUÍS VIÑAS I VIÑOLES,43093,430939,MÓRA D'EBRE,29,2,31
2021/2022,43001735,ESCOLA VENTURA GASSOL,43095,430957,EL MORELL,27,4,31
2021/2022,43001796,ESCOLA SANT SEBASTIÀ - ZER ATZAVARA,43098,430982,NULLES,5,3,8
2021/2022,43001826,ESCOLA SANT SEBASTIÀ,43100,431009,ELS PALLARESOS,19,4,23
2021/2022,43001851,ESCOLA SANT ROC - ZER RIU I SERRA,43102,431021,PAÜLS,4,1,5
2021/2022,43001942,ESCOLA CÈSAR MARTINELL - ZER TERRA ALTA-CENTRE,43106,431068,EL PINELL DE BRAI,3,4,7
2021/2022,43001954,ESCOLA ANTONI TOUS - ZER CONCA DE BARBERÀ,43107,431074,PIRA,4,2,6
2021/2022,43001966,ESCOLA SANT RAMON,43108,431080,EL PLA DE SANTA MARIA,14,2,16
2021/2022,43002016,ESCOLA L'AMETLLER - ZER TERRA ALTA NORD,43110,431107,LA POBLA DE MASSALUCA,3,1,4
2021/2022,43002053,ESCOLA GARBÍ - ZER MONTSANT-SERRA DE PRADES,43112,431129,POBOLEDA,2,2,4
2021/2022,43002144,ESCOLA MARE DE DÉU DE LA FONTCALDA - ZER PORTS-ALGARS,43117,431172,PRAT DE COMTE,3,0,3
2021/2022,43002171,ESCOLA JOAN PLANA,43119,431191,PUIGPELAT,15,0,15
2021/2022,43002211,ESCOLA PRAT DE LA RIBA,43123,431233,REUS,16,3,19
2021/2022,43002235,ESCOLA POMPEU FABRA,43123,431233,REUS,19,4,23
2021/2022,43002247,ESCOLA MISERICÒRDIA,43123,431233,REUS,18,5,23
2021/2022,43002259,ESCOLA MARIÀ FORTUNY,43123,431233,REUS,31,5,36
2021/2022,43002260,ESCOLA CIUTAT DE REUS,43123,431233,REUS,5,0,5
2021/2022,43002272,ESCOLA GENERAL PRIM,43123,431233,REUS,21,4,25
2021/2022,43002570,INSTITUT GAUDÍ,43123,431233,REUS,69,24,93
2021/2022,43002582,INSTITUT SALVADOR VILASECA,43123,431233,REUS,48,22,70
2021/2022,43002594,INSTITUT BAIX CAMP,43123,431233,REUS,98,50,148
2021/2022,43002661,ESCOLA SANT AGUSTÍ - ZER EBRE,43125,431251,RIBA-ROJA D'EBRE,7,0,7
2021/2022,43002752,ESCOLA BEAT BONAVENTURA GRAN,43129,431299,RIUDOMS,29,3,32
2021/2022,43002776,ESCOLA SALVADOR ESPRIU,43131,431310,RODA DE BERÀ,22,8,30
2021/2022,43002831,ESCOLA MESTRE MARCEL·LÍ DOMINGO,43133,431331,ROQUETES,36,7,43
2021/2022,43002892,ESCOLA CARLES III,43136,431362,SANT CARLES DE LA RÀPITA,34,10,44
2021/2022,43003008,ESCOLA JAUME BALMES,43138,431384,SANTA BÀRBARA,22,5,27
2021/2022,43003011,ESCOLA COR DE ROURE,43139,431397,SANTA COLOMA DE QUERALT,13,3,16
2021/2022,43003069,ESCOLA SALVADOR NINOT,43142,431423,SARRAL,14,2,16
2021/2022,43003082,ESCOLA GUILLEM DE CLARAMUNT,43144,431444,LA SECUITA,13,3,16
2021/2022,43003100,ESCOLA ABEL FERRATER,43145,431457,LA SELVA DEL CAMP,26,4,30
2021/2022,43003124,ESCOLA SAGRAT COR - ZER CONCA DE BARBERÀ,43147,431476,SOLIVELLA,4,1,5
2021/2022,43003136,ESCOLA BONAVISTA,43148,431482,TARRAGONA,34,6,40
2021/2022,43003185,ESCOLA LA CANONJA,43907,439076,LA CANONJA,32,7,39
2021/2022,43003227,ESCOLA SANT SALVADOR,43148,431482,TARRAGONA,28,10,38
2021/2022,43003306,ESCOLA SERRALLO,43148,431482,TARRAGONA,19,1,20
2021/2022,43003321,ESCOLA SANT PERE I SANT PAU,43148,431482,TARRAGONA,19,3,22
2021/2022,43003641,INSTITUT ANTONI DE MARTÍ I FRANQUÈS,43148,431482,TARRAGONA,81,41,122
2021/2022,43003653,INSTITUT COMTE DE RIUS,43148,431482,TARRAGONA,35,57,92
2021/2022,43003690,ESCOLA DE PRÀCTIQUES,43148,431482,TARRAGONA,26,5,31
2021/2022,43003720,ESCOLA EL MIRACLE,43148,431482,TARRAGONA,20,1,21
2021/2022,43003732,INSTITUT PONS D'ICART,43148,431482,TARRAGONA,42,15,57
2021/2022,43003756,ESCOLA TORREFORTA,43148,431482,TARRAGONA,29,6,35
2021/2022,43003768,ESCOLA ELS ÀNGELS,43148,431482,TARRAGONA,34,3,37
2021/2022,43003801,ESCOLA LA PINEDA - ZER RIU AVALL,43149,431495,TIVENYS,6,1,7
2021/2022,43003835,ESCOLA JOSEP RIBA - ZER LES VINYES,43150,431508,TIVISSA,1,2,3
2021/2022,43003847,ESCOLA MARCEL·LÍ DOMINGO,43150,431508,TIVISSA,12,1,13
2021/2022,43003884,ESCOLA ANTONI ROIG,43153,431536,TORREDEMBARRA,28,5,33
2021/2022,43003951,ESCOLA BÍTEM - ZER RIU AVALL,43155,431554,TORTOSA,7,1,8
2021/2022,43003975,ESCOLA SANT ÀNGEL,43903,439039,CAMARLES,12,5,17
2021/2022,43003987,ESCOLA PORT RODÓ - ZER MESTRAL,43155,431554,TORTOSA,10,0,10
2021/2022,43004013,ESCOLA SANT MIQUEL,43901,439018,DELTEBRE,27,7,34
2021/2022,43004037,ESCOLA MARIA GARCÍA I CABANES,43904,439044,L'ALDEA,14,4,18
2021/2022,43004050,ESCOLA 21 D'ABRIL,43904,439044,L'ALDEA,13,3,16
2021/2022,43004074,ESCOLA L'ASSUMPCIÓ,43901,439018,DELTEBRE,19,5,24
2021/2022,43004116,ESCOLA DEL LLIGALLO DEL GÀNGUIL - ZER MESTRAL,43903,439039,CAMARLES,6,1,7
2021/2022,43004189,ESCOLA SANT JAUME,43902,439023,SANT JAUME D'ENVEJA,20,0,20
2021/2022,43004232,ESCOLA LA MERCÈ,43155,431554,TORTOSA,21,6,27
2021/2022,43004268,ESCOLA REMOLINS,43155,431554,TORTOSA,18,2,20
2021/2022,43004438,INSTITUT DERTOSA,43155,431554,TORTOSA,62,37,99
2021/2022,43004441,INSTITUT DE L'EBRE,43155,431554,TORTOSA,60,66,126
2021/2022,43004463,ESCOLA RAMÓN Y CAJAL,43156,431567,ULLDECONA,32,8,40
2021/2022,43004487,ESCOLA MONTSANT - ZER MONTSANT-SERRA DE PRADES,43157,431573,ULLDEMOLINS,3,1,4
2021/2022,43004505,ESCOLA MARE DE DÉU DEL ROSER,43160,431606,VALLMOLL,14,1,15
2021/2022,43004517,ESCOLA ROCABRUNA - ZER EL FRANCOLÍ,43161,431613,VALLS,7,1,8
2021/2022,43004529,ESCOLA MARE DE DÉU DE LA CANDELA,43161,431613,VALLS,18,3,21
2021/2022,43004530,ESCOLA BALTASAR SEGÚ,43161,431613,VALLS,16,6,22
2021/2022,43004608,INSTITUT NARCÍS OLLER,43161,431613,VALLS,66,25,91
2021/2022,43004611,INSTITUT JAUME HUGUET,43161,431613,VALLS,66,51,117
2021/2022,43004633,ESCOLA EUGENI D'ORS,43161,431613,VALLS,30,6,36
2021/2022,43004657,ESCOLA MESTRAL,43162,431628,VANDELLÒS I L'HOSPITALET DE L'INFANT,37,6,43
2021/2022,43004700,ESCOLA VALDELORS,43162,431628,VANDELLÒS I L'HOSPITALET DE L'INFANT,8,3,11
2021/2022,43004748,ESCOLA ÀNGEL GUIMERÀ,43163,431634,EL VENDRELL,34,5,39
2021/2022,43004797,INSTITUT BAIX PENEDÈS,43163,431634,EL VENDRELL,47,21,68
2021/2022,43004803,INSTITUT ANDREU NIN,43163,431634,EL VENDRELL,71,68,139
2021/2022,43004815,ESCOLA PAU CASALS,43163,431634,EL VENDRELL,23,10,33
2021/2022,43004864,ESCOLA PERE VIRGILI,43166,431665,VILALLONGA DEL CAMP,23,4,27
2021/2022,43004888,ESCOLA FONT DE L'ARC - ZER BAIX CAMP SUD,43167,431671,VILANOVA D'ESCORNALBOU,6,1,7
2021/2022,43004921,ESCOLA BERNARDÍ TOLRÀ,43170,431704,VILA-RODONA,12,3,15
2021/2022,43004931,ESCOLA SANTA MARIA DEL MAR,43905,439057,SALOU,32,3,35
2021/2022,43004979,ESCOLA TORROJA I MIRET,43171,431711,VILA-SECA,26,6,32
2021/2022,43005005,ESCOLA SANT BERNAT CALVÓ,43171,431711,VILA-SECA,28,3,31
2021/2022,43005017,ESCOLA DEL MONTGOI - ZER POBLET,43172,431726,VILAVERD,2,1,3
2021/2022,43005081,ESCOLA MARE DE DÉU DELS TORRENTS - ZER POBLET,43176,431763,VIMBODÍ I POBLET,6,0,6
2021/2022,43005108,ESCOLA LES ERES - ZER RIBERA D'EBRE NORD,43177,431779,VINEBRE,6,0,6
2021/2022,43005121,ESCOLA SANTA CATERINA,43178,431785,VINYOLS I ELS ARCS,11,4,15
2021/2022,43005133,ESCOLA MARE DE DÉU DEL PRIORAT,43020,430206,BANYERES DEL PENEDÈS,14,3,17
2021/2022,43005145,ESCOLA ELS AMETLLERS,43111,431114,LA POBLA DE MONTORNÈS,11,5,16
2021/2022,43005157,ESCOLA MONTOLIU,43126,431264,LA RIERA DE GAIÀ,13,3,16
2021/2022,43005169,ESCOLA PAU DELCLÒS,43148,431482,TARRAGONA,29,5,34
2021/2022,43005170,ESCOLA LA FLORESTA,43148,431482,TARRAGONA,15,2,17
2021/2022,43005194,ESCOLA MEDITERRANI,43906,439060,L'AMPOLLA,14,4,18
2021/2022,43005297,ESCOLA JOAN PERUCHO,43002,430022,ALBINYANA,10,5,15
2021/2022,43005303,ESCOLA SANT JORDI - ZER RIU I SERRA,43006,430069,ALDOVER,6,0,6
2021/2022,43005315,ESCOLA D'ALFARA DE CARLES - ZER MONT CARO,43008,430081,ALFARA DE CARLES,4,0,4
2021/2022,43005327,ESCOLA RAMON SUGRAÑES,43011,430115,ALMOSTER,12,4,16
2021/2022,43005339,ESCOLA MONTSANT - ZER MONTSANT,43027,430271,LA BISBAL DE FALSET,3,0,3
2021/2022,43005340,ESCOLA SANTA ANNA,43042,430424,CASTELLVELL DEL CAMP,15,2,17
2021/2022,43005364,ESCOLA LES ERES,43050,430509,CREIXELL,16,3,19
2021/2022,43005376,ESCOLA PUIGMARÍ - ZER BAIX CAMP SUD,43053,430537,DUESAIGÜES,1,2,3
2021/2022,43005388,ESCOLA MESTRE JOSEP RONCERO I PALLARÈS - ZER MONTSIÀ,43062,430629,FREGINALS,3,1,4
2021/2022,43005391,ESCOLA SANT LLORENÇ - ZER MONTSIÀ,43063,430635,LA GALERA,3,3,6
2021/2022,43005406,ESCOLA EL VERGER - ZER RIBERA D'EBRE NORD,43065,430653,GARCIA,5,0,5
2021/2022,43005418,ESCOLA SANT SALVADOR - ZER MONTSIÀ,43068,430688,GODALL,4,0,4
2021/2022,43005421,ESCOLA BERENGUER DE MONTOLIU - ZER ELS CEPS,43079,430799,MASLLORENÇ,5,2,7
2021/2022,43005443,ESCOLA ROC LLOP I CONVALIA - ZER BENISSANET-MIRAVET,43084,430846,MIRAVET,5,1,6
2021/2022,43005455,ESCOLA PIUS XII - ZER L'AGLÀ,43085,430859,EL MOLAR,3,1,4
2021/2022,43005467,ESCOLA LES CODINETES,43097,430976,LA NOU DE GAIÀ,12,2,14
2021/2022,43005479,ESCOLA 1 D'ABRIL - ZER EBRE,43099,430995,LA PALMA D'EBRE,3,0,3
2021/2022,43005480,ESCOLA MARE DE DÉU DEL LLEDÓ,43109,431093,LA POBLA DE MAFUMET,25,7,32
2021/2022,43005492,ESCOLA SANTA MAGDALENA - ZER LA PARELLADA,43113,431135,EL PONT D'ARMENTERA,3,2,5
2021/2022,43005509,ESCOLA ROSSEND GIOL - ZER BAIX PRIORAT,43114,431140,PORRERA,1,2,3
2021/2022,43005510,ESCOLA SERRA DE PRADES - ZER MONTSANT-SERRA DE PRADES,43116,431166,PRADES,4,1,5
2021/2022,43005522,ESCOLA SANTA MARINA,43118,431188,PRATDIP,4,5,9
2021/2022,43005534,ESCOLA LES ERES DE RASQUERA - ZER LA FONT DE L'AIGUADÍ,43121,431212,RASQUERA,8,0,8
2021/2022,43005546,ESCOLA DE LA RIBA - ZER EL FRANCOLÍ,43124,431248,LA RIBA,3,3,6
2021/2022,43005558,ESCOLA SANT MATEU,43127,431270,RIUDECANYES,10,1,11
2021/2022,43005561,ESCOLA MARE DE DÉU DEL ROSER,43128,431286,RIUDECOLS,11,1,12
2021/2022,43005571,ESCOLA LES COMES,43132,431325,RODONYÀ,13,1,14
2021/2022,43005583,ESCOLA ELS QUATRE VENTS,43137,431378,SANT JAUME DELS DOMENYS,17,5,22
2021/2022,43005595,ESCOLA LA PARELLADA,43140,431401,SANTA OLIVA,14,9,23
2021/2022,43005601,ESCOLA EL TORMO - ZER RIBERA D'EBRE NORD,43152,431520,LA TORRE DE L'ESPANYOL,5,0,5
2021/2022,43005613,ESCOLA SETZE DE FEBRER - ZER MEDITERRÀNIA,43902,439023,SANT JAUME D'ENVEJA,3,1,4
2021/2022,43005625,ESCOLA SANT ANTONI ABAT - ZER MONT CARO,43155,431554,TORTOSA,5,0,5
2021/2022,43005637,ESCOLA MANUEL DE CASTELLVÍ I FELIU - ZER ATZAVARA,43165,431652,VILABELLA,7,0,7
2021/2022,43005650,ESCOLA EL DIVÍ MESTRE - ZER TERRA ALTA NORD,43175,431750,VILALBA DELS ARCS,5,1,6
2021/2022,43005662,ESCOLA JOSEP NIN,43135,431359,SALOMÓ,6,4,10
2021/2022,43005674,ESCOLA RAVAL DE CRISTO - ZER MONT CARO,43133,431331,ROQUETES,6,2,8
2021/2022,43005686,ESCOLA RIU CLAR,43148,431482,TARRAGONA,17,3,20
2021/2022,43005698,ESCOLA MARJAL - ZER MEDITERRÀNIA,43004,430043,ALCANAR,9,2,11
2021/2022,43005704,INSTITUT FRANCESC VIDAL I BARRAQUER,43148,431482,TARRAGONA,70,45,115
2021/2022,43005753,ESCOLA DOCTOR ALBERICH I CASAS,43123,431233,REUS,33,3,36
2021/2022,43005765,ESCOLA EDUARD TODA I GÜELL,43123,431233,REUS,30,2,32
2021/2022,43005893,ESCOLA CENTCELLES,43047,430477,CONSTANTÍ,18,5,23
2021/2022,43005901,ESCOLA JOAN REBULL,43123,431233,REUS,37,3,40
2021/2022,43005911,ESCOLA CAMPCLAR,43148,431482,TARRAGONA,23,4,27
2021/2022,43005935,ESCOLA SANT BERNAT CALVÓ,43123,431233,REUS,23,8,31
2021/2022,43005947,ESCOLA CAL·LÍPOLIS,43171,431711,VILA-SECA,23,5,28
2021/2022,43005959,ESCOLA CÈSAR AUGUST,43148,431482,TARRAGONA,30,7,37
2021/2022,43005972,INSTITUT RAMON BARBAT I MIRACLE,43171,431711,VILA-SECA,44,31,75
2021/2022,43006046,ESCOLA DIVINA PASTORA - ZER MESTRAL,43155,431554,TORTOSA,3,0,3
2021/2022,43006061,ESCOLA RUBIÓ I ORS,43123,431233,REUS,35,5,40
2021/2022,43006101,INSTITUT MONTSIÀ,43014,430141,AMPOSTA,49,46,95
2021/2022,43006125,INSTITUT CAMPCLAR,43148,431482,TARRAGONA,49,24,73
2021/2022,43006174,ESCOLA LES MORERES,43001,430017,AIGUAMÚRCIA,8,1,9
2021/2022,43006186,ESCOLA SORIANO MONTAGUT,43014,430141,AMPOSTA,27,7,34
2021/2022,43006216,ESCOLA CÈLIA ARTIGA,43123,431233,REUS,14,4,18
2021/2022,43006228,ESCOLA ROSA SENSAT,43123,431233,REUS,19,4,23
2021/2022,43006241,ESCOLA LA PLANA,43171,431711,VILA-SECA,12,2,14
2021/2022,43006332,ESCOLA MESTRAL,43171,431711,VILA-SECA,21,4,25
2021/2022,43006356,ESCOLA MARINADA,43038,430385,CAMBRILS,29,4,33
2021/2022,43006371,ESCOLA SANT ROC - ZER CONCA DE BARBERÀ,43130,431303,ROCAFORT DE QUERALT,2,1,3
2021/2022,43006393,ESCOLA EUROPA,43905,439057,SALOU,26,9,35
2021/2022,43006496,INSTITUT MANUEL SALES I FERRÉ,43156,431567,ULLDECONA,32,18,50
2021/2022,43006541,ESCOLA TERESA MIQUEL I PÀMIES,43123,431233,REUS,28,7,35
2021/2022,43006551,ESCOLA HORTA VELLA,43136,431362,SANT CARLES DE LA RÀPITA,27,5,32
2021/2022,43006563,ESCOLA MARCEL·LÍ DOMINGO,43148,431482,TARRAGONA,25,3,28
2021/2022,43006575,ESCOLA ELADI HOMS,43161,431613,VALLS,22,3,25
2021/2022,43006587,ESCOLA ÀNGELS GARRIGA,43163,431634,EL VENDRELL,37,4,41
2021/2022,43006617,INSTITUT JOAN AMIGÓ I CALLAU,43054,430542,L'ESPLUGA DE FRANCOLÍ,18,7,25
2021/2022,43006630,INSTITUT PERE MARTELL,43148,431482,TARRAGONA,37,77,114
2021/2022,43006642,INSTITUT TERRA ALTA,43064,430640,GANDESA,35,15,50
2021/2022,43006654,INSTITUT CAMBRILS,43038,430385,CAMBRILS,38,17,55
2021/2022,43006678,INSTITUT GABRIEL FERRATER I SOLER,43123,431233,REUS,53,34,87
2021/2022,43006681,INSTITUT DE LA SÉNIA,43044,430445,LA SÉNIA,26,18,44
2021/2022,43006691,INSTITUT PRIORAT,43055,430555,FALSET,29,27,56
2021/2022,43006708,INSTITUT JOAN SEGURA I VALLS,43139,431397,SANTA COLOMA DE QUERALT,12,6,18
2021/2022,43006851,ESCOLA MOLÍ DE VENT,43153,431536,TORREDEMBARRA,31,3,34
2021/2022,43006861,ESCOLA ENXANETA,43161,431613,VALLS,18,1,19
2021/2022,43006873,ESCOLA RIUMAR,43901,439018,DELTEBRE,11,6,17
2021/2022,43006940,EOI DE TARRAGONA,43148,431482,TARRAGONA,27,8,35
2021/2022,43006952,INSTITUT TORREDEMBARRA,43153,431536,TORREDEMBARRA,31,29,60
2021/2022,43006964,INSTITUT DE DELTEBRE,43901,439018,DELTEBRE,41,24,65
2021/2022,43006976,INSTITUT CANDELERA,43013,430136,L'AMETLLA DE MAR,25,20,45
2021/2022,43006988,CEE GARBÍ,43163,431634,EL VENDRELL,17,0,17
2021/2022,43007038,INSTITUT ESCOLA D'HOTELERIA I TURISME,43038,430385,CAMBRILS,24,23,47
2021/2022,43007051,CFA JOSEPA MASSANÉS I DALMAU,43148,431482,TARRAGONA,6,5,11
2021/2022,43007087,INSTITUT SÒL DE RIU,43004,430043,ALCANAR,33,26,59
2021/2022,43007105,ESCOLA MONTSANT,43123,431233,REUS,14,4,18
2021/2022,43007117,ESCOLA PAX,43148,431482,TARRAGONA,27,4,31
2021/2022,43007129,INSTITUT JULIO ANTONIO,43093,430939,MÓRA D'EBRE,34,30,64
2021/2022,43007166,INSTITUT LLUÍS DOMÈNECH I MONTANER,43123,431233,REUS,51,43,94
2021/2022,43007178,ESCOLA MOWGLI,43123,431233,REUS,19,1,20
2021/2022,43007208,INSTITUT BERENGUER D'ENTENÇA,43162,431628,VANDELLÒS I L'HOSPITALET DE L'INFANT,36,14,50
2021/2022,43007221,INSTITUT ELS ALFACS,43136,431362,SANT CARLES DE LA RÀPITA,47,26,73
2021/2022,43007233,INSTITUT DE FLIX,43060,430607,FLIX,27,15,42
2021/2022,43007257,INSTITUT CAMÍ DE MAR,43037,430379,CALAFELL,53,41,94
2021/2022,43007385,INSTITUT D'HORTICULTURA I JARDINERIA,43123,431233,REUS,11,19,30
2021/2022,43007543,INSTITUT JAUME I,43905,439057,SALOU,59,22,81
2021/2022,43007580,INSTITUT DE L'ARBOÇ,43016,430167,L'ARBOÇ,39,29,68
2021/2022,43007646,INSTITUT DE CONSTANTÍ,43047,430477,CONSTANTÍ,33,12,45
2021/2022,43007658,INSTITUT JOAN GUINJOAN I GISPERT,43129,431299,RIUDOMS,38,24,62
2021/2022,43007661,INSTITUT RAMON DE LA TORRE,43153,431536,TORREDEMBARRA,45,24,69
2021/2022,43008389,ESCOLA SANT LLATZER,43155,431554,TORTOSA,15,2,17
2021/2022,43008390,INSTITUT TORREFORTA,43148,431482,TARRAGONA,41,19,60
2021/2022,43008407,INSTITUT EL MORELL,43095,430957,EL MORELL,32,23,55
2021/2022,43008419,INSTITUT CAMARLES,43903,439039,CAMARLES,30,11,41
2021/2022,43008420,INSTITUT ROQUETES,43133,431331,ROQUETES,51,20,71
2021/2022,43008432,INSTITUT SANT PERE I SANT PAU,43148,431482,TARRAGONA,44,16,60
2021/2022,43008444,INSTITUT JOSEP TAPIRÓ,43123,431233,REUS,45,28,73
2021/2022,43008456,INSTITUT LES PLANES,43138,431384,SANTA BÀRBARA,23,17,40
2021/2022,43008481,INSTITUT COLLBLANC,43907,439076,LA CANONJA,44,24,68
2021/2022,43008501,INSTITUT PONT DEL DIABLE,43148,431482,TARRAGONA,31,9,40
2021/2022,43008511,INSTITUT JOAN PUIG I FERRETER,43145,431457,LA SELVA DEL CAMP,35,19,54
2021/2022,43008523,INSTITUT VILA-SECA,43171,431711,VILA-SECA,43,26,69
2021/2022,43008535,ESCOLA SOLCUNIT,43051,430516,CUNIT,23,8,31
2021/2022,43008547,ESCOLA CAMBRILS,43038,430385,CAMBRILS,26,4,30
2021/2022,43008638,INSTITUT ANTONI BALLESTER,43092,430923,MONT-ROIG DEL CAMP,24,19,43
2021/2022,43008729,CFA TARRAGONA,43148,431482,TARRAGONA,9,4,13
2021/2022,43008754,CFA SEBASTIÀ JUAN ARBÓ,43014,430141,AMPOSTA,6,0,6
2021/2022,43008857,CFA REUS,43123,431233,REUS,5,4,9
2021/2022,43008912,ESCOLA CINTA CURTO,43155,431554,TORTOSA,15,3,18
2021/2022,43009001,ZER MONTSANT-SERRA DE PRADES,43116,431166,PRADES,3,1,4
2021/2022,43009011,ZER RIU AVALL,43149,431495,TIVENYS,4,0,4
2021/2022,43009023,ZER L'AGLÀ,43069,430691,GRATALLOPS,2,1,3
2021/2022,43009035,ZER ATZAVARA,43098,430982,NULLES,3,1,4
2021/2022,43009047,ZER BAIX PRIORAT,43114,431140,PORRERA,3,1,4
2021/2022,43009059,ZER BAIX CAMP NORD,43007,430075,L'ALEIXAR,3,2,5
2021/2022,43009072,ZER CONCA DE BARBERÀ,43147,431476,SOLIVELLA,4,1,5
2021/2022,43009084,ZER MONTSIÀ,43078,430786,MASDENVERGE,3,2,5
2021/2022,43009096,ZER ELS CEPS,43079,430799,MASLLORENÇ,1,3,4
2021/2022,43009114,ZER EL FRANCOLÍ,43161,431613,VALLS,4,0,4
2021/2022,43009126,ZER BAIX CAMP SUD,43167,431671,VILANOVA D'ESCORNALBOU,4,0,4
2021/2022,43009138,ZER LA PARELLADA,43059,430593,FIGUEROLA DEL CAMP,3,1,4
2021/2022,43009141,ZER POBLET,43176,431763,VIMBODÍ I POBLET,4,0,4
2021/2022,43009187,INSTITUT MARTÍ L'HUMÀ,43086,430862,MONTBLANC,42,22,64
2021/2022,43009217,ESCOLA DEL POBLE NOU DEL DELTA - ZER MEDITERRÀNIA,43014,430141,AMPOSTA,4,0,4
2021/2022,43009229,ZER PORTS-ALGARS,43018,430189,ARNES,3,0,3
2021/2022,43009230,ESCOLA TARRAGONA,43148,431482,TARRAGONA,23,5,28
2021/2022,43009242,ESCOLA L'ANTINA,43153,431536,TORREDEMBARRA,31,4,35
2021/2022,43009308,ZER MEDITERRÀNIA,43004,430043,ALCANAR,2,2,4
2021/2022,43009311,ZER MONT CARO,43008,430081,ALFARA DE CARLES,3,0,3
2021/2022,43009321,ZER RIU I SERRA,43025,430252,BENIFALLET,3,0,3
2021/2022,43009345,ZER RIBERA D'EBRE NORD,43152,431520,LA TORRE DE L'ESPANYOL,3,1,4
2021/2022,43009369,ESCOLA SAAVEDRA,43148,431482,TARRAGONA,16,4,20
2021/2022,43009370,ZER TERRA ALTA NORD,43175,431750,VILALBA DELS ARCS,2,2,4
2021/2022,43009394,ZER LA FONT DE L'AIGUADÍ,43067,430672,GINESTAR,1,2,3
2021/2022,43009451,ESCOLA SALOU,43905,439057,SALOU,32,2,34
2021/2022,43009461,ZER TERRA ALTA-CENTRE,43048,430483,CORBERA D'EBRE,3,1,4
2021/2022,43009497,INSTITUT FONTS DEL GLORIETA,43005,430056,ALCOVER,23,12,35
2021/2022,43009606,ZER BENISSANET-MIRAVET,43026,430265,BENISSANET,2,2,4
2021/2022,43009618,ZER MESTRAL,43155,431554,TORTOSA,3,1,4
2021/2022,43009710,EOI DE REUS,43123,431233,REUS,9,2,11
2021/2022,43009722,INSTITUT CAL·LÍPOLIS,43148,431482,TARRAGONA,83,30,113
2021/2022,43009771,CFA TORTOSA,43155,431554,TORTOSA,5,4,9
2021/2022,43009850,INSTITUT ERNEST LLUCH I MARTÍ,43051,430516,CUNIT,50,28,78
2021/2022,43009862,EOI DE TORTOSA,43155,431554,TORTOSA,6,4,10
2021/2022,43009886,ESCOLA JOSEP VECIANA,43103,431037,PERAFORT,15,1,16
2021/2022,43009898,ESCOLA CASTELL DE CALAFELL,43037,430379,CALAFELL,25,9,34
2021/2022,43009977,INSTITUT D'ALTAFULLA,43012,430120,ALTAFULLA,32,23,55
2021/2022,43010037,EOI DEL VENDRELL,43163,431634,EL VENDRELL,5,2,7
2021/2022,43010062,CFA EL VENDRELL,43163,431634,EL VENDRELL,6,1,7
2021/2022,43010074,CFA VALLS,43161,431613,VALLS,4,3,7
2021/2022,43010086,CFA VILASECA,43171,431711,VILA-SECA,6,0,6
2021/2022,43010098,ESCOLA LA GINESTA,43037,430379,CALAFELL,26,8,34
2021/2022,43010141,ESCOLA GUILLEM FORTUNY,43038,430385,CAMBRILS,26,6,32
2021/2022,43010153,ESCOLA VORA MAR,43905,439057,SALOU,30,4,34
2021/2022,43010165,ESCOLA MARTA MATA,43163,431634,EL VENDRELL,24,6,30
2021/2022,43010189,INSTITUT MEDITERRÀNIA,43163,431634,EL VENDRELL,27,18,45
2021/2022,43010220,ESCOLA DE MASPUJOLS,43081,430810,MASPUJOLS,14,0,14
2021/2022,43010311,CFA RIBERA D'EBRE,43093,430939,MÓRA D'EBRE,4,3,7
2021/2022,43010323,CFA MONTBLANC,43086,430862,MONTBLANC,3,1,4
2021/2022,43010335,INSTITUT LA MAR DE LA FRAU,43038,430385,CAMBRILS,34,13,47
2021/2022,43010347,INSTITUT MARTA MATA,43905,439057,SALOU,39,17,56
2021/2022,43010372,INSTITUT LA TALAIA,43037,430379,CALAFELL,37,28,65
2021/2022,43010396,ESCOLA DE PONENT,43148,431482,TARRAGONA,23,1,24
2021/2022,43010402,ESCOLA EL ROQUISSAR,43012,430120,ALTAFULLA,15,4,19
2021/2022,43010414,INSTITUT COSTER DE LA TORRE,43028,430287,LA BISBAL DEL PENEDÈS,39,26,65
2021/2022,43010487,ESCOLA MARCEL·LÍ ESQUIUS,43092,430923,MONT-ROIG DEL CAMP,14,2,16
2021/2022,43010499,CFA PAU CASALS,43043,430430,EL CATLLAR,11,7,18
2021/2022,43010505,ESCOLA LA VITXETA,43123,431233,REUS,29,2,31
2021/2022,43010529,ESCOLA CAVALLER ARNAU,43129,431299,RIUDOMS,16,3,19
2021/2022,43010530,ESCOLA MIRAMAR,43171,431711,VILA-SECA,24,6,30
2021/2022,43010554,ZER LES VINYES,43076,430764,MARÇÀ,2,2,4
2021/2022,43010578,INSTITUT FONTANELLES,43031,430311,LES BORGES DEL CAMP,37,15,52
2021/2022,43010581,ESCOLA MAS CLARIANA,43038,430385,CAMBRILS,25,3,28
2021/2022,43010591,ESCOLA ARQUITECTE JUJOL,43100,431009,ELS PALLARESOS,14,3,17
2021/2022,43010608,INSTITUT SERRA DE MIRAMAR,43161,431613,VALLS,30,17,47
2021/2022,43010621,ESCOLA CINGLE ROIG - ZER BAIX CAMP NORD,43169,431690,VILAPLANA,4,0,4
2021/2022,43010669,EOI D'AMPOSTA,43014,430141,AMPOSTA,6,1,7
2021/2022,43010670,EOI DE VALLS,43161,431613,VALLS,5,0,5
2021/2022,43010748,INSTITUT ELS PALLARESOS,43100,431009,ELS PALLARESOS,32,22,54
2021/2022,43010773,ESCOLA CONSOL FERRÉ,43014,430141,AMPOSTA,22,8,30
2021/2022,43010815,ESCOLA ELS COSSETANS,43051,430516,CUNIT,24,4,28
2021/2022,43010839,ESCOLA SERRA MAJOR - ZER L'AGLÀ,43174,431747,LA VILELLA BAIXA,4,0,4
2021/2022,43010852,INSTITUT ROSETA MAURI,43123,431233,REUS,48,15,63
2021/2022,43010864,ESCOLA ISABEL BESORA,43123,431233,REUS,26,4,30
2021/2022,43010876,ESCOLA L'ARRABASSADA,43148,431482,TARRAGONA,30,1,31
2021/2022,43010888,INSTITUT DE TECNIFICACIÓ,43014,430141,AMPOSTA,26,24,50
2021/2022,43010980,EOI RIBERA D'EBRE,43093,430939,MÓRA D'EBRE,4,1,5
2021/2022,43011029,ZER EBRE,43125,431251,RIBA-ROJA D'EBRE,2,2,4
2021/2022,43011121,ESCOLA VILAMAR,43037,430379,CALAFELL,17,5,22
2021/2022,43011145,ESCOLA ELS GANXETS,43123,431233,REUS,11,5,16
2021/2022,43011170,INSTITUT CRISTÒFOL DESPUIG,43155,431554,TORTOSA,35,15,50
2021/2022,43011194,ESCOLA EL CUCURULL,43131,431310,RODA DE BERÀ,15,4,19
2021/2022,43011200,EOI DE SALOU,43905,439057,SALOU,5,1,6
2021/2022,43011212,ESCOLA LA BÒBILA,43038,430385,CAMBRILS,26,5,31
2021/2022,43011303,ZER MONTSANT,43035,430350,CABACÉS,3,1,4
2021/2022,43011418,INSTITUT RODA DE BERÀ,43131,431310,RODA DE BERÀ,18,18,36
2021/2022,43011479,INSTITUT TARRAGONA,43148,431482,TARRAGONA,44,16,60
2021/2022,43011492,ESCOLA LA CANALETA,43171,431711,VILA-SECA,27,4,31
2021/2022,43012083,INSTITUT ESCOLA PI DEL BURGAR,43123,431233,REUS,44,18,62
2021/2022,43012095,ESCOLA JOAN MIRÓ,43092,430923,MONT-ROIG DEL CAMP,30,4,34
2021/2022,43012113,INSTITUT ESCOLA MARE DE DÉU DEL PORTAL,43022,430228,BATEA,26,6,32
2021/2022,43012289,INSTITUT ESCOLA 3 D'ABRIL,43094,430944,MÓRA LA NOVA,39,9,48
2021/2022,43012307,INSTITUT ESCOLA DANIEL MANGRANÉ,43155,431554,TORTOSA,44,13,57
2021/2022,43012319,INSTITUT ESCOLA EL PERELLÓ,43104,431042,EL PERELLÓ,39,15,54
2021/2022,43012769,CEE FONT DEL LLEÓ,43123,431233,REUS,16,1,17
2021/2022,43012812,INSTITUT ESCOLA L'AGULLA,43043,430430,EL CATLLAR,38,10,48
2021/2022,43012903,ESCOLA EL BOSC - ZER EL FRANCOLÍ,43091,430918,MONT-RAL,1,1,2
2021/2022,43012976,INSTITUT ESCOLA MEDITERRANI,43148,431482,TARRAGONA,21,10,31
2021/2022,43012988,INSTITUT DE MIAMI,43092,430923,MONT-ROIG DEL CAMP,25,7,32
2021/2022,43013075,INSTITUT ESCOLA ÀNGEL DE TOBIES,43163,431634,EL VENDRELL,29,17,46
2021/2022,43013087,INSTITUT ESCOLA CORBATERA,43049,430496,CORNUDELLA DE MONTSANT,21,3,24
2021/2022,43013099,INSTITUT ESCOLA AGUSTÍ BARBERÀ,43014,430141,AMPOSTA,43,10,53
2021/2022,43013117,INSTITUT D'EST. PROFES. AQÜÍCOLES I AMBIENTALS DE CATALUNYA,43136,431362,SANT CARLES DE LA RÀPITA,8,4,12
2021/2022,43013129,INSTITUT ESCOLA COMA-RUGA,43163,431634,EL VENDRELL,42,6,48
2021/2022,43013130,INSTITUT ESCOLA JOAN ARDÈVOL,43038,430385,CAMBRILS,30,12,42
2021/2022,43013142,INSTITUT ESCOLA EL TEMPLE,43155,431554,TORTOSA,39,8,47
2020/2021,25009009,ZER EL SOLSONÈS,25207,252075,SOLSONA,5,0,5
2020/2021,43011170,INSTITUT CRISTÒFOL DESPUIG,43155,431554,TORTOSA,35,14,49
2020/2021,17008687,ESCOLA LES DEVESES,17155,171557,SALT,30,5,35
2020/2021,43011145,ESCOLA ELS GANXETS,43123,431233,REUS,12,4,16
2020/2021,17008675,ESCOLA PERICOT,17079,170792,GIRONA,24,6,30
2020/2021,43011121,ESCOLA VILAMAR,43037,430379,CALAFELL,15,3,18
2020/2021,43011029,ZER EBRE,43125,431251,RIBA-ROJA D'EBRE,3,1,4
2020/2021,43010980,EOI RIBERA D'EBRE,43093,430939,MÓRA D'EBRE,4,0,4
2020/2021,43013142,INSTITUT ESCOLA EL TEMPLE,43155,431554,TORTOSA,30,9,39
2020/2021,43013130,INSTITUT ESCOLA JOAN ARDÈVOL,43038,430385,CAMBRILS,25,9,34
2020/2021,43010888,INSTITUT DE TECNIFICACIÓ,43014,430141,AMPOSTA,27,21,48
2020/2021,43013129,INSTITUT ESCOLA COMA-RUGA,43163,431634,EL VENDRELL,32,5,37
2020/2021,43013117,INSTITUT D'EST. PROFES. AQÜÍCOLES I AMBIENTALS DE CATALUNYA,43136,431362,SANT CARLES DE LA RÀPITA,6,4,10
2020/2021,43013099,INSTITUT ESCOLA AGUSTÍ BARBERÀ,43014,430141,AMPOSTA,33,9,42
2020/2021,43013087,INSTITUT ESCOLA MONTSANT,43049,430496,CORNUDELLA DE MONTSANT,19,4,23
2020/2021,17008778,ESCOLA EL MORROT,17114,171143,OLOT,15,3,18
2020/2021,17003422,ESCOLA TAIALÀ,17079,170792,GIRONA,33,4,37
2020/2021,43013075,INSTITUT ESCOLA ÀNGEL DE TOBIES,43163,431634,EL VENDRELL,24,15,39
2020/2021,43012988,INSTITUT DE MIAMI,43092,430923,MONT-ROIG DEL CAMP,20,8,28
2020/2021,43012976,INSTITUT ESCOLA MEDITERRANI,43148,431482,TARRAGONA,21,9,30
2020/2021,43012903,ESCOLA EL BOSC - ZER EL FRANCOLÍ,43091,430918,MONT-RAL,1,1,2
2020/2021,43012812,INSTITUT ESCOLA L'AGULLA,43043,430430,EL CATLLAR,37,11,48
2020/2021,43012769,CEE FONT DEL LLEÓ,43123,431233,REUS,12,1,13
2020/2021,43000871,ESCOLA JAUME I,43044,430445,LA SÉNIA,30,5,35
2020/2021,43012307,INSTITUT ESCOLA DANIEL MANGRANÉ,43155,431554,TORTOSA,41,11,52
2020/2021,43010864,ESCOLA ISABEL BESORA,43123,431233,REUS,24,4,28
2020/2021,43012289,INSTITUT ESCOLA 3 D'ABRIL,43094,430944,MÓRA LA NOVA,33,12,45
2020/2021,43010876,ESCOLA L'ARRABASSADA,43148,431482,TARRAGONA,29,1,30
2020/2021,43012113,INSTITUT ESCOLA MARE DE DÉU DEL PORTAL,43022,430228,BATEA,24,6,30
2020/2021,43012095,ESCOLA JOAN MIRÓ,43092,430923,MONT-ROIG DEL CAMP,28,4,32
2020/2021,43012083,INSTITUT ESCOLA PI DEL BURGAR,43123,431233,REUS,44,11,55
2020/2021,43011492,ESCOLA LA CANALETA,43171,431711,VILA-SECA,27,3,30
2020/2021,08000086,ESCOLA LA FORJA - ZER ALT LLUÇANÈS,08004,080044,ALPENS,4,0,4
2020/2021,08000049,ESCOLA FABRA,08003,080039,ALELLA,26,2,28
2020/2021,08000013,ESCOLA FRANCESC PLATÓN I SARTÍ,08001,080018,ABRERA,25,8,33
2020/2021,43011479,INSTITUT TARRAGONA,43148,431482,TARRAGONA,45,13,58
2020/2021,43011418,INSTITUT RODA DE BERÀ,43131,431310,RODA DE BERÀ,16,18,34
2020/2021,43011303,ZER MONTSANT,43035,430350,CABACÉS,3,1,4
2020/2021,43011212,ESCOLA LA BÒBILA,43038,430385,CAMBRILS,25,5,30
2020/2021,43011200,EOI DE SALOU,43905,439057,SALOU,6,0,6
2020/2021,43011194,ESCOLA EL CUCURULL,43131,431310,RODA DE BERÀ,14,3,17
2020/2021,43010852,INSTITUT ROSETA MAURI,43123,431233,REUS,50,8,58
2020/2021,43010839,ESCOLA SERRA MAJOR - ZER L'AGLÀ,43174,431747,LA VILELLA BAIXA,2,1,3
2020/2021,43010815,ESCOLA ELS COSSETANS,43051,430516,CUNIT,21,4,25
2020/2021,43010773,ESCOLA CONSOL FERRÉ,43014,430141,AMPOSTA,21,9,30
2020/2021,43010748,INSTITUT ELS PALLARESOS,43100,431009,ELS PALLARESOS,33,20,53
2020/2021,43010670,EOI DE VALLS,43161,431613,VALLS,6,0,6
2020/2021,43010669,EOI D'AMPOSTA,43014,430141,AMPOSTA,6,1,7
2020/2021,43010621,ESCOLA CINGLE ROIG - ZER BAIX CAMP NORD,43169,431690,VILAPLANA,4,0,4
2020/2021,43010608,INSTITUT SERRA DE MIRAMAR,43161,431613,VALLS,24,18,42
2020/2021,43010591,ESCOLA ARQUITECTE JUJOL,43100,431009,ELS PALLARESOS,14,3,17
2020/2021,43010581,ESCOLA MAS CLARIANA,43038,430385,CAMBRILS,26,3,29
2020/2021,43010578,INSTITUT FONTANELLES,43031,430311,LES BORGES DEL CAMP,39,14,53
2020/2021,43010554,ZER LES VINYES,43076,430764,MARÇÀ,2,2,4
2020/2021,43010530,ESCOLA MIRAMAR,43171,431711,VILA-SECA,25,5,30
2020/2021,43010529,ESCOLA CAVALLER ARNAU,43129,431299,RIUDOMS,14,3,17
2020/2021,43010505,ESCOLA LA VITXETA,43123,431233,REUS,25,3,28
2020/2021,43010499,CFA PAU CASALS,43043,430430,EL CATLLAR,11,7,18
2020/2021,43010487,ESCOLA MARCEL·LÍ ESQUIUS,43092,430923,MONT-ROIG DEL CAMP,14,2,16
2020/2021,43010414,INSTITUT COSTER DE LA TORRE,43028,430287,LA BISBAL DEL PENEDÈS,34,26,60
2020/2021,43010402,ESCOLA EL ROQUISSAR,43012,430120,ALTAFULLA,14,4,18
2020/2021,43010396,ESCOLA DE PONENT,43148,431482,TARRAGONA,21,0,21
2020/2021,43010372,INSTITUT LA TALAIA,43037,430379,CALAFELL,32,24,56
2020/2021,43010347,INSTITUT MARTA MATA,43905,439057,SALOU,31,15,46
2020/2021,43010335,INSTITUT LA MAR DE LA FRAU,43038,430385,CAMBRILS,32,13,45
2020/2021,43010323,CFA MONTBLANC,43086,430862,MONTBLANC,3,1,4
2020/2021,43010311,CFA RIBERA D'EBRE,43093,430939,MÓRA D'EBRE,3,4,7
2020/2021,43010220,ESCOLA DE MASPUJOLS,43081,430810,MASPUJOLS,13,1,14
2020/2021,43010189,INSTITUT MEDITERRÀNIA,43163,431634,EL VENDRELL,27,18,45
2020/2021,43010165,ESCOLA MARTA MATA,43163,431634,EL VENDRELL,21,7,28
2020/2021,43010153,ESCOLA VORA MAR,43905,439057,SALOU,30,4,34
2020/2021,43010141,ESCOLA GUILLEM FORTUNY,43038,430385,CAMBRILS,25,6,31
2020/2021,43010098,ESCOLA LA GINESTA,43037,430379,CALAFELL,21,9,30
2020/2021,43010086,CFA VILASECA,43171,431711,VILA-SECA,5,0,5
2020/2021,43010074,CFA VALLS,43161,431613,VALLS,5,2,7
2020/2021,43010062,CFA EL VENDRELL,43163,431634,EL VENDRELL,5,2,7
2020/2021,43010037,EOI DEL VENDRELL,43163,431634,EL VENDRELL,5,2,7
2020/2021,43009977,INSTITUT D'ALTAFULLA,43012,430120,ALTAFULLA,30,25,55
2020/2021,43009898,ESCOLA CASTELL DE CALAFELL,43037,430379,CALAFELL,22,7,29
2020/2021,43009886,ESCOLA JOSEP VECIANA,43103,431037,PERAFORT,15,1,16
2020/2021,43009862,EOI DE TORTOSA,43155,431554,TORTOSA,7,3,10
2020/2021,43009850,INSTITUT ERNEST LLUCH I MARTÍ,43051,430516,CUNIT,50,28,78
2020/2021,43009771,CFA TORTOSA,43155,431554,TORTOSA,6,2,8
2020/2021,43009722,INSTITUT CAL·LÍPOLIS,43148,431482,TARRAGONA,74,31,105
2020/2021,43009710,EOI DE REUS,43123,431233,REUS,8,3,11
2020/2021,43009618,ZER MESTRAL,43155,431554,TORTOSA,3,1,4
2020/2021,43009606,ZER BENISSANET-MIRAVET,43026,430265,BENISSANET,2,2,4
2020/2021,43009497,INSTITUT FONTS DEL GLORIETA,43005,430056,ALCOVER,22,12,34
2020/2021,43009461,ZER TERRA ALTA-CENTRE,43048,430483,CORBERA D'EBRE,4,0,4
2020/2021,43009451,ESCOLA SALOU,43905,439057,SALOU,28,3,31
2020/2021,43009394,ZER LA FONT DE L'AIGUADÍ,43067,430672,GINESTAR,1,2,3
2020/2021,43009370,ZER TERRA ALTA NORD,43175,431750,VILALBA DELS ARCS,4,0,4
2020/2021,43009369,ESCOLA SAAVEDRA,43148,431482,TARRAGONA,17,2,19
2020/2021,43009345,ZER RIBERA D'EBRE NORD,43152,431520,LA TORRE DE L'ESPANYOL,3,1,4
2020/2021,43009321,ZER RIU I SERRA,43025,430252,BENIFALLET,2,1,3
2020/2021,43009311,ZER MONT CARO,43008,430081,ALFARA DE CARLES,3,0,3
2020/2021,43009308,ZER MEDITERRÀNIA,43004,430043,ALCANAR,2,2,4
2020/2021,43009242,ESCOLA L'ANTINA,43153,431536,TORREDEMBARRA,26,4,30
2020/2021,43009230,ESCOLA TARRAGONA,43148,431482,TARRAGONA,20,4,24
2020/2021,43009229,ZER PORTS-ALGARS,43018,430189,ARNES,2,1,3
2020/2021,43009217,ESCOLA DEL POBLE NOU DEL DELTA - ZER MEDITERRÀNIA,43014,430141,AMPOSTA,3,0,3
2020/2021,43009187,INSTITUT MARTÍ L'HUMÀ,43086,430862,MONTBLANC,42,20,62
2020/2021,43009141,ZER POBLET,43176,431763,VIMBODÍ I POBLET,4,0,4
2020/2021,43009138,ZER LA PARELLADA,43059,430593,FIGUEROLA DEL CAMP,4,0,4
2020/2021,43009126,ZER BAIX CAMP SUD,43167,431671,VILANOVA D'ESCORNALBOU,3,1,4
2020/2021,43009114,ZER EL FRANCOLÍ,43161,431613,VALLS,3,0,3
2020/2021,43009096,ZER ELS CEPS,43079,430799,MASLLORENÇ,2,2,4
2020/2021,43009084,ZER MONTSIÀ,43078,430786,MASDENVERGE,3,2,5
2020/2021,43009072,ZER CONCA DE BARBERÀ,43147,431476,SOLIVELLA,4,1,5
2020/2021,43009059,ZER BAIX CAMP NORD,43007,430075,L'ALEIXAR,3,2,5
2020/2021,43009047,ZER BAIX PRIORAT,43114,431140,PORRERA,3,1,4
2020/2021,43009035,ZER ATZAVARA,43098,430982,NULLES,3,1,4
2020/2021,43009023,ZER L'AGLÀ,43069,430691,GRATALLOPS,3,0,3
2020/2021,43009011,ZER RIU AVALL,43149,431495,TIVENYS,4,0,4
2020/2021,43009001,ZER MONTSANT-SERRA DE PRADES,43116,431166,PRADES,4,0,4
2020/2021,43008912,ESCOLA CINTA CURTO,43155,431554,TORTOSA,13,3,16
2020/2021,43008857,CFA REUS,43123,431233,REUS,4,5,9
2020/2021,43008754,CFA SEBASTIÀ JUAN ARBÓ,43014,430141,AMPOSTA,6,0,6
2020/2021,43008729,CFA TARRAGONA,43148,431482,TARRAGONA,7,6,13
2020/2021,43008638,INSTITUT ANTONI BALLESTER,43092,430923,MONT-ROIG DEL CAMP,25,16,41
2020/2021,43008547,ESCOLA CAMBRILS,43038,430385,CAMBRILS,26,3,29
2020/2021,43008535,ESCOLA SOLCUNIT,43051,430516,CUNIT,20,9,29
2020/2021,43008523,INSTITUT VILA-SECA,43171,431711,VILA-SECA,39,24,63
2020/2021,43008511,INSTITUT JOAN PUIG I FERRETER,43145,431457,LA SELVA DEL CAMP,36,19,55
2020/2021,43008501,INSTITUT PONT DEL DIABLE,43148,431482,TARRAGONA,34,7,41
2020/2021,43008481,INSTITUT COLLBLANC,43907,439076,LA CANONJA,40,23,63
2020/2021,43008456,INSTITUT LES PLANES,43138,431384,SANTA BÀRBARA,21,13,34
2020/2021,43008444,INSTITUT JOSEP TAPIRÓ,43123,431233,REUS,48,23,71
2020/2021,43008432,INSTITUT SANT PERE I SANT PAU,43148,431482,TARRAGONA,42,13,55
2020/2021,43008420,INSTITUT ROQUETES,43133,431331,ROQUETES,47,20,67
2020/2021,43008419,INSTITUT CAMARLES,43903,439039,CAMARLES,29,11,40
2020/2021,43008407,INSTITUT EL MORELL,43095,430957,EL MORELL,33,20,53
2020/2021,43008390,INSTITUT TORREFORTA,43148,431482,TARRAGONA,41,15,56
2020/2021,43008389,ESCOLA SANT LLATZER,43155,431554,TORTOSA,15,1,16
2020/2021,43007661,INSTITUT RAMON DE LA TORRE,43153,431536,TORREDEMBARRA,47,20,67
2020/2021,43007658,INSTITUT JOAN GUINJOAN I GISPERT,43129,431299,RIUDOMS,41,21,62
2020/2021,43007646,INSTITUT DE CONSTANTÍ,43047,430477,CONSTANTÍ,29,14,43
2020/2021,43007580,INSTITUT DE L'ARBOÇ,43016,430167,L'ARBOÇ,38,27,65
2020/2021,43007543,INSTITUT JAUME I,43905,439057,SALOU,58,23,81
2020/2021,43007385,INSTITUT D'HORTICULTURA I JARDINERIA,43123,431233,REUS,11,16,27
2020/2021,43007257,INSTITUT CAMÍ DE MAR,43037,430379,CALAFELL,59,29,88
2020/2021,43007233,INSTITUT DE FLIX,43060,430607,FLIX,23,14,37
2020/2021,43007221,INSTITUT ELS ALFACS,43136,431362,SANT CARLES DE LA RÀPITA,43,26,69
2020/2021,43007211,INSTITUT BLANCA D'ANJOU,43104,431042,EL PERELLÓ,15,12,27
2020/2021,43007208,INSTITUT BERENGUER D'ENTENÇA,43162,431628,VANDELLÒS I L'HOSPITALET DE L'INFANT,36,15,51
2020/2021,43007178,ESCOLA MOWGLI,43123,431233,REUS,13,2,15
2020/2021,43007166,INSTITUT LLUÍS DOMÈNECH I MONTANER,43123,431233,REUS,48,48,96
2020/2021,43007129,INSTITUT JULIO ANTONIO,43093,430939,MÓRA D'EBRE,36,32,68
2020/2021,43007117,ESCOLA PAX,43148,431482,TARRAGONA,26,4,30
2020/2021,43007105,ESCOLA MONTSANT,43123,431233,REUS,15,2,17
2020/2021,43007087,INSTITUT SÒL DE RIU,43004,430043,ALCANAR,26,24,50
2020/2021,43007051,CFA JOSEPA MASSANÉS I DALMAU,43148,431482,TARRAGONA,6,5,11
2020/2021,43007038,INSTITUT ESCOLA D'HOTELERIA I TURISME,43038,430385,CAMBRILS,24,23,47
2020/2021,43006988,CEE GARBÍ,43163,431634,EL VENDRELL,15,0,15
2020/2021,43006976,INSTITUT CANDELERA,43013,430136,L'AMETLLA DE MAR,28,20,48
2020/2021,43006964,INSTITUT DE DELTEBRE,43901,439018,DELTEBRE,42,18,60
2020/2021,43006952,INSTITUT TORREDEMBARRA,43153,431536,TORREDEMBARRA,30,25,55
2020/2021,43006940,EOI DE TARRAGONA,43148,431482,TARRAGONA,28,7,35
2020/2021,43006873,ESCOLA RIUMAR,43901,439018,DELTEBRE,9,7,16
2020/2021,43006861,ESCOLA ENXANETA,43161,431613,VALLS,16,0,16
2020/2021,43006851,ESCOLA MOLÍ DE VENT,43153,431536,TORREDEMBARRA,28,4,32
2020/2021,43006708,INSTITUT JOAN SEGURA I VALLS,43139,431397,SANTA COLOMA DE QUERALT,10,6,16
2020/2021,43006691,INSTITUT PRIORAT,43055,430555,FALSET,31,22,53
2020/2021,43006681,INSTITUT DE LA SÉNIA,43044,430445,LA SÉNIA,30,13,43
2020/2021,43006678,INSTITUT GABRIEL FERRATER I SOLER,43123,431233,REUS,51,34,85
2020/2021,43006654,INSTITUT CAMBRILS,43038,430385,CAMBRILS,36,15,51
2020/2021,43006642,INSTITUT TERRA ALTA,43064,430640,GANDESA,32,16,48
2020/2021,43006630,INSTITUT PERE MARTELL,43148,431482,TARRAGONA,32,77,109
2020/2021,43006617,INSTITUT JOAN AMIGÓ I CALLAU,43054,430542,L'ESPLUGA DE FRANCOLÍ,19,5,24
2020/2021,43006587,ESCOLA ÀNGELS GARRIGA,43163,431634,EL VENDRELL,33,4,37
2020/2021,43006575,ESCOLA ELADI HOMS,43161,431613,VALLS,20,3,23
2020/2021,43006563,ESCOLA MARCEL·LÍ DOMINGO,43148,431482,TARRAGONA,24,4,28
2020/2021,43006551,ESCOLA HORTA VELLA,43136,431362,SANT CARLES DE LA RÀPITA,26,5,31
2020/2021,43006541,ESCOLA TERESA MIQUEL I PÀMIES,43123,431233,REUS,26,6,32
2020/2021,43006496,INSTITUT MANUEL SALES I FERRÉ,43156,431567,ULLDECONA,29,16,45
2020/2021,43006393,ESCOLA EUROPA,43905,439057,SALOU,24,7,31
2020/2021,43006371,ESCOLA SANT ROC - ZER CONCA DE BARBERÀ,43130,431303,ROCAFORT DE QUERALT,2,1,3
2020/2021,43006356,ESCOLA MARINADA,43038,430385,CAMBRILS,26,3,29
2020/2021,43006332,ESCOLA MESTRAL,43171,431711,VILA-SECA,21,4,25
2020/2021,43006241,ESCOLA LA PLANA,43171,431711,VILA-SECA,11,3,14
2020/2021,43006228,ESCOLA ROSA SENSAT,43123,431233,REUS,18,3,21
2020/2021,43006216,ESCOLA CÈLIA ARTIGA,43123,431233,REUS,14,3,17
2020/2021,43006186,ESCOLA SORIANO MONTAGUT,43014,430141,AMPOSTA,25,6,31
2020/2021,43006174,ESCOLA LES MORERES,43001,430017,AIGUAMÚRCIA,7,1,8
2020/2021,43006125,INSTITUT CAMPCLAR,43148,431482,TARRAGONA,50,22,72
2020/2021,43006101,INSTITUT MONTSIÀ,43014,430141,AMPOSTA,47,47,94
2020/2021,43006061,ESCOLA RUBIÓ I ORS,43123,431233,REUS,32,5,37
2020/2021,43006046,ESCOLA DIVINA PASTORA - ZER MESTRAL,43155,431554,TORTOSA,3,0,3
2020/2021,43005972,INSTITUT RAMON BARBAT I MIRACLE,43171,431711,VILA-SECA,38,32,70
2020/2021,43005959,ESCOLA CÈSAR AUGUST,43148,431482,TARRAGONA,29,8,37
2020/2021,43005947,ESCOLA CAL·LÍPOLIS,43171,431711,VILA-SECA,23,6,29
2020/2021,43005935,ESCOLA SANT BERNAT CALVÓ,43123,431233,REUS,25,4,29
2020/2021,43005911,ESCOLA CAMPCLAR,43148,431482,TARRAGONA,22,4,26
2020/2021,43005901,ESCOLA JOAN REBULL,43123,431233,REUS,36,3,39
2020/2021,43005893,ESCOLA CENTCELLES,43047,430477,CONSTANTÍ,15,7,22
2020/2021,43005765,ESCOLA EDUARD TODA I GÜELL,43123,431233,REUS,28,2,30
2020/2021,43005753,ESCOLA DOCTOR ALBERICH I CASAS,43123,431233,REUS,30,4,34
2020/2021,43005704,INSTITUT FRANCESC VIDAL I BARRAQUER,43148,431482,TARRAGONA,66,45,111
2020/2021,43005698,ESCOLA MARJAL - ZER MEDITERRÀNIA,43004,430043,ALCANAR,7,3,10
2020/2021,43005686,ESCOLA RIU CLAR,43148,431482,TARRAGONA,15,3,18
2020/2021,43005674,ESCOLA RAVAL DE CRISTO - ZER MONT CARO,43133,431331,ROQUETES,6,2,8
2020/2021,43005662,ESCOLA JOSEP NIN,43135,431359,SALOMÓ,8,2,10
2020/2021,43005650,ESCOLA EL DIVÍ MESTRE - ZER TERRA ALTA NORD,43175,431750,VILALBA DELS ARCS,4,1,5
2020/2021,43005637,ESCOLA MANUEL DE CASTELLVÍ I FELIU - ZER ATZAVARA,43165,431652,VILABELLA,6,1,7
2020/2021,43005625,ESCOLA SANT ANTONI ABAT - ZER MONT CARO,43155,431554,TORTOSA,5,0,5
2020/2021,43005613,ESCOLA SETZE DE FEBRER - ZER MEDITERRÀNIA,43902,439023,SANT JAUME D'ENVEJA,3,0,3
2020/2021,43005601,ESCOLA EL TORMO - ZER RIBERA D'EBRE NORD,43152,431520,LA TORRE DE L'ESPANYOL,4,0,4
2020/2021,43005595,ESCOLA LA PARELLADA,43140,431401,SANTA OLIVA,18,5,23
2020/2021,43005583,ESCOLA ELS QUATRE VENTS,43137,431378,SANT JAUME DELS DOMENYS,19,4,23
2020/2021,43005571,ESCOLA LES COMES,43132,431325,RODONYÀ,12,1,13
2020/2021,43005561,ESCOLA MARE DE DÉU DEL ROSER,43128,431286,RIUDECOLS,10,1,11
2020/2021,43005558,ESCOLA SANT MATEU,43127,431270,RIUDECANYES,10,1,11
2020/2021,43005546,ESCOLA DE LA RIBA - ZER EL FRANCOLÍ,43124,431248,LA RIBA,4,2,6
2020/2021,43005534,ESCOLA LES ERES DE RASQUERA - ZER LA FONT DE L'AIGUADÍ,43121,431212,RASQUERA,7,0,7
2020/2021,43005522,ESCOLA SANTA MARINA,43118,431188,PRATDIP,4,4,8
2020/2021,43005510,ESCOLA SERRA DE PRADES - ZER MONTSANT-SERRA DE PRADES,43116,431166,PRADES,4,1,5
2020/2021,43005509,ESCOLA ROSSEND GIOL - ZER BAIX PRIORAT,43114,431140,PORRERA,1,2,3
2020/2021,43005492,ESCOLA SANTA MAGDALENA - ZER LA PARELLADA,43113,431135,EL PONT D'ARMENTERA,4,1,5
2020/2021,43005480,ESCOLA MARE DE DÉU DEL LLEDÓ,43109,431093,LA POBLA DE MAFUMET,25,4,29
2020/2021,43005479,ESCOLA 1 D'ABRIL - ZER EBRE,43099,430995,LA PALMA D'EBRE,3,0,3
2020/2021,43005467,ESCOLA LES CODINETES,43097,430976,LA NOU DE GAIÀ,11,3,14
2020/2021,43005455,ESCOLA PIUS XII - ZER L'AGLÀ,43085,430859,EL MOLAR,2,1,3
2020/2021,43005443,ESCOLA ROC LLOP I CONVALIA - ZER BENISSANET-MIRAVET,43084,430846,MIRAVET,5,1,6
2020/2021,43005421,ESCOLA BERENGUER DE MONTOLIU - ZER ELS CEPS,43079,430799,MASLLORENÇ,5,1,6
2020/2021,43005418,ESCOLA SANT SALVADOR - ZER MONTSIÀ,43068,430688,GODALL,4,0,4
2020/2021,43005406,ESCOLA EL VERGER - ZER RIBERA D'EBRE NORD,43065,430653,GARCIA,4,0,4
2020/2021,43005391,ESCOLA SANT LLORENÇ - ZER MONTSIÀ,43063,430635,LA GALERA,3,3,6
2020/2021,43005388,ESCOLA MESTRE JOSEP RONCERO I PALLARÈS - ZER MONTSIÀ,43062,430629,FREGINALS,3,1,4
2020/2021,43005376,ESCOLA PUIGMARÍ - ZER BAIX CAMP SUD,43053,430537,DUESAIGÜES,2,1,3
2020/2021,43005364,ESCOLA LES ERES,43050,430509,CREIXELL,14,4,18
2020/2021,43005340,ESCOLA SANTA ANNA,43042,430424,CASTELLVELL DEL CAMP,16,2,18
2020/2021,43005339,ESCOLA MONTSANT - ZER MONTSANT,43027,430271,LA BISBAL DE FALSET,3,0,3
2020/2021,43005327,ESCOLA RAMON SUGRA¦ES,43011,430115,ALMOSTER,10,5,15
2020/2021,43005315,ESCOLA D'ALFARA DE CARLES - ZER MONT CARO,43008,430081,ALFARA DE CARLES,4,0,4
2020/2021,43005303,ESCOLA SANT JORDI - ZER RIU I SERRA,43006,430069,ALDOVER,6,0,6
2020/2021,43005297,ESCOLA JOAN PERUCHO,43002,430022,ALBINYANA,10,5,15
2020/2021,43005194,ESCOLA MEDITERRANI,43906,439060,L'AMPOLLA,14,3,17
2020/2021,43005170,ESCOLA LA FLORESTA,43148,431482,TARRAGONA,14,2,16
2020/2021,43005169,ESCOLA PAU DELCLÒS,43148,431482,TARRAGONA,24,6,30
2020/2021,43005157,ESCOLA MONTOLIU,43126,431264,LA RIERA DE GAIÀ,14,2,16
2020/2021,43005145,ESCOLA ELS AMETLLERS,43111,431114,LA POBLA DE MONTORNÈS,13,4,17
2020/2021,43005133,ESCOLA MARE DE DÉU DEL PRIORAT,43020,430206,BANYERES DEL PENEDÈS,12,4,16
2020/2021,43005121,ESCOLA SANTA CATERINA,43178,431785,VINYOLS I ELS ARCS,12,4,16
2020/2021,43005108,ESCOLA LES ERES - ZER RIBERA D'EBRE NORD,43177,431779,VINEBRE,5,0,5
2020/2021,43005081,ESCOLA MARE DE DÉU DELS TORRENTS - ZER POBLET,43176,431763,VIMBODÍ I POBLET,6,1,7
2020/2021,43005017,ESCOLA DEL MONTGOI - ZER POBLET,43172,431726,VILAVERD,2,1,3
2020/2021,43005005,ESCOLA SANT BERNAT CALVÓ,43171,431711,VILA-SECA,26,3,29
2020/2021,43004979,ESCOLA TORROJA I MIRET,43171,431711,VILA-SECA,27,3,30
2020/2021,43004931,ESCOLA SANTA MARIA DEL MAR,43905,439057,SALOU,29,3,32
2020/2021,43004921,ESCOLA BERNARDÍ TOLRÀ,43170,431704,VILA-RODONA,12,3,15
2020/2021,43004888,ESCOLA FONT DE L'ARC - ZER BAIX CAMP SUD,43167,431671,VILANOVA D'ESCORNALBOU,6,1,7
2020/2021,43004864,ESCOLA PERE VIRGILI,43166,431665,VILALLONGA DEL CAMP,22,4,26
2020/2021,43004815,ESCOLA PAU CASALS,43163,431634,EL VENDRELL,25,6,31
2020/2021,43004803,INSTITUT ANDREU NIN,43163,431634,EL VENDRELL,71,63,134
2020/2021,43004797,INSTITUT BAIX PENEDÈS,43163,431634,EL VENDRELL,47,22,69
2020/2021,43004748,ESCOLA ÀNGEL GUIMERÀ,43163,431634,EL VENDRELL,27,9,36
2020/2021,43004700,ESCOLA VALDELORS,43162,431628,VANDELLÒS I L'HOSPITALET DE L'INFANT,7,2,9
2020/2021,43004657,ESCOLA MESTRAL,43162,431628,VANDELLÒS I L'HOSPITALET DE L'INFANT,35,6,41
2020/2021,43004633,ESCOLA EUGENI D'ORS,43161,431613,VALLS,26,5,31
2020/2021,43004611,INSTITUT JAUME HUGUET,43161,431613,VALLS,56,51,107
2020/2021,43004608,INSTITUT NARCÍS OLLER,43161,431613,VALLS,60,26,86
2020/2021,43004530,ESCOLA BALTASAR SEGÚ,43161,431613,VALLS,15,5,20
2020/2021,43004529,ESCOLA MARE DE DÉU DE LA CANDELA,43161,431613,VALLS,16,4,20
2020/2021,43004517,ESCOLA ROCABRUNA - ZER EL FRANCOLÍ,43161,431613,VALLS,6,1,7
2020/2021,43004505,ESCOLA MARE DE DÉU DEL ROSER,43160,431606,VALLMOLL,14,1,15
2020/2021,43004487,ESCOLA MONTSANT - ZER MONTSANT-SERRA DE PRADES,43157,431573,ULLDEMOLINS,2,1,3
2020/2021,43004463,ESCOLA RAMÓN Y CAJAL,43156,431567,ULLDECONA,33,8,41
2020/2021,43004441,INSTITUT DE L'EBRE,43155,431554,TORTOSA,55,59,114
2020/2021,43004438,INSTITUT DERTOSA,43155,431554,TORTOSA,61,37,98
2020/2021,43004268,ESCOLA REMOLINS,43155,431554,TORTOSA,17,4,21
2020/2021,43004256,ESCOLA FERRERIES,43155,431554,TORTOSA,23,8,31
2020/2021,43004232,ESCOLA LA MERCÈ,43155,431554,TORTOSA,18,6,24
2020/2021,43004189,ESCOLA SANT JAUME,43902,439023,SANT JAUME D'ENVEJA,18,1,19
2020/2021,43004116,ESCOLA DEL LLIGALLO DEL GÀNGUIL - ZER MESTRAL,43903,439039,CAMARLES,7,0,7
2020/2021,43004074,ESCOLA L'ASSUMPCIÓ,43901,439018,DELTEBRE,18,6,24
2020/2021,43004050,ESCOLA 21 D'ABRIL,43904,439044,L'ALDEA,14,3,17
2020/2021,43004037,ESCOLA MARIA GARCÍA I CABANES,43904,439044,L'ALDEA,11,4,15
2020/2021,43004013,ESCOLA SANT MIQUEL,43901,439018,DELTEBRE,26,7,33
2020/2021,43003987,ESCOLA PORT RODÓ - ZER MESTRAL,43155,431554,TORTOSA,10,0,10
2020/2021,43003975,ESCOLA SANT ÀNGEL,43903,439039,CAMARLES,13,2,15
2020/2021,43003951,ESCOLA BÍTEM - ZER RIU AVALL,43155,431554,TORTOSA,8,1,9
2020/2021,43003884,ESCOLA ANTONI ROIG,43153,431536,TORREDEMBARRA,24,7,31
2020/2021,43003847,ESCOLA MARCEL·LÍ DOMINGO,43150,431508,TIVISSA,10,1,11
2020/2021,43003835,ESCOLA JOSEP RIBA - ZER LES VINYES,43150,431508,TIVISSA,2,1,3
2020/2021,43003801,ESCOLA LA PINEDA - ZER RIU AVALL,43149,431495,TIVENYS,5,1,6
2020/2021,43003768,ESCOLA ELS ÀNGELS,43148,431482,TARRAGONA,33,4,37
2020/2021,43003756,ESCOLA TORREFORTA,43148,431482,TARRAGONA,25,7,32
2020/2021,43003732,INSTITUT PONS D'ICART,43148,431482,TARRAGONA,36,18,54
2020/2021,43003720,ESCOLA EL MIRACLE,43148,431482,TARRAGONA,17,1,18
2020/2021,43003690,ESCOLA DE PRÀCTIQUES,43148,431482,TARRAGONA,25,5,30
2020/2021,43003653,INSTITUT COMTE DE RIUS,43148,431482,TARRAGONA,43,55,98
2020/2021,43003641,INSTITUT ANTONI DE MARTÍ I FRANQUÈS,43148,431482,TARRAGONA,74,40,114
2020/2021,43003321,ESCOLA SANT PERE I SANT PAU,43148,431482,TARRAGONA,20,1,21
2020/2021,43003306,ESCOLA SERRALLO,43148,431482,TARRAGONA,16,1,17
2020/2021,43003227,ESCOLA SANT SALVADOR,43148,431482,TARRAGONA,26,8,34
2020/2021,43003185,ESCOLA LA CANONJA,43907,439076,LA CANONJA,34,5,39
2020/2021,43003136,ESCOLA BONAVISTA,43148,431482,TARRAGONA,34,5,39
2020/2021,43003124,ESCOLA SAGRAT COR - ZER CONCA DE BARBERÀ,43147,431476,SOLIVELLA,4,1,5
2020/2021,43003100,ESCOLA ABEL FERRATER,43145,431457,LA SELVA DEL CAMP,25,6,31
2020/2021,43003082,ESCOLA GUILLEM DE CLARAMUNT,43144,431444,LA SECUITA,13,3,16
2020/2021,43003069,ESCOLA SALVADOR NINOT,43142,431423,SARRAL,14,2,16
2020/2021,43003011,ESCOLA COR DE ROURE,43139,431397,SANTA COLOMA DE QUERALT,12,4,16
2020/2021,43003008,ESCOLA JAUME BALMES,43138,431384,SANTA BÀRBARA,23,4,27
2020/2021,43002892,ESCOLA CARLES III,43136,431362,SANT CARLES DE LA RÀPITA,34,8,42
2020/2021,43002831,ESCOLA MESTRE MARCEL·LÍ DOMINGO,43133,431331,ROQUETES,34,8,42
2020/2021,43002776,ESCOLA SALVADOR ESPRIU,43131,431310,RODA DE BERÀ,18,7,25
2020/2021,43002752,ESCOLA BEAT BONAVENTURA GRAN,43129,431299,RIUDOMS,29,1,30
2020/2021,43002661,ESCOLA SANT AGUSTÍ - ZER EBRE,43125,431251,RIBA-ROJA D'EBRE,7,0,7
2020/2021,43002594,INSTITUT BAIX CAMP,43123,431233,REUS,101,46,147
2020/2021,43002582,INSTITUT SALVADOR VILASECA,43123,431233,REUS,40,22,62
2020/2021,43002570,INSTITUT GAUDÍ,43123,431233,REUS,62,20,82
2020/2021,43002272,ESCOLA GENERAL PRIM,43123,431233,REUS,20,4,24
2020/2021,43002260,ESCOLA CIUTAT DE REUS,43123,431233,REUS,5,0,5
2020/2021,43002259,ESCOLA MARIÀ FORTUNY,43123,431233,REUS,30,5,35
2020/2021,43002247,ESCOLA MISERICÒRDIA,43123,431233,REUS,16,5,21
2020/2021,43002235,ESCOLA POMPEU FABRA,43123,431233,REUS,18,3,21
2020/2021,43002211,ESCOLA PRAT DE LA RIBA,43123,431233,REUS,13,3,16
2020/2021,43002171,ESCOLA JOAN PLANA,43119,431191,PUIGPELAT,15,0,15
2020/2021,43002144,ESCOLA MARE DE DÉU DE LA FONTCALDA - ZER PORTS-ALGARS,43117,431172,PRAT DE COMTE,3,0,3
2020/2021,43002053,ESCOLA GARBÍ - ZER MONTSANT-SERRA DE PRADES,43112,431129,POBOLEDA,2,1,3
2020/2021,43002016,ESCOLA L'AMETLLER - ZER TERRA ALTA NORD,43110,431107,LA POBLA DE MASSALUCA,3,0,3
2020/2021,43001966,ESCOLA SANT RAMON,43108,431080,EL PLA DE SANTA MARIA,12,3,15
2020/2021,43001954,ESCOLA ANTONI TOUS - ZER CONCA DE BARBERÀ,43107,431074,PIRA,5,2,7
2020/2021,43001942,ESCOLA CÈSAR MARTINELL - ZER TERRA ALTA-CENTRE,43106,431068,EL PINELL DE BRAI,5,2,7
2020/2021,43001929,ESCOLA JAUME II,43104,431042,EL PERELLÓ,18,4,22
2020/2021,43001851,ESCOLA SANT ROC - ZER RIU I SERRA,43102,431021,PAÜLS,5,0,5
2020/2021,43001826,ESCOLA SANT SEBASTIÀ,43100,431009,ELS PALLARESOS,20,4,24
2020/2021,43001796,ESCOLA SANT SEBASTIÀ - ZER ATZAVARA,43098,430982,NULLES,5,3,8
2020/2021,43001735,ESCOLA VENTURA GASSOL,43095,430957,EL MORELL,26,5,31
2020/2021,43001681,ESCOLA LLUÍS VI¦AS I VI¦OLES,43093,430939,MÓRA D'EBRE,27,4,31
2020/2021,43001668,ESCOLA MARE DE DÉU DE LA ROCA,43092,430923,MONT-ROIG DEL CAMP,27,5,32
2020/2021,43001656,ESCOLA TERESA GODES I DOMÈNECH,43090,430901,EL MONTMELL,11,3,14
2020/2021,43001607,ESCOLA JOSEP M. SOLER I GENÉ,43088,430884,MONTBRIÓ DEL CAMP,17,5,22
2020/2021,43001553,ESCOLA LES MURALLES,43086,430862,MONTBLANC,28,5,33
2020/2021,43001498,ESCOLA ONZE DE SETEMBRE - ZER BAIX PRIORAT,43082,430825,EL MASROIG,3,1,4
2020/2021,43001462,ESCOLA ELS TIL·LERS - ZER EL FRANCOLÍ,43080,430803,LA MASÓ,4,0,4
2020/2021,43001437,ESCOLA ROSA GISBERT - ZER MONTSIÀ,43078,430786,MASDENVERGE,6,2,8
2020/2021,43001395,ESCOLA TERESA SUBIRATS I MESTRE - ZER MONTSIÀ,43077,430770,MAS DE BARBERANS,3,2,5
2020/2021,43001383,ESCOLA ANICET VILLAR - ZER LES VINYES,43076,430764,MARÇÀ,3,1,4
2020/2021,43001361,ESCOLA LES COMETES,43074,430748,LLORENÇ DEL PENEDÈS,16,7,23
2020/2021,43001346,ESCOLA MONTSAGRE,43071,430712,HORTA DE SANT JOAN,7,2,9
2020/2021,43001334,ESCOLA SANT FELIU - ZER LES VINYES,43070,430705,ELS GUIAMETS,2,1,3
2020/2021,43001310,ESCOLA LLICORELLA - ZER L'AGLÀ,43069,430691,GRATALLOPS,3,0,3
2020/2021,43001280,ESCOLA PÀMIES - ZER LA FONT DE L'AIGUADÍ,43067,430672,GINESTAR,5,1,6
2020/2021,43001231,ESCOLA PUIG CAVALLER,43064,430640,GANDESA,20,7,27
2020/2021,43001127,ESCOLA ENRIC GRAU I FONTSERÈ,43060,430607,FLIX,17,3,20
2020/2021,43001115,ESCOLA MARE DE DÉU DE L'ESPERANÇA - ZER LA PARELLADA,43059,430593,FIGUEROLA DEL CAMP,5,0,5
2020/2021,43001097,ESCOLA LOS CASTELLETS - ZER TERRA ALTA NORD,43056,430568,LA FATARELLA,6,0,6
2020/2021,43001051,ESCOLA ANTONI VILANOVA,43055,430555,FALSET,25,2,27
2020/2021,43001036,ESCOLA MARTÍ POCH,43054,430542,L'ESPLUGA DE FRANCOLÍ,13,2,15
2020/2021,43001000,ESCOLA DE XERTA,43052,430521,XERTA,8,1,9
2020/2021,43000998,ESCOLA POMPEU FABRA,43051,430516,CUNIT,23,4,27
2020/2021,43000950,ESCOLA DOCTOR FERRAN - ZER TERRA ALTA-CENTRE,43048,430483,CORBERA D'EBRE,5,1,6
2020/2021,43000895,ESCOLA MOSSÈN RAMON BERGADÀ,43047,430477,CONSTANTÍ,28,8,36
2020/2021,43000809,ESCOLA LA GESSERA - ZER PORTS-ALGARS,43041,430419,CASERES,2,1,3
2020/2021,43000792,ESCOLA SANT ISIDRE - ZER LES VINYES,43040,430402,CAPÇANES,2,2,4
2020/2021,43000779,INSTITUT RAMON BERENGUER IV,43038,430385,CAMBRILS,40,28,68
2020/2021,43000721,ESCOLA MOSSÈN JACINT VERDAGUER,43037,430379,CALAFELL,29,6,35
2020/2021,43000706,ESCOLA SANTA CREU DE CALAFELL,43037,430379,CALAFELL,32,7,39
2020/2021,43000688,ESCOLA DE CABRA DEL CAMP - ZER LA PARELLADA,43036,430363,CABRA DEL CAMP,3,2,5
2020/2021,43000676,ESCOLA EL CASTELL - ZER MONTSANT,43035,430350,CABACÉS,4,0,4
2020/2021,43000652,ESCOLA SANT JAUME DE BRÀFIM - ZER ATZAVARA,43034,430347,BRÀFIM,7,2,9
2020/2021,43000640,ESCOLA MARE DE DÉU DE LA CANDELA,43033,430332,BOTARELL,15,0,15
2020/2021,43000639,ESCOLA SANT BLAI - ZER TERRA ALTA-CENTRE,43032,430326,BOT,4,1,5
2020/2021,43000627,ESCOLA ROCABRUNA,43031,430311,LES BORGES DEL CAMP,12,4,16
2020/2021,43000615,ESCOLA L'ESTEL - ZER ELS CEPS,43030,430304,BONASTRE,3,4,7
2020/2021,43000603,ESCOLA DE BLANCAFORT - ZER POBLET,43029,430290,BLANCAFORT,3,0,3
2020/2021,43000597,ESCOLA ULL DEL VENT,43028,430287,LA BISBAL DEL PENEDÈS,15,7,22
2020/2021,43000561,ESCOLA ANTONI NAT - ZER BENISSANET-MIRAVET,43026,430265,BENISSANET,8,0,8
2020/2021,43000551,ESCOLA LLORENÇ VALLESPÍ I VIDIELLA - ZER RIU I SERRA,43025,430252,BENIFALLET,3,2,5
2020/2021,43000548,ESCOLA LA MUNTANYETA,43024,430249,BELLVEI,15,4,19
2020/2021,43000512,ESCOLA EL SARRAÍ - ZER BAIX PRIORAT,43023,430234,BELLMUNT DEL PRIORAT,1,1,2
2020/2021,43000470,ESCOLA VALLDEMUR - ZER CONCA DE BARBERÀ,43021,430213,BARBERÀ DE LA CONCA,6,1,7
2020/2021,43000433,ESCOLA SANT MIQUEL,43019,430192,ASCÓ,14,1,15
2020/2021,43000421,ESCOLA LA MIRANDA - ZER PORTS-ALGARS,43018,430189,ARNES,3,2,5
2020/2021,43000378,ESCOLA SANT JULIÀ,43016,430167,L'ARBOÇ,26,7,33
2020/2021,43000329,INSTITUT RAMON BERENGUER IV,43014,430141,AMPOSTA,54,27,81
2020/2021,43000275,ESCOLA MIQUEL GRANELL,43014,430141,AMPOSTA,23,7,30
2020/2021,43000263,ESCOLA SANT JORDI,43013,430136,L'AMETLLA DE MAR,34,4,38
2020/2021,43000251,ESCOLA LA PORTALADA,43012,430120,ALTAFULLA,26,3,29
2020/2021,43000226,ESCOLA LA BARQUERA - ZER ATZAVARA,43010,430108,ALIÓ,4,0,4
2020/2021,43000214,ESCOLA JOSEP FUSTÉ,43009,430094,ALFORJA,16,0,16
2020/2021,43000184,ESCOLA TERESA SALVAT I LLAURADÓ - ZER BAIX CAMP NORD,43007,430075,L'ALEIXAR,6,0,6
2020/2021,43000135,ESCOLA MARE DE DÉU DEL REMEI,43005,430056,ALCOVER,28,5,33
2020/2021,43000081,ESCOLA JOAN BAPTISTA SERRA,43004,430043,ALCANAR,42,5,47
2020/2021,43000020,ESCOLA SANT MIQUEL,43001,430017,AIGUAMÚRCIA,6,1,7
2020/2021,25010361,INSTITUT CENTRE D'ESPORTS DE MUNTANYA DEL PALLARS,25171,251713,LA POBLA DE SEGUR,7,8,15
2020/2021,25010358,INSTITUT ESCOLA VALL DE LORD,25193,251930,SANT LLORENÇ DE MORUNYS,13,6,19
2020/2021,25010334,INSTITUT ESCOLA MAGRANERS,25120,251207,LLEIDA,19,7,26
2020/2021,25010310,INSTITUT DE MOLLERUSSA IV,25137,251370,MOLLERUSSA,18,1,19
2020/2021,25010280,INSTITUT ESCOLA TORRE QUERALT,25120,251207,LLEIDA,36,7,43
2020/2021,25010231,ESCOLA DE SALÀS DE PALLARS - ZER PALLARS JUSSÀ,25190,251902,SALÀS DE PALLARS,3,0,3
2020/2021,25010127,INSTITUT CASTELL DELS TEMPLERS,25120,251207,LLEIDA,19,13,32
2020/2021,25010085,ESCOLA JOSEP MA¦É I GAVALDÀ - ZER PONENT,25120,251207,LLEIDA,6,0,6
2020/2021,25009836,INSTITUT LA MITJANA,25120,251207,LLEIDA,49,7,56
2020/2021,25009800,ESCOLA TORRELAMEU - ZER ARGELAGA,25231,252311,TORRELAMEU,5,0,5
2020/2021,25009733,INSTITUT JOAN SOLÀ,25228,252287,TORREFARRERA,33,16,49
2020/2021,25009721,INSTITUT D'ALPICAT,25023,250236,ALPICAT,22,5,27
2020/2021,25009368,ESCOLA LA VALIRA,25203,252038,LA SEU D'URGELL,6,1,7
2020/2021,25009356,ESCOLA LES ARRELS,25137,251370,MOLLERUSSA,13,4,17
2020/2021,25009344,ESCOLA LA MITJANA,25120,251207,LLEIDA,26,3,29
2020/2021,25009186,INSTITUT LA VALIRA,25203,252038,LA SEU D'URGELL,17,5,22
2020/2021,25009149,ESCOLA PINYANA,25120,251207,LLEIDA,18,7,25
2020/2021,25009113,ESCOLA MESTRE RAMON ESTADELLA I TORRADEFLOT,25110,251109,GUISSONA,22,2,24
2020/2021,25009101,ESCOLA EL VINYET,25207,252075,SOLSONA,15,1,16
2020/2021,25009095,ESCOLA LES SAVINES,25072,250729,CERVERA,14,2,16
2020/2021,25009071,ESCOLA PAÏSOS CATALANS,25120,251207,LLEIDA,28,2,30
2020/2021,25009034,ESCOLA CIUTAT JARDÍ,25120,251207,LLEIDA,27,3,30
2020/2021,25008984,CFA TREMP,25234,252347,TREMP,3,0,3
2020/2021,25008935,ESCOLA LA RÀPITA - ZER EL JONC,25240,252402,VALLFOGONA DE BALAGUER,5,0,5
2020/2021,25008923,CFA ENRIC GRANADOS,25120,251207,LLEIDA,9,6,15
2020/2021,25008893,ESCOLA PARC DEL SALADAR,25011,250117,ALCARRÀS,34,6,40
2020/2021,25008790,ESCOLA MARIA-MERCÈ MARÇAL,25217,252173,TÀRREGA,19,5,24
2020/2021,25008789,ESCOLA MONT-ROIG,25040,250404,BALAGUER,17,3,20
2020/2021,25008777,ESCOLA PARC DE L'AIGUA,25120,251207,LLEIDA,26,4,30
2020/2021,25008765,ESCOLA LA VALL FOSCA - ZER PALLARS JUSSÀ,25227,252271,LA TORRE DE CABDELLA,5,1,6
2020/2021,25008753,CFA SOLSONÈS,25207,252075,SOLSONA,6,0,6
2020/2021,25008741,CFA VAL D'ARAN,25243,252430,VIELHA E MIJARAN,3,0,3
2020/2021,25008649,ESCOLA FRANCESCO TONUCCI,25120,251207,LLEIDA,17,2,19
2020/2021,25008625,CFA MOLLERUSSA,25137,251370,MOLLERUSSA,6,3,9
2020/2021,25008595,CFA TÀRREGA,25217,252173,TÀRREGA,4,2,6
2020/2021,25008583,CFA LA SEU D'URGELL,25203,252038,LA SEU D'URGELL,5,1,6
2020/2021,25008571,CFA JOAN COMORERA,25072,250729,CERVERA,1,3,4
2020/2021,25008561,CFA BALAGUER,25040,250404,BALAGUER,1,3,4
2020/2021,25008558,EOI DE LA SEU D'URGELL,25203,252038,LA SEU D'URGELL,6,2,8
2020/2021,25008546,EOI DE TÀRREGA,25217,252173,TÀRREGA,5,1,6
2020/2021,25008534,ESCOLA DE LA VALL DE BOÍ - ZER ALTA RIBAGORÇA,25043,250432,LA VALL DE BOÍ,6,1,7
2020/2021,25008352,INSTITUT DE LA POBLA DE SEGUR,25171,251713,LA POBLA DE SEGUR,21,9,30
2020/2021,25008236,ZER PEDRERA,25081,250812,L'ESPLUGA CALBA,2,1,3
2020/2021,25008224,ZER ARGELAGA,25254,252542,VILANOVA DE LA BARCA,2,1,3
2020/2021,25008212,ESCOLA PRÀCTIQUES II,25120,251207,LLEIDA,27,3,30
2020/2021,25008157,ZER RIU ONDARA,25225,252252,TORNABOUS,3,1,4
2020/2021,25008145,ZER ALT SEGRIÀ,25251,252516,VILANOVA DE SEGRIÀ,3,1,4
2020/2021,25008133,ZER PONENT,25120,251207,LLEIDA,4,0,4
2020/2021,25008111,ZER LA COMA,25211,252115,SUDANELL,3,0,3
2020/2021,25008108,ZER L'ERAL,25200,252000,SARROCA DE LLEIDA,4,0,4
2020/2021,25008091,ZER VENT SERÈ,25068,250680,CASTELLNOU DE SEANA,3,1,4
2020/2021,25008081,ZER EL JONC,25062,250621,CAMARASA,3,1,4
2020/2021,25008078,ZER EL ROMANÍ,25138,251386,MONTGAI,3,2,5
2020/2021,25008066,ZER ESPERNALLAC,25070,250707,CASTELLSERÀ,5,0,5
2020/2021,25008054,ZER VALL DE L'ARANYÓ,25067,250674,CASTELLDANS,3,1,4
2020/2021,25008042,ZER RIU SET,25009,250096,L'ALBI,4,1,5
2020/2021,25007992,ESCOLA D'ALMENAR,25021,250215,ALMENAR,19,3,22
2020/2021,25007943,ZER PLAURCÉN,25168,251689,EL POAL,3,1,4
2020/2021,25007931,ZER VAL D'ARAN,25025,250254,NAUT ARAN,4,1,5
2020/2021,25007921,ZER L'HORTA DE LLEIDA,25120,251207,LLEIDA,4,0,4
2020/2021,25007918,ZER L'OLIVER,25133,251333,MAIALS,3,1,4
2020/2021,25007906,ZER SERRA LLARGA,25015,250156,ALGERRI,2,2,4
2020/2021,25007891,ZER ALTA RIBAGORÇA,25245,252458,VILALLER,4,1,5
2020/2021,25007888,ZER GARRIGUES ALTES,25118,251180,JUNCOSA,2,2,4
2020/2021,25007876,ZER RIU CORB,25046,250463,BELIANES,3,1,4
2020/2021,25007864,ZER URGELLET,25203,252038,LA SEU D'URGELL,3,1,4
2020/2021,25007852,ZER EL SIÓ,25138,251386,MONTGAI,3,1,4
2020/2021,25007840,ZER MONTSEC,25037,250371,LES AVELLANES I SANTA LINYA,3,1,4
2020/2021,25007839,ZER PALLARS JUSSÀ,25115,251155,ISONA I CONCA DELLÀ,2,2,4
2020/2021,25007827,ZER NARIEDA,25155,251556,ORGANYÀ,3,1,4
2020/2021,25007815,ZER ELAIA,25101,251018,LA GRANADELLA,2,1,3
2020/2021,25007803,ZER ALT PALLARS SOBIRÀ,25126,251266,LLAVORSÍ,4,0,4
2020/2021,25007797,ZER BARIDÀ-BATLLIA,25139,251399,MONTELLÀ I MARTINET,1,3,4
2020/2021,25007773,ZER LA SEGARRA,25905,259059,RIBERA D'ONDARA,2,2,4
2020/2021,25007761,ZER GUICIVERVI,25244,252445,VILAGRASSA,3,1,4
2020/2021,25007700,INSTITUT ERMENGOL IV,25047,250479,BELLCAIRE D'URGELL,26,5,31
2020/2021,25007611,CFA JOAN CARLES I,25120,251207,LLEIDA,7,5,12
2020/2021,25007529,INSTITUT SERÒS,25204,252043,SERÒS,23,16,39
2020/2021,25007517,INSTITUT LA SERRA,25137,251370,MOLLERUSSA,34,21,55
2020/2021,25007505,INSTITUT DE GUISSONA,25110,251109,GUISSONA,49,20,69
2020/2021,25007499,INSTITUT L'OLIVERA,25101,251018,LA GRANADELLA,7,6,13
2020/2021,25007189,INSTITUT MARIA RÚBIES,25120,251207,LLEIDA,42,18,60
2020/2021,25007153,INSTITUT D'ALCARRÀS,25011,250117,ALCARRÀS,45,17,62
2020/2021,25007025,INSTITUT MORELLÓ,25086,250864,ESTERRI D'ÀNEU,6,6,12
2020/2021,25006781,INSTITUT ALFONS COSTAFREDA,25217,252173,TÀRREGA,49,26,75
2020/2021,25006771,INSTITUT RONDA,25120,251207,LLEIDA,72,14,86
2020/2021,25006744,CEE ESPERANÇA,25120,251207,LLEIDA,10,3,13
2020/2021,25006732,INSTITUT TORREVICENS,25120,251207,LLEIDA,103,24,127
2020/2021,25006720,INSTITUT D'HOTELERIA I TURISME,25120,251207,LLEIDA,10,15,25
2020/2021,25006598,INSTITUT LO PLA D'URGELL,25050,250501,BELLPUIG,32,16,48
2020/2021,25006574,INSTITUT DE PONTS,25172,251728,PONTS,17,8,25
2020/2021,25006549,ESCOLA D'ESPLUGA DE SERRA - ZER ALTA RIBAGORÇA,25234,252347,TREMP,2,0,2
2020/2021,25006525,INSTITUT JOSEP VALLVERDÚ,25058,250582,LES BORGES BLANQUES,43,18,61
2020/2021,25006513,INSTITUT MANUEL DE MONTSUAR,25120,251207,LLEIDA,36,13,49
2020/2021,25006501,ESCOLA ALBA,25078,250788,CORBINS,26,2,28
2020/2021,25006495,INSTITUT JOSEP LLADONOSA,25120,251207,LLEIDA,37,23,60
2020/2021,25006483,INSTITUT CANIGÓ,25019,250194,ALMACELLES,27,16,43
2020/2021,25006471,INSTITUT AUBENÇ,25149,251497,OLIANA,11,6,17
2020/2021,25006410,CFA SEGRIÀ,25120,251207,LLEIDA,7,4,11
2020/2021,25006409,ESCOLA JOC DE LA BOLA,25120,251207,LLEIDA,30,2,32
2020/2021,25006291,INSTITUT HUG ROGER III,25209,252094,SORT,27,13,40
2020/2021,25006288,INSTITUT DE TREMP,25234,252347,TREMP,32,22,54
2020/2021,25006276,ESCOLA SANT JORDI,25120,251207,LLEIDA,12,3,15
2020/2021,25006264,ESCOLA ESPIGA,25120,251207,LLEIDA,25,3,28
2020/2021,25006252,EOI DE LLEIDA,25120,251207,LLEIDA,33,9,42
2020/2021,25006240,INSTITUT EL PONT DE SUERT,25173,251734,EL PONT DE SUERT,26,19,45
2020/2021,25006239,INSTITUT D'ARAN,25243,252430,VIELHA E MIJARAN,38,18,56
2020/2021,25006227,INSTITUT D'ALMENAR,25021,250215,ALMENAR,28,16,44
2020/2021,25006148,INSTITUT D'OSTALARIA DE LES-VAL D'ARAN,25121,251214,LES,7,5,12
2020/2021,25006069,ESCOLA D'ARDÈVOL - ZER EL SOLSONÈS,25167,251673,PINÓS,2,1,3
2020/2021,25005983,ESCOLA SANT SERNI - ZER BARIDÀ-BATLLIA,25175,251752,PRATS I SANSOR,5,0,5
2020/2021,25005910,ESCOLA ABAT RUERA - ZER PEDRERA,25180,251804,PUIGGRÒS,3,1,4
2020/2021,25005909,ESCOLA MOSSÈN RAMON MUNTANYOLA - ZER RIU CORB,25154,251543,ELS OMELLS DE NA GAIA,0,2,2
2020/2021,25005892,ESCOLA MALDANELL - ZER RIU CORB,25130,251305,MALDÀ,1,1,2
2020/2021,25005880,ESCOLA FREDERIC GODAS,25120,251207,LLEIDA,24,7,31
2020/2021,25005727,INSTITUT ALMATÀ,25040,250404,BALAGUER,39,18,57
2020/2021,25005685,INSTITUT LA SEGARRA,25072,250729,CERVERA,49,16,65
2020/2021,25005673,ESCOLA JOAN MARAGALL,25120,251207,LLEIDA,20,5,25
2020/2021,25005582,INSTITUT TERRES DE PONENT,25137,251370,MOLLERUSSA,38,9,47
2020/2021,25005557,CEE SILOÉ,25137,251370,MOLLERUSSA,9,1,10
2020/2021,25005545,ESCOLA POMPEU FABRA,25137,251370,MOLLERUSSA,27,2,29
2020/2021,25005533,ESCOLA PAU CLARIS,25203,252038,LA SEU D'URGELL,20,1,21
2020/2021,25005454,INSTITUT FRANCESC RIBALTA,25207,252075,SOLSONA,38,21,59
2020/2021,25005442,INSTITUT ESCOLA DEL TREBALL,25120,251207,LLEIDA,42,29,71
2020/2021,25005430,ESCOLA JOAN XXIII,25120,251207,LLEIDA,21,6,27
2020/2021,25005429,INSTITUT ELS PLANELLS,25034,250349,ARTESA DE SEGRE,26,4,30
2020/2021,25005260,INSTITUT RIBERA DEL SIÓ,25003,250030,AGRAMUNT,26,12,38
2020/2021,25005171,ESCOLA MESTRE IGNASI PERAIRE,25137,251370,MOLLERUSSA,26,6,32
2020/2021,25005144,ESCOLA ÀNGEL SERAFÍ I CASANOVAS,25209,252094,SORT,22,1,23
2020/2021,25005132,ESCOLA SANT JORDI,25149,251497,OLIANA,15,0,15
2020/2021,25005120,ESCOLA TERESA BERGADÀ,25016,250169,ALGUAIRE,19,1,20
2020/2021,25005119,ESCOLA PINYANA,25013,250138,ALFARRÀS,18,4,22
2020/2021,25005107,ESCOLA SANT BONIFACI - ZER RIU SET,25255,252555,VINAIXA,2,1,3
2020/2021,25005090,ESCOLA MESTRAL - ZER ARGELAGA,25254,252542,VILANOVA DE LA BARCA,7,1,8
2020/2021,25005077,ESCOLA MOSSÈN TON CLAVÉ - ZER VENT SERÈ,25252,252521,VILA-SANA,7,0,7
2020/2021,25005065,ESCOLA DE VILANOVA DE SEGRIÀ - ZER ALT SEGRIÀ,25251,252516,VILANOVA DE SEGRIÀ,7,0,7
2020/2021,25005053,ESCOLA MARE DE DÉU DEL PUIG DE MEIÀ - ZER EL ROMANÍ,25250,252509,VILANOVA DE MEIÀ,4,0,4
2020/2021,25005016,ESCOLA MARINADA,25248,252483,VILANOVA DE BELLPUIG,12,3,15
2020/2021,25004981,ESCOLA VIDAL I ABAD - ZER ALTA RIBAGORÇA,25245,252458,VILALLER,5,0,5
2020/2021,25004966,ESCOLA RAMON PERELLÓ - ZER GUICIVERVI,25244,252445,VILAGRASSA,6,1,7
2020/2021,25004929,ESCOLA GARONA,25243,252430,VIELHA E MIJARAN,34,4,38
2020/2021,25004863,ESCOLA JARDÍ - ZER GUICIVERVI,25242,252424,VERDÚ,4,3,7
2020/2021,25004851,ESCOLA SALVADOR ESPRIU,25240,252402,VALLFOGONA DE BALAGUER,12,3,15
2020/2021,25004826,ESCOLA DE TUIXENT - ZER URGELLET,25910,259101,JOSA I TUIXÉN,2,0,2
2020/2021,25004772,ESCOLA VALLDEFLORS,25234,252347,TREMP,27,2,29
2020/2021,25004759,ESCOLA EL ROSER - ZER ALT SEGRIÀ,25233,252332,TORRE-SERONA,3,0,3
2020/2021,25004747,ESCOLA CARRASSUMADA,25232,252326,TORRES DE SEGRE,15,0,15
2020/2021,25004723,ESCOLA LA BASSA,25230,252304,TORREGROSSA,15,2,17
2020/2021,25004711,ESCOLA LA CREU,25228,252287,TORREFARRERA,31,5,36
2020/2021,25004656,ESCOLA DE TORREBESSES - ZER L'ERAL,25226,252265,TORREBESSES,2,1,3
2020/2021,25004644,ESCOLA ESPÍGOL - ZER RIU ONDARA,25225,252252,TORNABOUS,7,0,7
2020/2021,25004607,ESCOLA SANT GIL,25223,252234,TORÀ,11,1,12
2020/2021,25004577,ESCOLA DE TÍRVIA - ZER ALT PALLARS SOBIRÀ,25221,252213,TÍRVIA,2,0,2
2020/2021,25004565,ESCOLA ALFRED POTRONY,25220,252206,TÉRMENS,12,0,12
2020/2021,25004531,ESCOLA ÀNGEL GUIMERÀ,25217,252173,TÀRREGA,29,2,31
2020/2021,25004528,EA ONDARA,25217,252173,TÀRREGA,20,12,32
2020/2021,25004498,INSTITUT MANUEL DE PEDROLO,25217,252173,TÀRREGA,37,16,53
2020/2021,25004462,ESCOLA JACINT VERDAGUER,25217,252173,TÀRREGA,28,3,31
2020/2021,25004413,ESCOLA DE SUNYER - ZER L'ERAL,25212,252120,SUNYER,2,1,3
2020/2021,25004401,ESCOLA EL ROSER - ZER LA COMA,25211,252115,SUDANELL,7,0,7
2020/2021,25004395,ESCOLA JAUME MIRET,25210,252108,SOSES,17,0,17
2020/2021,25004243,ESCOLA SETELSIS,25207,252075,SOLSONA,27,4,31
2020/2021,25004231,ESCOLA DEL SOLERÀS - ZER GARRIGUES ALTES,25206,252069,EL SOLERÀS,3,0,3
2020/2021,25004221,ESCOLA EL TIMÓ - ZER PLAURCÉN,25205,252056,SIDAMON,7,1,8
2020/2021,25004218,ESCOLA MIQUEL BARÓ DABAN,25204,252043,SERÒS,18,1,19
2020/2021,25004188,INSTITUT JOAN BRUDIEU,25203,252038,LA SEU D'URGELL,54,27,81
2020/2021,25004140,ESCOLA MOSSÈN ALBERT VIVES,25203,252038,LA SEU D'URGELL,26,4,30
2020/2021,25004115,ESCOLA LA ROCA - ZER L'ERAL,25200,252000,SARROCA DE LLEIDA,3,0,3
2020/2021,25004103,ESCOLA EL TALLAT - ZER RIU CORB,25902,259025,SANT MARTÍ DE RIUCORB,5,1,6
2020/2021,25004085,ESCOLA VALL ONDARA - ZER LA SEGARRA,25905,259059,RIBERA D'ONDARA,3,2,5
2020/2021,25004073,ESCOLA MARE DE DÉU DE LA MERCÈ,25194,251945,SANT RAMON,9,3,12
2020/2021,25004036,ESCOLA L'ESTEL,25192,251924,SANT GUIM DE FREIXENET,11,3,14
2020/2021,25004024,ESCOLA DE SANAÜJA - ZER LA SEGARRA,25191,251919,SANAÜJA,1,2,3
2020/2021,25004000,ESCOLA LA ROSELLA,25189,251898,ROSSELLÓ,24,3,27
2020/2021,25003974,ESCOLA DE FREIXINET DE SOLSONA - ZER EL SOLSONÈS,25186,251863,RINER,2,2,4
2020/2021,25003950,ESCOLA ARNAU MIR - ZER URGELLET,25185,251850,RIBERA D'URGELLET,5,0,5
2020/2021,25003895,ESCOLA ELS MINAIRONS - ZER ALT PALLARS SOBIRÀ,25901,259010,VALL DE CARDÓS,5,0,5
2020/2021,25003871,ESCOLA MONTSENT DE PALLARS - ZER ALT PALLARS SOBIRÀ,25183,251832,RIALP,6,0,6
2020/2021,25003861,ESCOLA SANT JORDI,25182,251826,PUIGVERD DE LLEIDA,11,1,12
2020/2021,25003858,ESCOLA DE PUIGVERD D'AGRAMUNT - ZER EL SIÓ,25181,251811,PUIGVERD D'AGRAMUNT,2,1,3
2020/2021,25003846,ESCOLA EL PUIG - ZER BARIDÀ-BATLLIA,25179,251790,PRULLANS,3,0,3
2020/2021,25003822,ESCOLA DE LES VENTOSES - ZER EL SIÓ,25177,251771,PREIXENS,1,1,2
2020/2021,25003810,ESCOLA DE PREIXENS - ZER EL SIÓ,25177,251771,PREIXENS,1,2,3
2020/2021,25003809,ESCOLA MONTALBÀ - ZER RIU CORB,25176,251765,PREIXANA,2,2,4
2020/2021,25003792,ESCOLA BLANCA DE VILLALONGA - ZER ALT SEGRIÀ,25174,251749,LA PORTELLA,5,0,5
2020/2021,25003755,ESCOLA RIBAGORÇANA,25173,251734,EL PONT DE SUERT,14,2,16
2020/2021,25003718,ESCOLA DE PONTS,25172,251728,PONTS,15,5,20
2020/2021,25003688,ESCOLA ELS RAIERS,25171,251713,LA POBLA DE SEGUR,21,2,23
2020/2021,25003676,ESCOLA ELS SET FOCS - ZER ELAIA,25170,251706,BELLAGUARDA,2,0,2
2020/2021,25003652,ESCOLA EL ROSER - ZER PLAURCÉN,25168,251689,EL POAL,6,0,6
2020/2021,25003627,ESCOLA DE SANT CLIMENT - ZER EL SOLSONÈS,25166,251667,PINELL DE SOLSONÈS,2,1,3
2020/2021,25003585,ESCOLA SANT MIQUEL - ZER NARIEDA,25165,251654,PERAMOLA,3,0,3
2020/2021,25003551,ESCOLA RAMON GOMBAL - ZER ESPERNALLAC,25164,251641,PENELLES,3,0,3
2020/2021,25003536,ESCOLA DE LA COMA - ZER EL SOLSONÈS,25163,251636,LA COMA I LA PEDRA,2,0,2
2020/2021,25003500,ESCOLA DE LES PALLARGUES - ZER LA SEGARRA,25911,259118,ELS PLANS DE SIÓ,3,1,4
2020/2021,25003494,ESCOLA ARNAU BERENGUER,25158,251581,EL PALAU D'ANGLESOLA,17,1,18
2020/2021,25003482,ESCOLA LEANDRE CRISTÒFOL - ZER MONTSEC,25156,251569,OS DE BALAGUER,4,1,5
2020/2021,25003470,ESCOLA L'ESPÍGOL - ZER MONTSEC,25156,251569,OS DE BALAGUER,6,0,6
2020/2021,25003469,ESCOLA MIRET I SANS - ZER NARIEDA,25155,251556,ORGANYÀ,6,1,7
2020/2021,25003330,ESCOLA AIGUADORA - ZER EL SOLSONÈS,25146,251462,NAVÈS,5,0,5
2020/2021,25003305,ESCOLA SANT ISIDRE - ZER LA COMA,25142,251425,MONTOLIU DE LLEIDA,2,2,4
2020/2021,25003299,ESCOLA ROSA CAMPÀ,25140,251403,MONTFERRER I CASTELLBÒ,11,2,13
2020/2021,25003275,ESCOLA RIDOLAINA,25139,251399,MONTELLÀ I MARTINET,6,1,7
2020/2021,25003263,ESCOLA PERE SARRET - ZER BARIDÀ-BATLLIA,25139,251399,MONTELLÀ I MARTINET,3,0,3
2020/2021,25003241,ESCOLA COLOMINA - ZER EL ROMANÍ,25138,251386,MONTGAI,3,0,3
2020/2021,25003238,ESCOLA DE BUTSÈNIT - ZER EL SIÓ,25138,251386,MONTGAI,1,1,2
2020/2021,25003202,INSTITUT MOLLERUSSA,25137,251370,MOLLERUSSA,35,39,74
2020/2021,25003147,ESCOLA SANT MIQUEL,25135,251351,MIRALCAMP,11,5,16
2020/2021,25003135,ESCOLA JOAN ROS I PORTA - ZER EL JONC,25134,251348,MENÀRGUENS,5,0,5
2020/2021,25003123,ESCOLA OTOGESA - ZER L'OLIVER,25133,251333,MAIALS,7,1,8
2020/2021,25003111,ESCOLA DE MASSALCOREIG - ZER L'OLIVER,25131,251312,MASSALCOREIG,5,0,5
2020/2021,25003093,ESCOLA DE LLOBERA - ZER EL SOLSONÈS,25129,251291,LLOBERA,4,0,4
2020/2021,25003056,ESCOLA PORTELLA BLANCA - ZER BARIDÀ-BATLLIA,25127,251272,LLES DE CERDANYA,3,0,3
2020/2021,25003032,ESCOLA DE LLAVORSÍ - ZER ALT PALLARS SOBIRÀ,25126,251266,LLAVORSÍ,4,0,4
2020/2021,25003019,ESCOLA ARC D'ADÀ - ZER L'OLIVER,25125,251253,LLARDECANS,3,1,4
2020/2021,25002982,ESCOLA DE LLADURS - ZER EL SOLSONÈS,25124,251240,LLADURS,3,1,4
2020/2021,25002970,ESCOLA EL SITJAR,25122,251229,LINYOLA,18,2,20
2020/2021,25002957,ESCOLA ESTUDI ALEJANDRO CASONA,25121,251214,LES,11,0,11
2020/2021,25002921,ESCOLA EL VILOT - ZER PONENT,25120,251207,LLEIDA,6,1,7
2020/2021,25002854,ESCOLA EL SEGRIÀ - ZER L'HORTA DE LLEIDA,25120,251207,LLEIDA,7,1,8
2020/2021,25002799,INSTITUT CAPARRELLA,25120,251207,LLEIDA,49,65,114
2020/2021,25002787,INSTITUT JOAN ORÓ,25120,251207,LLEIDA,46,27,73
2020/2021,25002726,INSTITUT GUINDÀVOLS,25120,251207,LLEIDA,39,34,73
2020/2021,25002696,INSTITUT MARIUS TORRES,25120,251207,LLEIDA,47,27,74
2020/2021,25002684,INSTITUT SAMUEL GILI I GAYA,25120,251207,LLEIDA,38,18,56
2020/2021,25002672,ESCOLA DE PRÀCTIQUES I,25120,251207,LLEIDA,14,3,17
2020/2021,25002659,ESCOLA SANT JOSEP DE CALASSANÇ,25120,251207,LLEIDA,19,2,21
2020/2021,25002131,ESCOLA CREU DEL BATLLE - ZER L'HORTA DE LLEIDA,25120,251207,LLEIDA,2,1,3
2020/2021,25002121,ESCOLA PRÍNCEP DE VIANA,25120,251207,LLEIDA,18,3,21
2020/2021,25002106,ESCOLA PARDINYES,25120,251207,LLEIDA,18,2,20
2020/2021,25002091,ESCOLA MAGÍ MORERA I GALÍCIA,25120,251207,LLEIDA,17,5,22
2020/2021,25002088,ESCOLA RIU SEGRE,25120,251207,LLEIDA,26,6,32
2020/2021,25002076,ESCOLA CERVANTES,25120,251207,LLEIDA,15,2,17
2020/2021,25002064,ESCOLA CAMPS ELISIS,25120,251207,LLEIDA,19,4,23
2020/2021,25002052,ESCOLA BALÀFIA,25120,251207,LLEIDA,16,4,20
2020/2021,25002003,ESCOLA SANTA MARIA DE GARDENY,25120,251207,LLEIDA,22,6,28
2020/2021,25001990,ESCOLA ANTONI BERGÓS - ZER L'HORTA DE LLEIDA,25120,251207,LLEIDA,2,1,3
2020/2021,25001953,ESCOLA ENRIC FARRENY,25120,251207,LLEIDA,10,6,16
2020/2021,25001928,ESCOLA MANUEL ORTIZ I CASTELLÓ,25119,251193,JUNEDA,24,3,27
2020/2021,25001916,ESCOLA L'ESPÍGOL - ZER GARRIGUES ALTES,25118,251180,JUNCOSA,3,0,3
2020/2021,25001886,ESCOLA AESO - ZER PALLARS JUSSÀ,25115,251155,ISONA I CONCA DELLÀ,6,1,7
2020/2021,25001801,ESCOLA MARE DE DÉU DE L'HORTA,25113,251137,IVARS D'URGELL,15,1,16
2020/2021,25001795,ESCOLA SANT SEBASTIÀ - ZER SERRA LLARGA,25112,251121,IVARS DE NOGUERA,3,1,4
2020/2021,25001761,ESCOLA RAMON FAUS I ESTEVE,25110,251109,GUISSONA,32,2,34
2020/2021,25001758,ESCOLA DE GUIMERÀ - ZER GUICIVERVI,25109,251095,GUIMERÀ,1,1,2
2020/2021,25001722,ESCOLA SANT JAUME - ZER L'OLIVER,25102,251023,LA GRANJA D'ESCARP,7,2,9
2020/2021,25001710,ESCOLA DE LA GRANADELLA - ZER ELAIA,25101,251018,LA GRANADELLA,5,0,5
2020/2021,25001709,ESCOLA SANTA MARGARIDA - ZER ALT BERGUEDÀ,25100,251001,GÓSOL,2,1,3
2020/2021,25001692,ESCOLA FRANCESC ARENES,25099,250997,GOLMÉS,14,1,15
2020/2021,25001618,ESCOLA GUILLEM ISARN,25096,250962,LA FULIOLA,12,3,15
2020/2021,25001606,ESCOLA MINYONS D'URGELL,25093,250931,FONDARELLA,12,1,13
2020/2021,25001539,ESCOLA LA CLOSA,25086,250864,ESTERRI D'ÀNEU,13,2,15
2020/2021,25001473,ESCOLA PORCEL DE CERVERA - ZER PEDRERA,25081,250812,L'ESPLUGA CALBA,4,0,4
2020/2021,25001436,ESCOLA SOL NAIXENT - ZER EL ROMANÍ,25079,250791,CUBELLS,2,1,3
2020/2021,25001424,ESCOLA SOL IXENT,25078,250788,CORBINS,14,1,15
2020/2021,25001400,ESCOLA SANT CLIMENT - ZER NARIEDA,25077,250772,COLL DE NARGÓ,4,1,5
2020/2021,25001357,ESCOLA DE CIUTADILLA - ZER GUICIVERVI,25074,250740,CIUTADILLA,2,0,2
2020/2021,25001333,ESCOLA EL CÉRVOL - ZER RIU SET,25073,250735,CERVIÀ DE LES GARRIGUES,5,0,5
2020/2021,25001321,ESCOLA MOSSÈN JOSEP ARQUES,25072,250729,CERVERA,24,5,29
2020/2021,25001311,INSTITUT ANTONI TORROJA,25072,250729,CERVERA,22,14,36
2020/2021,25001291,ESCOLA JAUME BALMES,25072,250729,CERVERA,24,3,27
2020/2021,25001281,ESCOLA EL TERRALL - ZER ESPERNALLAC,25070,250707,CASTELLSERÀ,9,0,9
2020/2021,25001278,ESCOLA SANTA MARIA - ZER SERRA LLARGA,25069,250693,CASTELLÓ DE FARFANYA,3,1,4
2020/2021,25001266,ESCOLA L'ESTEL - ZER VENT SERÈ,25068,250680,CASTELLNOU DE SEANA,5,1,6
2020/2021,25001254,ESCOLA TIMORELL - ZER VALL DE L'ARANYÓ,25067,250674,CASTELLDANS,6,1,7
2020/2021,25001242,ESCOLA CASTELL-CIUTAT - ZER URGELLET,25203,252038,LA SEU D'URGELL,4,0,4
2020/2021,25001229,ESCOLA DOS RIUS - ZER EL JONC,25062,250621,CAMARASA,5,1,6
2020/2021,25001199,ESCOLA SANT RÒC,25059,250595,BOSSÒST,10,1,11
2020/2021,25001141,ESCOLA JOAN XXIII,25058,250582,LES BORGES BLANQUES,25,3,28
2020/2021,25001138,ESCOLA CASTETH LEON - ZER VAL D'ARAN,25057,250576,ES BÒRDES,4,0,4
2020/2021,25001126,ESCOLA VALLMAJOR - ZER ELAIA,25056,250560,BOVERA,2,1,3
2020/2021,25001096,ESCOLA SANT JOAN,25053,250539,BENAVENT DE SEGRIÀ,14,1,15
2020/2021,25001084,ESCOLA JOAQUIM PALACÍN,25052,250523,BELLVÍS,14,2,16
2020/2021,25001059,ESCOLA MARE DE DÉU DE TALLÓ,25051,250518,BELLVER DE CERDANYA,14,2,16
2020/2021,25001011,ESCOLA VALERI SERRA,25050,250501,BELLPUIG,19,2,21
2020/2021,25001001,ESCOLA SANT BARTOMEU - ZER ESPERNALLAC,25049,250498,BELLMUNT D'URGELL,1,1,2
2020/2021,25000985,ESCOLA RAMON FARRERONS,25048,250485,BELL-LLOC D'URGELL,16,1,17
2020/2021,25000961,ESCOLA BONAVISTA,25047,250479,BELLCAIRE D'URGELL,11,2,13
2020/2021,25000951,ESCOLA PERE TEIXINÉ - ZER RIU CORB,25046,250463,BELIANES,4,1,5
2020/2021,25000869,ESCOLA SANT ROC - ZER RIU ONDARA,25041,250411,BARBENS,6,1,7
2020/2021,25000857,ESCOLA LA NOGUERA,25040,250404,BALAGUER,12,4,16
2020/2021,25000833,INSTITUT CIUTAT DE BALAGUER,25040,250404,BALAGUER,31,24,55
2020/2021,25000781,ESCOLA ÀNGEL GUIMERÀ,25040,250404,BALAGUER,20,2,22
2020/2021,25000778,ESCOLA GASPAR DE PORTOLÀ,25040,250404,BALAGUER,25,6,31
2020/2021,25000730,ESCOLA FRANCESC FELIU,25038,250387,AITONA,22,4,26
2020/2021,25000717,ESCOLA DE TARTAREU - ZER MONTSEC,25037,250371,LES AVELLANES I SANTA LINYA,1,1,2
2020/2021,25000699,ESCOLA DE LES AVELLANES - ZER MONTSEC,25037,250371,LES AVELLANES I SANTA LINYA,2,1,3
2020/2021,25000675,ESCOLA MARE DE DÉU DE LA GUARDIOLA - ZER EL ROMANÍ,25035,250352,LA SENTIU DE SIÓ,3,0,3
2020/2021,25000638,ESCOLA ELS PLANELLS,25034,250349,ARTESA DE SEGRE,26,1,27
2020/2021,25000626,ESCOLA ELS TIL.LERS,25033,250334,ARTESA DE LLEIDA,12,4,16
2020/2021,25000602,ESCOLA ALBIRKA,25029,250292,ARBECA,12,2,14
2020/2021,25000584,ESCOLA SANTA CREU,25027,250273,ANGLESOLA,17,1,18
2020/2021,25000560,ESCOLA RUDA - ZER VAL D'ARAN,25025,250254,NAUT ARAN,8,0,8
2020/2021,25000559,ESCOLA SANT MARTÍ - ZER VAL D'ARAN,25025,250254,NAUT ARAN,2,0,2
2020/2021,25000535,ESCOLA LOSERON - ZER VAL D'ARAN,25025,250254,NAUT ARAN,6,0,6
2020/2021,25000511,ESCOLA INOCENCIO PARDOS - ZER PONENT,25912,259123,GIMENELLS I EL PLA DE LA FONT,3,0,3
2020/2021,25000481,ESCOLA SANT ISIDRE - ZER PONENT,25912,259123,GIMENELLS I EL PLA DE LA FONT,6,0,6
2020/2021,25000468,ESCOLA DOCTOR SERÉS,25023,250236,ALPICAT,29,3,32
2020/2021,25000341,ESCOLA ANTÒNIA SIMÓ ARNÓ,25019,250194,ALMACELLES,31,5,36
2020/2021,25000316,ESCOLA D'ALINS - ZER ALT PALLARS SOBIRÀ,25017,250175,ALINS,2,0,2
2020/2021,25000286,ESCOLA SANT BLAI - ZER SERRA LLARGA,25015,250156,ALGERRI,2,1,3
2020/2021,25000274,ESCOLA D'ALFÉS - ZER L'ERAL,25014,250143,ALFÉS,3,0,3
2020/2021,25000225,ESCOLA MARE DE DÉU DEL CARME,25012,250122,ALCOLETGE,21,7,28
2020/2021,25000195,ESCOLA COMTES DE TORREGROSSA,25011,250117,ALCARRÀS,30,7,37
2020/2021,25000183,ESCOLA LA DULA - ZER L'ERAL,25010,250100,ALCANÓ,3,0,3
2020/2021,25000171,ESCOLA ELS AUBIS - ZER RIU SET,25009,250096,L'ALBI,6,1,7
2020/2021,25000161,ESCOLA L'ÀLBER,25008,250083,ALBESA,13,2,15
2020/2021,25000158,ESCOLA SANT SALVADOR,25007,250077,ALBATÀRREC,15,1,16
2020/2021,25000146,ESCOLA MARE DE DÉU DE MONTSERRAT - ZER VALL DE L'ARANYÓ,25006,250061,L'ALBAGÉS,3,1,4
2020/2021,25000122,ESCOLA SANT ESTEVE - ZER URGELLET,25005,250058,ALÀS I CERC,3,0,3
2020/2021,25000110,ESCOLA ARRELS - ZER L'HORTA DE LLEIDA,25004,250045,ELS ALAMÚS,5,1,6
2020/2021,25000067,ESCOLA MACIÀ-COMPANYS,25003,250030,AGRAMUNT,24,5,29
2020/2021,25000031,ESCOLA ANDREU FARRAN - ZER MONTSEC,25002,250024,ÀGER,4,1,5
2020/2021,17010840,INSTITUT NOU PALAFRUGELL,17117,171175,PALAFRUGELL,7,2,9
2020/2021,17010839,INSTITUT DE PERALADA,17132,171328,PERALADA,4,3,7
2020/2021,17010827,INSTITUT ESCOLA GREDA,17114,171143,OLOT,19,5,24
2020/2021,17010815,INSTITUT ESCOLA VILA-ROMÀ,17118,171181,PALAMÓS,28,6,34
2020/2021,17010803,INSTITUT ESCOLA RIBES DE FRESER,17145,171450,RIBES DE FRESER,22,5,27
2020/2021,17010797,INSTITUT ESCOLA CARITAT SERINYANA - CAP DE CREUS,17032,170329,CADAQUÉS,26,6,32
2020/2021,17010700,INSTITUT SANT QUIRZE,17095,170950,LLORET DE MAR,7,6,13
2020/2021,17010694,INSTITUT ESCOLA EL BRUEL-EMPURIABRAVA,17047,170470,CASTELLÓ D'EMPÚRIES,33,9,42
2020/2021,17010682,INSTITUT DE SARRIÀ DE TER,17186,171864,SARRIÀ DE TER,13,11,24
2020/2021,17010451,CFA TRAMUNTANA,17066,170669,FIGUERES,13,5,18
2020/2021,17010441,CFA NOU GIRONA,17079,170792,GIRONA,7,4,11
2020/2021,17010414,INSTITUT ERMESSENDA DE GIRONA,17079,170792,GIRONA,39,10,49
2020/2021,17010189,INSTITUT VALL DE LLÉMENA,17163,171637,SANT GREGORI,13,9,22
2020/2021,17010049,ESCOLA BALANDRAU,17079,170792,GIRONA,15,2,17
2020/2021,17010037,INSTITUT EL BRUC,17146,171463,RIELLS I VIABREA,14,5,19
2020/2021,17009898,INSTITUT ESCOLA LLORET DE MAR,17095,170950,LLORET DE MAR,55,9,64
2020/2021,17009850,ESCOLA LES ARRELS,17155,171557,SALT,30,5,35
2020/2021,17009813,INSTITUT ESCOLA MESTRE ANDREU,17167,171674,SANT JOAN DE LES ABADESSES,34,6,40
2020/2021,17009801,INSTITUT ESCOLA SALVADOR VILARRASA,17019,170195,BESALÚ,33,9,42
2020/2021,17009795,INSTITUT ESCOLA FRANCESC CAMBÓ I BATLLE,17211,172116,VERGES,33,9,42
2020/2021,17009783,INSTITUT LA MIQUELA,17020,170209,BESCANÓ,25,10,35
2020/2021,17009710,ESCOLA EMPORDANET,17022,170221,LA BISBAL D'EMPORDÀ,16,0,16
2020/2021,17009631,ZER CAP DE CREUS,17140,171404,EL PORT DE LA SELVA,3,2,5
2020/2021,17009473,ZER EMPORDANET-GAVARRES,17130,171306,LA PERA,4,0,4
2020/2021,17009345,ESCOLA CAMINS,17015,170157,BANYOLES,20,2,22
2020/2021,17009308,INSTITUT DE SILS,17193,171931,SILS,24,9,33
2020/2021,17009278,ESCOLA FANALS D'ARO,17048,170486,CASTELL-PLATJA D'ARO,13,2,15
2020/2021,17009242,ESCOLA NOU DE QUART,17142,171426,QUART,14,2,16
2020/2021,17009205,INSTITUT DE VILABLAREIX,17215,172155,VILABLAREIX,38,19,57
2020/2021,17009199,ESCOLA ELS ESTANYS,17193,171931,SILS,12,3,15
2020/2021,17009138,ESCOLA PUIG DE LES CADIRETES,17089,170890,LLAGOSTERA,28,3,31
2020/2021,17009126,ESCOLA EL BOSC DE LA PABORDIA,17079,170792,GIRONA,25,3,28
2020/2021,17008997,ESCOLA FORALLAC,17902,179026,FORALLAC,11,4,15
2020/2021,17008951,INSTITUT MAÇANET DE LA SELVA,17103,171030,MAÇANET DE LA SELVA,21,11,32
2020/2021,17008894,ESCOLA ALZINES BALLADORES,17159,171595,SANT FELIU DE BUIXALLEU,13,0,13
2020/2021,17008882,ESCOLA LA BÒBILA,17139,171390,LES PRESES,17,0,17
2020/2021,17008821,EOI DE BANYOLES,17015,170157,BANYOLES,4,1,5
2020/2021,17008808,ESCOLA CARME GUASCH I DARNÉ,17066,170669,FIGUERES,24,5,29
2020/2021,17008781,ESCOLA LA BENAULA,17033,170335,CALDES DE MALAVELLA,16,1,17
2020/2021,17008651,INSTITUT DE CALDES DE MALAVELLA,17033,170335,CALDES DE MALAVELLA,25,9,34
2020/2021,17008641,ESCOLA DE CABANES,17030,170307,CABANES,10,2,12
2020/2021,17008547,ESCOLA LES ARRELS,17103,171030,MAÇANET DE LA SELVA,17,6,23
2020/2021,17008523,ESCOLA PI VERD,17117,171175,PALAFRUGELL,30,8,38
2020/2021,17008501,ESCOLA ALDRIC,17044,170448,CASSÀ DE LA SELVA,27,2,29
2020/2021,17008493,ESCOLA VALL-LLOBREGA,17209,172095,VALL-LLOBREGA,14,0,14
2020/2021,17008481,ESCOLA L'ESCULAPI,17062,170622,L'ESCALA,16,2,18
2020/2021,17008471,ESCOLA LES FALGUERES,17049,170499,CELRÀ,29,0,29
2020/2021,17008468,ESCOLA LA SÍNIA,17034,170340,CALONGE I SANT ANTONI,14,1,15
2020/2021,17008444,ESCOLA PARC DE LES AIGÜES,17066,170669,FIGUERES,28,3,31
2020/2021,17008419,ESCOLA LLUMS DEL NORD,17141,171411,PUIGCERDÀ,14,2,16
2020/2021,17008407,INSTITUT SALVADOR SUNYER I AIMERIC,17155,171557,SALT,28,10,38
2020/2021,17008390,INSTITUT DE VILAFANT,17221,172214,VILAFANT,35,10,45
2020/2021,17008389,CFA LA SELVA,17180,171805,SANTA COLOMA DE FARNERS,4,3,7
2020/2021,17008377,CFA RIPOLLÈS,17147,171479,RIPOLL,2,1,3
2020/2021,17008365,CFA PLA DE L'ESTANY,17015,170157,BANYOLES,6,2,8
2020/2021,17008298,ESCOLA EL GEGANT DEL REC,17155,171557,SALT,30,5,35
2020/2021,17008286,ESCOLA DOMENY,17079,170792,GIRONA,27,3,30
2020/2021,17008274,ESCOLA SA FORCANERA,17023,170237,BLANES,21,5,26
2020/2021,17008249,ESCOLA CASTELL DE FARNERS,17180,171805,SANTA COLOMA DE FARNERS,28,3,31
2020/2021,17008237,ESCOLA MONTSERRAT VAYREDA,17152,171523,ROSES,22,5,27
2020/2021,17008146,CFA PALAFRUGELL,17117,171175,PALAFRUGELL,4,3,7
2020/2021,17008134,EOI DE FIGUERES,17066,170669,FIGUERES,7,2,9
2020/2021,17008122,EOI DE BLANES,17023,170237,BLANES,8,1,9
2020/2021,17008110,EOI DE SANT FELIU DE GUÍXOLS,17160,171609,SANT FELIU DE GUÍXOLS,5,2,7
2020/2021,17008080,ESCOLA ÀNGELS ALEMANY I BORIS,17095,170950,LLORET DE MAR,41,6,47
2020/2021,17008018,ESCOLA ARDENYA,17160,171609,SANT FELIU DE GUÍXOLS,27,2,29
2020/2021,17008006,ESCOLA AMISTAT,17066,170669,FIGUERES,25,5,30
2020/2021,17007981,EOI D'OLOT,17114,171143,OLOT,9,1,10
2020/2021,17007919,ESCOLA MAS MASÓ,17155,171557,SALT,33,4,37
2020/2021,17007907,ESCOLA JOANA D'EMPÚRIES,17047,170470,CASTELLÓ D'EMPÚRIES,25,3,28
2020/2021,17007828,ESCOLA PINYA DE ROSA,17023,170237,BLANES,26,5,31
2020/2021,17007695,ZER EMPORDÀ,17228,172288,VILANANT,2,2,4
2020/2021,17007671,CFA LA GARROTXA,17114,171143,OLOT,8,4,12
2020/2021,17007658,CFA SANT FELIU DE GUÍXOLS,17160,171609,SANT FELIU DE GUÍXOLS,6,3,9
2020/2021,17007609,INSTITUT OLIVAR GRAN,17066,170669,FIGUERES,46,31,77
2020/2021,17007531,ZER MONTGRÍ,17018,170182,BELLCAIRE D'EMPORDÀ,2,1,3
2020/2021,17007518,ZER LES SALINES,17001,170010,AGULLANA,4,0,4
2020/2021,17007488,ZER REQUESENS,17042,170427,CAPMANY,2,2,4
2020/2021,17007464,ZER COMTE ARNAU,17170,171707,VALLFOGONA DE RIPOLLÈS,4,0,4
2020/2021,17007452,ZER EL LLIERCA,17200,172001,TORTELLÀ,3,1,4
2020/2021,17007440,ZER VALL DE TER,17177,171772,SANT PAU DE SEGÚRIES,3,2,5
2020/2021,17007439,ZER CERDANYA,17094,170947,LLÍVIA,4,1,5
2020/2021,17007427,ZER TRAMUNTANA,17210,172109,VENTALLÓ,4,0,4
2020/2021,17007300,INSTITUT LA BISBAL,17022,170221,LA BISBAL D'EMPORDÀ,60,35,95
2020/2021,17007181,CFA GIRONA,17079,170792,GIRONA,14,5,19
2020/2021,17007178,CFA MARIA VERDAGUER,17066,170669,FIGUERES,8,3,11
2020/2021,17007129,CFA ES PITEUS,17023,170237,BLANES,8,5,13
2020/2021,17007014,CFA LLORET DE MAR,17095,170950,LLORET DE MAR,6,1,7
2020/2021,17006952,ESCOLA LA DRAGA,17015,170157,BANYOLES,26,2,28
2020/2021,17006940,ESCOLA DE LLIURONA,17003,170031,ALBANYÀ,1,2,3
2020/2021,17006939,INSTITUT SANTA EUGÈNIA,17079,170792,GIRONA,63,49,112
2020/2021,17006873,ESCOLA CASTELLUM,17169,171693,SANT JULIÀ DE RAMIS,21,1,22
2020/2021,17006851,INSTITUT ILLA DE RODES,17152,171523,ROSES,43,22,65
2020/2021,17006836,ESCOLA LES MÈLIES,17221,172214,VILAFANT,27,2,29
2020/2021,17006824,INSTITUT VIDRERES,17213,172137,VIDRERES,38,26,64
2020/2021,17006812,INSTITUT DE TOSSA DE MAR,17202,172023,TOSSA DE MAR,18,12,30
2020/2021,17006800,ESCOLA ELS GRECS,17152,171523,ROSES,22,3,25
2020/2021,17006782,ESCOLA CARRILET,17117,171175,PALAFRUGELL,31,5,36
2020/2021,17006770,INSTITUT ROCAGROSSA,17095,170950,LLORET DE MAR,38,32,70
2020/2021,17006769,INSTITUT DE LLANÇÀ,17092,170926,LLANÇÀ,25,20,45
2020/2021,17006757,INSTITUT DE LLAGOSTERA,17089,170890,LLAGOSTERA,29,18,47
2020/2021,17006745,INSTITUT DE LA JONQUERA,17086,170865,LA JONQUERA,24,10,34
2020/2021,17006733,INSTITUT VESCOMTAT DE CABRERA,17083,170834,HOSTALRIC,53,18,71
2020/2021,17006721,ESCOLA MARTA MATA,17079,170792,GIRONA,26,3,29
2020/2021,17006711,ESCOLA M. ÀNGELS ANGLADA,17066,170669,FIGUERES,15,3,18
2020/2021,17006708,INSTITUT DE CELRÀ,17049,170499,CELRÀ,46,17,63
2020/2021,17006691,INSTITUT RIDAURA,17048,170486,CASTELL-PLATJA D'ARO,47,13,60
2020/2021,17006681,INSTITUT GERMANS VILA-RIERA,17039,170391,CAMPRODON,13,6,19
2020/2021,17006666,INSTITUT PLA DE L'ESTANY,17015,170157,BANYOLES,48,23,71
2020/2021,17006605,INSTITUT MONTSORIU,17009,170097,ARBÚCIES,34,18,52
2020/2021,17006083,INSTITUT CASTELLÓ D'EMPÚRIES,17047,170470,CASTELLÓ D'EMPÚRIES,39,24,63
2020/2021,17005923,INSTITUT MONTGRÍ,17199,171997,TORROELLA DE MONTGRÍ,39,24,63
2020/2021,17005911,INSTITUT RAMON COLL I RODÉS,17095,170950,LLORET DE MAR,55,29,84
2020/2021,17005893,INSTITUT BOSC DE LA COMA,17114,171143,OLOT,58,32,90
2020/2021,17005741,INSTITUT PERE BORRELL,17141,171411,PUIGCERDÀ,54,23,77
2020/2021,17005731,INSTITUT S'AGULLA,17023,170237,BLANES,49,22,71
2020/2021,17005704,INSTITUT ABAT OLIBA,17147,171479,RIPOLL,47,31,78
2020/2021,17005662,INSTITUT SERRALLARGA,17023,170237,BLANES,62,39,101
2020/2021,17005650,INSTITUT DE CASSÀ DE LA SELVA,17044,170448,CASSÀ DE LA SELVA,43,15,58
2020/2021,17005649,INSTITUT CENDRASSOS,17066,170669,FIGUERES,59,34,93
2020/2021,17005522,ESCOLA VEÏNAT,17155,171557,SALT,19,1,20
2020/2021,17005388,INSTITUT VALLVERA,17155,171557,SALT,77,24,101
2020/2021,17005376,INSTITUT DE SANTA COLOMA DE FARNERS,17180,171805,SANTA COLOMA DE FARNERS,63,34,97
2020/2021,17005364,INSTITUT CAP NORFEU,17152,171523,ROSES,43,21,64
2020/2021,17005352,INSTITUT DE PALAMÓS,17118,171181,PALAMÓS,45,35,80
2020/2021,17005340,EA D'OLOT,17114,171143,OLOT,26,14,40
2020/2021,17005339,CFA LES BERNARDES,17155,171557,SALT,9,9,18
2020/2021,17005261,ESCOLA MONTPALAU - ZER EL LLIERCA,17010,170101,ARGELAGUER,4,1,5
2020/2021,17005251,INSTITUT EL PEDRÓ,17062,170622,L'ESCALA,31,24,55
2020/2021,17005248,ESCOLA MAS CLARÀ,17022,170221,LA BISBAL D'EMPORDÀ,22,6,28
2020/2021,17005182,ESCOLA CAN PUIG,17015,170157,BANYOLES,26,3,29
2020/2021,17005042,INSTITUT CARLES RAHOLA I LLORENS,17079,170792,GIRONA,41,17,58
2020/2021,17005029,ESCOLA L'ESQUIROL - ZER VALL DE TER,17112,171122,OGASSA,3,0,3
2020/2021,17005017,ESCOLA QUATRE VENTS,17023,170237,BLANES,22,8,30
2020/2021,17004955,ESCOLA POMPEU FABRA,17095,170950,LLORET DE MAR,32,9,41
2020/2021,17004943,ESCOLA MONTFALGARS,17079,170792,GIRONA,24,5,29
2020/2021,17004906,ESCOLA SALVADOR ESPRIU,17213,172137,VIDRERES,24,2,26
2020/2021,17004891,ESCOLA JOSEP PALLACH,17066,170669,FIGUERES,27,4,31
2020/2021,17004888,ESCOLA SANTA CECÍLIA - ZER CERDANYA,17024,170242,BOLVIR,6,0,6
2020/2021,17004876,ESCOLA L'OLIVAR VELL,17013,170139,BEGUR,9,2,11
2020/2021,17004864,ESCOLA EL PLA,17155,171557,SALT,26,10,36
2020/2021,17004852,EOI DE GIRONA,17079,170792,GIRONA,32,8,40
2020/2021,17004827,ESCOLA ALZINA RECLAMADORA,17071,170715,FONTCOBERTA,13,2,15
2020/2021,17004761,CEE DOCTOR RAMON SURI¦ACH,17147,171479,RIPOLL,7,0,7
2020/2021,17004751,ESCOLA TOMÀS RAGUER,17147,171479,RIPOLL,16,1,17
2020/2021,17004748,CEE MARE DE DÉU DEL MONT,17221,172214,VILAFANT,25,2,27
2020/2021,17004736,CEE ELS ÀNGELS,17118,171181,PALAMÓS,22,1,23
2020/2021,17004724,CEE PALAU,17079,170792,GIRONA,16,1,17
2020/2021,17004712,CEE VENTIJOL,17023,170237,BLANES,24,2,26
2020/2021,17004694,ESCOLA CASSIÀ COSTAL,17079,170792,GIRONA,26,3,29
2020/2021,17004682,ESCOLA L'ESTACIÓ,17160,171609,SANT FELIU DE GUÍXOLS,26,4,30
2020/2021,17004657,ESCOLA ESTEVE CARLES,17095,170950,LLORET DE MAR,19,3,22
2020/2021,17004578,INSTITUT CASTELL D'ESTELA,17007,170078,AMER,19,12,31
2020/2021,17004566,ESCOLA NAPOLEÓ SOLIVA,17023,170237,BLANES,20,3,23
2020/2021,17004530,INSTITUT SANTIAGO SOBREQUÉS I VIDAL,17079,170792,GIRONA,42,21,63
2020/2021,17004529,ESCOLA MIGDIA,17079,170792,GIRONA,24,4,28
2020/2021,17004517,INSTITUT ANTON BUSQUETS I PUNSET,17164,171642,SANT HILARI SACALM,22,8,30
2020/2021,17004499,INSTITUT NARCÍS XIFRA I MASMITJÀ,17079,170792,GIRONA,103,45,148
2020/2021,17004487,INSTITUT RAFAEL CAMPALANS,17008,170084,ANGLÈS,32,22,54
2020/2021,17004463,ESCOLA ANICET DE PAGÈS I DE PUIG,17066,170669,FIGUERES,25,5,30
2020/2021,17004451,ESCOLA JAUME VICENS I VIVES,17152,171523,ROSES,23,4,27
2020/2021,17004438,INSTITUT ALEXANDRE DEULOFEU,17066,170669,FIGUERES,54,22,76
2020/2021,17004360,CEE LA MAÇANA,17155,171557,SALT,10,0,10
2020/2021,17004347,ESCOLA FONT DE LA PÓLVORA,17079,170792,GIRONA,10,2,12
2020/2021,17004335,ESCOLA SANTA EUGÈNIA,17079,170792,GIRONA,17,0,17
2020/2021,17004293,ESCOLA MANUEL DE PEDROLO - ZER LES SALINES,17234,172348,BIURE,3,1,4
2020/2021,17004281,ESCOLA JOSEP MADRENYS,17233,172333,VILOBÍ D'ONYAR,23,1,24
2020/2021,17004244,ESCOLA TRAMUNTANA - ZER EMPORDÀ,17228,172288,VILANANT,3,0,3
2020/2021,17004232,ESCOLA JOSEP DE RIBOT I OLIVAS,17226,172266,VILAMALLA,15,1,16
2020/2021,17004220,ESCOLA ELS VALENTINS - ZER TRAMUNTANA,17225,172253,VILAMACOLUM,3,2,5
2020/2021,17004219,ESCOLA LA DAINA - ZER VALL DE TER,17224,172240,VILALLONGA DE TER,3,0,3
2020/2021,17004207,ESCOLA SANTIAGO RATÉS,17223,172235,VILAJUÏGA,10,2,12
2020/2021,17004190,ESCOLA SOL I VENT,17221,172214,VILAFANT,14,1,15
2020/2021,17004189,ESCOLA ELS CASTANYERS - ZER GUILLERIES,17220,172207,VILADRAU,8,0,8
2020/2021,17004153,ESCOLA DE SANT ESTEVE DE GUIALBES,17218,172180,VILADEMULS,11,2,13
2020/2021,17004128,ESCOLA PUIG SEGALAR - ZER TRAMUNTANA,17217,172174,VILADAMAT,4,0,4
2020/2021,17004116,ESCOLA MADRENC,17215,172155,VILABLAREIX,23,2,25
2020/2021,17004098,ESCOLA TORRE D'EN REIG,17214,172142,VILABERTRAN,14,2,16
2020/2021,17004074,ESCOLA SANT ISCLE,17213,172137,VIDRERES,19,3,22
2020/2021,17004062,ESCOLA SANTA BÀRBARA - ZER ELS CASTELLS,17212,172121,VIDRÀ,2,0,2
2020/2021,17004049,ESCOLA OLIVERES MIL·LENÀRIES - ZER TRAMUNTANA,17210,172109,VENTALLÓ,8,0,8
2020/2021,17004001,ESCOLA VERNTALLAT,17207,172076,LA VALL D'EN BAS,19,3,22
2020/2021,17003951,PARVULARI DE SANT ESTEVE D'EN BAS,17207,172076,LA VALL D'EN BAS,4,0,4
2020/2021,17003941,ESCOLA L'ESTANY - ZER EMPORDANET-GAVARRES,17205,172057,ULLASTRET,3,1,4
2020/2021,17003938,ESCOLA PUIG RODÓ - ZER MONTGRÍ,17204,172044,ULLÀ,6,0,6
2020/2021,17003926,ESCOLA IGNASI MELÉ I FARRÉ,17202,172023,TOSSA DE MAR,27,5,32
2020/2021,17003902,ESCOLA JOAN ROURA I PARELLA - ZER EL LLIERCA,17200,172001,TORTELLÀ,5,2,7
2020/2021,17003872,ESCOLA GUILLEM DE MONTGRÍ,17199,171997,TORROELLA DE MONTGRÍ,36,6,42
2020/2021,17003860,ESCOLA PORTITXOL,17199,171997,TORROELLA DE MONTGRÍ,19,4,23
2020/2021,17003823,ESCOLA VERDAGUER,17193,171931,SILS,22,5,27
2020/2021,17003801,ESCOLA BORA GRAN,17190,171903,SERINYÀ,13,3,16
2020/2021,17003781,ESCOLA JUNCADELLA,17189,171899,LA CELLERA DE TER,12,4,16
2020/2021,17003768,ESCOLA ELS TERRAPRIMS,17187,171870,"SAUS, CAMALLERA I LLAMPAIES",14,1,15
2020/2021,17003756,ESCOLA MONTSERRAT,17186,171864,SARRIÀ DE TER,27,3,30
2020/2021,17003732,ESCOLA CASTANYER,17185,171851,SANT JOAN LES FONTS,19,1,20
2020/2021,17003719,ESCOLA JOAN MARAGALL,17184,171848,SANTA PAU,10,4,14
2020/2021,17003689,ESCOLA PEDRALTA,17181,171812,SANTA CRISTINA D'ARO,25,4,29
2020/2021,17003641,ESCOLA SANT SALVADOR D'HORTA,17180,171805,SANTA COLOMA DE FARNERS,32,2,34
2020/2021,17003631,ESCOLA LA PEDRA DRETA - ZER EMPORDANET-GAVARRES,17901,179011,"CRUÏLLES, MONELLS I SANT SADURNÍ L'HEURA",4,1,5
2020/2021,17003628,ESCOLA LLAGUT,17178,171788,SANT PERE PESCADOR,14,7,21
2020/2021,17003616,ESCOLA ELS PINETS - ZER VALL DE TER,17177,171772,SANT PAU DE SEGÚRIES,7,0,7
2020/2021,17003598,ESCOLA VALLGARRIGA,17175,171753,SANT MIQUEL DE FLUVIÀ,6,3,9
2020/2021,17003537,ESCOLA DE VALLFOGONA DE RIPOLLÈS - ZER COMTE ARNAU,17170,171707,VALLFOGONA DE RIPOLLÈS,1,0,1
2020/2021,17003471,ESCOLA SANT JORDI,17166,171668,SANT JORDI DESVALLS,9,1,10
2020/2021,17003461,ESCOLA LES ESCOMES,17165,171655,SANT JAUME DE LLIERCA,12,3,15
2020/2021,17003434,ESCOLA GUILLERIES,17164,171642,SANT HILARI SACALM,25,3,28
2020/2021,17003392,ESCOLA AGUSTÍ GIFRE,17163,171637,SANT GREGORI,28,7,35
2020/2021,17003343,ESCOLA ROCALBA,17161,171616,SANT FELIU DE PALLEROLS,13,2,15
2020/2021,17003321,ESCOLA MOSSÈN BALDIRI REIXACH,17160,171609,SANT FELIU DE GUÍXOLS,24,4,28
2020/2021,17003318,INSTITUT DE SANT FELIU DE GUÍXOLS,17160,171609,SANT FELIU DE GUÍXOLS,62,28,90
2020/2021,17003306,INSTITUT SANT ELM,17160,171609,SANT FELIU DE GUÍXOLS,32,13,45
2020/2021,17003264,ESCOLA GAZIEL,17160,171609,SANT FELIU DE GUÍXOLS,20,8,28
2020/2021,17003227,ESCOLA SANT SEBASTIÀ - ZER REQUESENS,17158,171582,SANT CLIMENT SESCEBES,5,0,5
2020/2021,17003215,ESCOLA LA FARGA,17155,171557,SALT,31,6,37
2020/2021,17003203,INSTITUT SALVADOR ESPRIU,17155,171557,SALT,54,23,77
2020/2021,17003151,ESCOLA SILVESTRE SANTALÓ,17155,171557,SALT,16,5,21
2020/2021,17003136,ESCOLA NARCÍS MONTURIOL,17152,171523,ROSES,14,3,17
2020/2021,17003094,ESCOLA DE RIUDELLOTS DE LA SELVA,17150,171501,RIUDELLOTS DE LA SELVA,14,2,16
2020/2021,17003082,ESCOLA LLUÍS CASTELLS,17149,171498,RIUDAURA,10,2,12
2020/2021,17003070,ESCOLA JOSEP BOADA,17148,171485,RIUDARENES,16,0,16
2020/2021,17002995,ESCOLA JOAN MARAGALL,17147,171479,RIPOLL,18,2,20
2020/2021,17002983,ESCOLA EL BRUC,17146,171463,RIELLS I VIABREA,14,2,16
2020/2021,17002922,ESCOLA SANTA MARGARIDA,17142,171426,QUART,16,2,18
2020/2021,17002880,ESCOLA ALFONS I,17141,171411,PUIGCERDÀ,22,8,30
2020/2021,17002879,ESCOLA LES CLISQUES - ZER CAP DE CREUS,17140,171404,EL PORT DE LA SELVA,5,0,5
2020/2021,17002831,ESCOLA SANT JAUME,17138,171387,PORTBOU,6,0,6
2020/2021,17002818,ESCOLA FRIGOLET,17137,171371,PORQUERES,10,0,10
2020/2021,17002791,ESCOLA L'ENTORN,17137,171371,PORQUERES,27,3,30
2020/2021,17002776,ESCOLA TRAMUNTANA - ZER EMPORDÀ,17135,171352,PONT DE MOLINS,5,0,5
2020/2021,17002764,ESCOLA NÚRIA MORER I PI - ZER COMTE ARNAU,17134,171349,PLANOLES,3,0,3
2020/2021,17002752,ESCOLA SANT CRISTÒFOL,17133,171334,LES PLANES D'HOSTOLES,15,2,17
2020/2021,17002740,ESCOLA RAMON MUNTANER,17132,171328,PERALADA,14,1,15
2020/2021,17002715,ESCOLA PEDRA BLANCA - ZER EMPORDANET-GAVARRES,17130,171306,LA PERA,5,1,6
2020/2021,17002703,ESCOLA PAU,17128,171289,PAU,4,3,7
2020/2021,17002651,ESCOLA QUERMANY,17124,171241,PALS,13,2,15
2020/2021,17002624,ESCOLA MARTÍ INGLÈS,17120,171208,PALAU-SAVERDERA,15,1,16
2020/2021,17002569,ESCOLA LA VILA,17118,171181,PALAMÓS,27,4,31
2020/2021,17002557,INSTITUT BAIX EMPORDÀ,17117,171175,PALAFRUGELL,53,49,102
2020/2021,17002545,INSTITUT FREDERIC MARTÍ I CARRERAS,17117,171175,PALAFRUGELL,44,30,74
2020/2021,17002491,ESCOLA JOSEP BARCELÓ I MATAS,17117,171175,PALAFRUGELL,25,9,34
2020/2021,17002481,ESCOLA TORRES JONAMA,17117,171175,PALAFRUGELL,31,3,34
2020/2021,17002442,ESCOLA LA VALL,17116,171169,OSOR,4,2,6
2020/2021,17002430,ESCOLA MARIA PAGÈS I TRAYTER,17115,171156,ORDIS,4,3,7
2020/2021,17002429,ESCOLA SANT ROC,17114,171143,OLOT,27,3,30
2020/2021,17002399,INSTITUT LA GARROTXA,17114,171143,OLOT,69,41,110
2020/2021,17002387,INSTITUT MONTSACOPA,17114,171143,OLOT,54,18,72
2020/2021,17002326,ESCOLA VOLCÀ BISAROQUES,17114,171143,OLOT,28,2,30
2020/2021,17002314,ESCOLA PLA DE DALT,17114,171143,OLOT,26,4,30
2020/2021,17002296,ESCOLA MALAGRIDA,17114,171143,OLOT,28,4,32
2020/2021,17002260,ESCOLA JOAQUIM VALLMAJÓ,17111,171117,NAVATA,13,2,15
2020/2021,17002259,ESCOLA TORRES JONAMA,17110,171100,MONT-RAS,11,4,15
2020/2021,17002247,ESCOLA MONT CÓS - ZER EL LLIERCA,17109,171096,MONTAGUT I OIX,6,0,6
2020/2021,17002201,ESCOLA FINESTRES,17105,171058,MIERES,6,0,6
2020/2021,17002193,ESCOLA SANTA FE,17169,171693,SANT JULIÀ DE RAMIS,9,2,11
2020/2021,17002181,ESCOLA SANT JORDI,17103,171030,MAÇANET DE LA SELVA,19,9,28
2020/2021,17002168,ESCOLA LES SALINES - ZER LES SALINES,17102,171024,MAÇANET DE CABRENYS,5,0,5
2020/2021,17002107,ESCOLA PERE TORRENT,17095,170950,LLORET DE MAR,33,5,38
2020/2021,17002090,ESCOLA JAUME I - ZER CERDANYA,17094,170947,LLÍVIA,9,1,10
2020/2021,17002089,ESCOLA DE LLERS,17093,170932,LLERS,13,2,15
2020/2021,17002077,ESCOLA POMPEU FABRA,17092,170926,LLANÇÀ,23,5,28
2020/2021,17002065,ESCOLA LES MORERES - ZER VALL DE TER,17091,170911,LLANARS,4,0,4
2020/2021,17002031,ESCOLA LACUSTÀRIA,17089,170890,LLAGOSTERA,30,4,34
2020/2021,17002028,ESCOLA MONTSERRAT VAYREDA I TRULLOL,17088,170887,LLADÓ,12,0,12
2020/2021,17002004,ESCOLA JOSEP PE¦UELAS DEL RIO,17086,170865,LA JONQUERA,24,6,30
2020/2021,17001981,ESCOLA MARE DE DÉU DELS SOCORS,17083,170834,HOSTALRIC,29,3,32
2020/2021,17001954,ESCOLA DE VILA-ROJA,17079,170792,GIRONA,12,1,13
2020/2021,17001930,ESCOLA JOSEP DALMAU I CARLES,17079,170792,GIRONA,23,7,30
2020/2021,17001887,ESCOLA CARME AUGUET,17079,170792,GIRONA,13,2,15
2020/2021,17001838,ESCOLA ÀGORA,17079,170792,GIRONA,16,1,17
2020/2021,17001759,INSTITUT ESCOLA D'HOSTALERIA I TURISME DE GIRONA,17079,170792,GIRONA,22,21,43
2020/2021,17001735,INSTITUT MONTILIVI,17079,170792,GIRONA,82,62,144
2020/2021,17001723,INSTITUT JAUME VICENS VIVES,17079,170792,GIRONA,51,23,74
2020/2021,17001693,CEE FONT DE L'ABELLA,17079,170792,GIRONA,34,8,42
2020/2021,17001516,ESCOLA PLA DE GIRONA,17079,170792,GIRONA,25,4,29
2020/2021,17001486,ESCOLA MONTJUÏC,17079,170792,GIRONA,14,3,17
2020/2021,17001462,ESCOLA VERD,17079,170792,GIRONA,14,2,16
2020/2021,17001450,ESCOLA JOAN BRUGUERA,17079,170792,GIRONA,12,4,16
2020/2021,17001449,ESCOLA ANNEXA - JOAN PUIGBERT,17079,170792,GIRONA,24,5,29
2020/2021,17001425,ESCOLA EIXIMENIS,17079,170792,GIRONA,15,1,16
2020/2021,17001395,ESCOLA SANTA COLOMA - ZER CERDANYA,17078,170789,GER,8,1,9
2020/2021,17001383,ESCOLA JOAQUIM GIFRE,17077,170773,GARRIGUELLA,11,2,13
2020/2021,17001371,ESCOLA DE GARRIGÀS - ZER EMPORDÀ,17075,170754,GARRIGÀS,5,0,5
2020/2021,17001361,ESCOLA TERESA DE PALLEJÀ,17074,170741,FORTIÀ,12,0,12
2020/2021,17001346,ESCOLA FORN D'ANELLS,17073,170736,FORNELLS DE LA SELVA,19,3,22
2020/2021,17001292,ESCOLA LES MORERES,17067,170675,FLAÇÀ,12,3,15
2020/2021,17001280,ESCOLA JOAQUIM CUSÍ I FURTUNET,17066,170669,FIGUERES,26,6,32
2020/2021,17001279,ESCOLA SANT PAU,17066,170669,FIGUERES,25,6,31
2020/2021,17001221,INSTITUT NARCÍS MONTURIOL,17066,170669,FIGUERES,53,36,89
2020/2021,17001218,INSTITUT RAMON MUNTANER,17066,170669,FIGUERES,44,23,67
2020/2021,17001115,ESCOLA JOSEP POUS I PAGÈS,17066,170669,FIGUERES,16,4,20
2020/2021,17001103,ESCOLA SALVADOR DALÍ,17066,170669,FIGUERES,29,3,32
2020/2021,17001097,ESCOLA CARLES DE FORTUNY,17065,170656,ESPONELLÀ,7,0,7
2020/2021,17001085,ESCOLA ANTONI BALMANYA - ZER REQUESENS,17064,170643,ESPOLLA,3,0,3
2020/2021,17001048,ESCOLA EMPÚRIES,17062,170622,L'ESCALA,33,5,38
2020/2021,17001036,ESCOLA MONT-ROIG - ZER REQUESENS,17060,170600,DARNIUS,3,1,4
2020/2021,17001024,ESCOLA LES GAVARRES - ZER EMPORDANET-GAVARRES,17901,179011,"CRUÏLLES, MONELLS I SANT SADURNÍ L'HEURA",6,0,6
2020/2021,17000998,ESCOLA EL RODONELL,17057,170577,CORÇÀ,13,3,16
2020/2021,17000986,ESCOLA LA VALL DEL TERRI,17056,170561,CORNELLÀ DEL TERRI,22,2,24
2020/2021,17000950,ESCOLA PUIG D'ESQUERS - ZER CAP DE CREUS,17054,170545,COLERA,3,1,4
2020/2021,17000937,ESCOLA MOSSÈN JOSEP MARIA ALBERT - ZER EMPORDÀ,17051,170519,CISTELLA,2,0,2
2020/2021,17000925,ESCOLA L'AIXART,17050,170502,CERVIÀ DE TER,12,1,13
2020/2021,17000913,ESCOLA L'AULET,17049,170499,CELRÀ,23,1,24
2020/2021,17000895,ESCOLA ELS ESTANYS,17048,170486,CASTELL-PLATJA D'ARO,23,6,29
2020/2021,17000883,ESCOLA VALL D'ARO,17048,170486,CASTELL-PLATJA D'ARO,14,3,17
2020/2021,17000871,ESCOLA RUIZ AMADO,17047,170470,CASTELLÓ D'EMPÚRIES,28,3,31
2020/2021,17000861,ESCOLA CASTELLROC,17046,170464,CASTELLFOLLIT DE LA ROCA,11,1,12
2020/2021,17000846,ESCOLA PUIG D'ARQUES,17044,170448,CASSÀ DE LA SELVA,26,4,30
2020/2021,17000822,ESCOLA ELS DÒLMENS - ZER REQUESENS,17042,170427,CAPMANY,2,1,3
2020/2021,17000779,ESCOLA DOCTOR ROBERT,17039,170391,CAMPRODON,16,4,20
2020/2021,17000731,ESCOLA PIRINEU,17036,170366,CAMPDEVÀNOL,19,0,19
2020/2021,17000718,ESCOLA LLEVANTÍ DE MAR,17034,170340,CALONGE I SANT ANTONI,15,1,16
2020/2021,17000706,INSTITUT PUIG CARGOL,17034,170340,CALONGE I SANT ANTONI,31,19,50
2020/2021,17000688,ESCOLA PERE ROSSELLÓ,17034,170340,CALONGE I SANT ANTONI,27,1,28
2020/2021,17000676,ESCOLA SANT ESTEVE,17033,170335,CALDES DE MALAVELLA,27,2,29
2020/2021,17000603,ESCOLA SANTA CECÍLIA - ZER LES SALINES,17029,170293,BOADELLA I LES ESCAULES,3,0,3
2020/2021,17000585,ESCOLA MONTSENY,17027,170274,BREDA,23,6,29
2020/2021,17000573,ESCOLA SANT ANDREU DE BORRASSÀ,17026,170268,BORRASSÀ,9,0,9
2020/2021,17000561,ESCOLA DE BORDILS,17025,170255,BORDILS,13,4,17
2020/2021,17000551,INSTITUT SA PALOMERA,17023,170237,BLANES,50,30,80
2020/2021,17000548,ESCOLA MOSSÈN JOAN BATLLE,17023,170237,BLANES,19,7,26
2020/2021,17000470,ESCOLA CARLES FAUST,17023,170237,BLANES,9,6,15
2020/2021,17000469,ESCOLA JOAQUIM RUYRA,17023,170237,BLANES,16,1,17
2020/2021,17000411,ESCOLA JOAN DE MARGARIT,17022,170221,LA BISBAL D'EMPORDÀ,24,4,28
2020/2021,17000408,ESCOLA DOCTOR SOBREQUÉS,17020,170209,BESCANÓ,29,4,33
2020/2021,17000381,ESCOLA EL RAJARET - ZER MONTGRÍ,17018,170182,BELLCAIRE D'EMPORDÀ,7,0,7
2020/2021,17000354,ESCOLA JOAN REGLÀ,17016,170160,BÀSCARA,12,2,14
2020/2021,17000342,ESCOLA DE LA VILA BALDIRI REIXAC,17015,170157,BANYOLES,27,4,31
2020/2021,17000330,INSTITUT JOSEP BRUGULAT,17015,170157,BANYOLES,53,35,88
2020/2021,17000329,ESCOLA PLA DE L'AMETLLER,17015,170157,BANYOLES,29,2,31
2020/2021,17000305,INSTITUT PERE ALSIUS I TORRENT,17015,170157,BANYOLES,39,24,63
2020/2021,17000263,ESCOLA DOCTOR ARRUGA,17013,170139,BEGUR,13,3,16
2020/2021,17000251,ESCOLA GONÇAL COMELLAS,17012,170123,AVINYONET DE PUIGVENTÓS,14,1,15
2020/2021,17000241,ESCOLA FLUVIANETS,17011,170118,L'ARMENTERA,11,2,13
2020/2021,17000160,ESCOLA DOCTOR CARULLA,17009,170097,ARBÚCIES,30,4,34
2020/2021,17000135,ESCOLA POMPEU FABRA,17008,170084,ANGLÈS,24,5,29
2020/2021,17000123,ESCOLA SANT JORDI,17903,179032,SANT JULIÀ DEL LLOR I BONMATÍ,16,0,16
2020/2021,17000093,ESCOLA GASPAR DE QUERALT,17007,170078,AMER,14,2,16
2020/2021,17000071,ESCOLA BAC DE CERDANYA,17006,170062,ALP,14,1,15
2020/2021,17000068,ESCOLA DEL FAR D'EMPORDÀ,17005,170059,EL FAR D'EMPORDÀ,13,0,13
2020/2021,17000056,ESCOLA LA BRANCA - ZER MONTGRÍ,17004,170046,ALBONS,7,0,7
2020/2021,17000032,ESCOLA VILADEMANY,17002,170025,AIGUAVIVA,10,2,12
2020/2021,17000019,ESCOLA LLUÍS MARIÀ VIDAL - ZER LES SALINES,17001,170010,AGULLANA,7,1,8
2020/2021,08077228,INSTITUT PROFESSIONAL DE TURISME EQÜESTRE DEL MARESME,08261,082613,SANTA SUSANNA,2,2,4
2020/2021,08077137,INSTITUT D'ENSENYAMENTS ESPORTIUS DE BARCELONA,08019,080193,BARCELONA,16,18,34
2020/2021,08077125,INSTITUT ESCOLA ANTONI UBACH I SOLER,08279,082798,TERRASSA,31,8,39
2020/2021,08077113,ESCOLA VOLTREGÀ,08215,082153,SANT HIPÒLIT DE VOLTREGÀ,24,1,25
2020/2021,08077101,INSTITUT ESCOLA PLAÇA COMAS,08019,080193,BARCELONA,33,3,36
2020/2021,08077083,INSTITUT VAPOR DEL FIL,08019,080193,BARCELONA,5,3,8
2020/2021,08077071,INSTITUT ESCOLA MAS RAMPINYO,08125,081252,MONTCADA I REIXAC,28,5,33
2020/2021,08077061,INSTITUT ESCOLA ONZE DE SETEMBRE,08238,082384,SANT QUIRZE DEL VALLÈS,21,6,27
2020/2021,08077058,INSTITUT ESCOLA CATALUNYA,08205,082055,SANT CUGAT DEL VALLÈS,29,7,36
2020/2021,08077046,INSTITUT ESCOLA JOAN SALLARÈS I PLA,08187,081878,SABADELL,26,9,35
2020/2021,08077034,INSTITUT ESCOLA EL PI GROS,08203,082037,SANT CEBRIÀ DE VALLALTA,23,4,27
2020/2021,08077022,INSTITUT ESCOLA ELS TRES PINS,08296,082969,VALLROMANES,20,3,23
2020/2021,08077010,INSTITUT ESCOLA COVES D'EN CIMANY,08019,080193,BARCELONA,24,2,26
2020/2021,08077009,INSTITUT ESCOLA CASTELL D'ÒDENA,08143,081430,ÒDENA,25,7,32
2020/2021,08076996,INSTITUT ESCOLA MOSSEN CINTO,08083,080832,FOLGUEROLES,24,4,28
2020/2021,08076984,INSTITUT ESCOLA JOSEP MARIA XANDRI,08233,082331,SANT PERE DE TORELLÓ,15,4,19
2020/2021,08076972,INSTITUT ESCOLA PIERA,08161,081614,PIERA,40,16,56
2020/2021,08076960,INSTITUT ESCOLA RENAIXENÇA,08162,081629,ELS HOSTALETS DE PIEROLA,28,6,34
2020/2021,08076959,INSTITUT ESCOLA CARLES CAPDEVILA,08017,080174,BALENYÀ,23,7,30
2020/2021,08076947,INSTITUT ESCOLA LLUÍS MILLET,08245,082457,SANTA COLOMA DE GRAMENET,15,4,19
2020/2021,08076935,INSTITUT ESCOLA PUIG I GAIRALT,08101,081017,L'HOSPITALET DE LLOBREGAT,32,12,44
2020/2021,08076923,INSTITUT ESCOLA LLIBERTAT,08015,080155,BADALONA,18,4,22
2020/2021,08076901,INSTITUT ESCOLA DE BADALONA,08015,080155,BADALONA,41,15,56
2020/2021,08076893,INSTITUT VILAFRANCA 2,08305,083054,VILAFRANCA DEL PENEDÈS,4,3,7
2020/2021,08076820,INSTITUT ESCOLA SALA I BADRINAS,08279,082798,TERRASSA,31,3,34
2020/2021,08076650,CFA SANT ADRIÀ DE BESÒS,08194,081944,SANT ADRIÀ DE BESÒS,9,7,16
2020/2021,08076649,INSTITUT DE JARDINERIA I AGRICULTURA LES GARBERES,08051,080517,CASTELLAR DEL VALLÈS,6,10,16
2020/2021,08076637,INSTITUT FP SANT CUGAT DEL VALLÈS,08205,082055,SANT CUGAT DEL VALLÈS,28,20,48
2020/2021,08076613,INSTITUT ESCOLA BARNOLA,08012,080121,AVINYÓ,17,5,22
2020/2021,08076601,INSTITUT ESCOLA PERE VIVER,08279,082798,TERRASSA,36,8,44
2020/2021,08076595,INSTITUT ESCOLA TERESA ALTET,08184,081846,RUBÍ,31,10,41
2020/2021,08076583,INSTITUT ESCOLA ELS PINETONS,08180,081803,RIPOLLET,41,16,57
2020/2021,08076571,INSTITUT ESCOLA EL MARTINET,08180,081803,RIPOLLET,39,2,41
2020/2021,08076561,INSTITUT ESCOLA EL VIVER,08125,081252,MONTCADA I REIXAC,37,9,46
2020/2021,08076558,INSTITUT ESCOLA SANT ESTEVE,08051,080517,CASTELLAR DEL VALLÈS,32,5,37
2020/2021,08076546,INSTITUT ESCOLA CAN LLOBET,08252,082520,BARBERÀ DEL VALLÈS,32,8,40
2020/2021,08076534,INSTITUT ESCOLA MONTAGUT,08261,082613,SANTA SUSANNA,25,12,37
2020/2021,08076522,INSTITUT ESCOLA PALLEROLA,08202,082021,SANT CELONI,40,9,49
2020/2021,08076510,INSTITUT ESCOLA PLA DE L'AVELLÀ,08029,080291,CABRERA DE MAR,36,2,38
2020/2021,08076509,INSTITUT ESCOLA ARTS,08019,080193,BARCELONA,29,6,35
2020/2021,08076492,INSTITUT ESCOLA POMPEU FABRA,08182,081825,EL PONT DE VILOMARA I ROCAFORT,28,11,39
2020/2021,08076480,INSTITUT ESCOLA PALLARESA,08245,082457,SANTA COLOMA DE GRAMENET,32,8,40
2020/2021,08076479,INSTITUT ESCOLA SANT QUINTÍ DE MEDIONA,08236,082362,SANT QUINTÍ DE MEDIONA,29,9,38
2020/2021,08076467,INSTITUT ESCOLA PERE LLISCART,08101,081017,L'HOSPITALET DE LLOBREGAT,40,10,50
2020/2021,08076455,INSTITUT ESCOLA SANT JORDI,08015,080155,BADALONA,18,4,22
2020/2021,08076443,INSTITUT ESCOLA RAFAEL ALBERTI,08015,080155,BADALONA,28,9,37
2020/2021,08076431,INSTITUT ESCOLA BALDOMER SOLÀ,08015,080155,BADALONA,30,8,38
2020/2021,08076421,INSTITUT ESCOLA PEPA COLOMER,08169,081691,EL PRAT DE LLOBREGAT,44,6,50
2020/2021,08076406,INSTITUT NARCISA FREIXAS I CRUELLS,08187,081878,SABADELL,7,4,11
2020/2021,08076391,INSTITUT PEDRALBES,08019,080193,BARCELONA,75,58,133
2020/2021,08076194,INSTITUT TECNOLÒGIC DE BARCELONA,08019,080193,BARCELONA,11,29,40
2020/2021,08076169,INSTITUT ESCOLA GORNAL,08101,081017,L'HOSPITALET DE LLOBREGAT,19,10,29
2020/2021,08076157,INSTITUT ESCOLA ÀNGELA BRANSUELA,08121,081213,MATARÓ,31,10,41
2020/2021,08076145,INSTITUT ESCOLA MAR MEDITERRÀNIA,08121,081213,MATARÓ,36,14,50
2020/2021,08076111,INSTITUT JAUME BOTEY,08101,081017,L'HOSPITALET DE LLOBREGAT,28,10,38
2020/2021,08076108,INSTITUT JAUME CABRÉ,08279,082798,TERRASSA,10,7,17
2020/2021,08076091,INSTITUT CA N'ORIAC,08187,081878,SABADELL,13,6,19
2020/2021,08076078,ESCOLA AUDITORI,08019,080193,BARCELONA,11,0,11
2020/2021,08075724,ESCOLA NORAI,08126,081265,MONTGAT,6,1,7
2020/2021,08075712,INSTITUT LES CINC SÉNIES,08121,081213,MATARÓ,23,13,36
2020/2021,08075700,ESCOLA XIRINACS,08019,080193,BARCELONA,12,1,13
2020/2021,08075682,INSTITUT OLÍMPIA,08301,083015,VILADECANS,21,11,32
2020/2021,08075670,INSTITUT ESCOLA TRINITAT NOVA,08019,080193,BARCELONA,44,19,63
2020/2021,08075669,INSTITUT ESCOLA EL TIL·LER,08019,080193,BARCELONA,25,9,34
2020/2021,08075657,INSTITUT ESCOLA ANTAVIANA,08019,080193,BARCELONA,43,19,62
2020/2021,08075645,ESCOLA LA FLOR DE MAIG,08019,080193,BARCELONA,15,1,16
2020/2021,08075633,ESCOLA ANGLESOLA,08019,080193,BARCELONA,18,4,22
2020/2021,08075621,ESCOLA TEIXIDORES DE GRÀCIA,08019,080193,BARCELONA,12,1,13
2020/2021,08075611,ESCOLA GAIA,08019,080193,BARCELONA,15,2,17
2020/2021,08075608,ESCOLA 9 GRAONS,08019,080193,BARCELONA,8,5,13
2020/2021,08075384,INSTITUT ESCOLA LA MINA,08194,081944,SANT ADRIÀ DE BESÒS,42,29,71
2020/2021,08075293,INSTITUT ESCOLA GAVÀ MAR,08089,080898,GAVÀ,46,10,56
2020/2021,08075281,INSTITUT BITÀCOLA,08252,082520,BARBERÀ DEL VALLÈS,13,8,21
2020/2021,08075268,ESCOLA LA MIRADA,08205,082055,SANT CUGAT DEL VALLÈS,20,2,22
2020/2021,08075256,INSTITUT ESCOLA MARTA MATA,08285,082858,TORELLÓ,43,7,50
2020/2021,08075244,ESCOLA LES BASES,08113,081136,MANRESA,13,0,13
2020/2021,08075207,ESCOLA ENTENÇA,08019,080193,BARCELONA,16,1,17
2020/2021,08075074,INSTITUT DE SANTA COLOMA DE GRAMENET,08245,082457,SANTA COLOMA DE GRAMENET,13,9,22
2020/2021,08074847,INSTITUT DE NÀUTICA DE BARCELONA,08019,080193,BARCELONA,8,21,29
2020/2021,08074835,ESCOLA JAUME LLULL,08197,081976,SANT ANDREU DE LLAVANERES,28,3,31
2020/2021,08074823,ESCOLA ELS PICOTS,08107,081075,LLIÇÀ D'AMUNT,25,4,29
2020/2021,08074811,ESCOLA TURÓ DE CAN GILI,08096,080961,GRANOLLERS,21,6,27
2020/2021,08074801,INSTITUT MARTA ESTRADA,08096,080961,GRANOLLERS,17,5,22
2020/2021,08074641,ESCOLA 30 PASSOS,08019,080193,BARCELONA,18,1,19
2020/2021,08074631,INSTITUT LES SALINES,08169,081691,EL PRAT DE LLOBREGAT,45,44,89
2020/2021,08074628,INSTITUT EL PRAT DE LLOBREGAT,08169,081691,EL PRAT DE LLOBREGAT,6,7,13
2020/2021,08074410,INSTITUT LA SERRA,08187,081878,SABADELL,16,8,24
2020/2021,08074380,ESCOLA CASTELL DE DOSRIUS,08075,080752,DOSRIUS,24,7,31
2020/2021,08074070,EOI DE CALELLA,08035,080351,CALELLA,4,3,7
2020/2021,08073961,INSTITUT PLA DEL BOSC,08043,080431,CANYELLES,17,11,28
2020/2021,08073958,ESCOLA NOVA D'ARGENTONA,08009,080095,ARGENTONA,20,3,23
2020/2021,08073843,INSTITUT TORDÀRIA,08284,082845,TORDERA,14,7,21
2020/2021,08073651,INSTITUT PIC DEL VENT,08033,080333,CALDES DE MONTBUI,17,6,23
2020/2021,08073193,INSTITUT BADIA I MARGARIT,08102,081022,IGUALADA,20,16,36
2020/2021,08073171,INSTITUT LA RIERA,08015,080155,BADALONA,12,10,22
2020/2021,08073119,INSTITUT CAN PERIQUET,08156,081568,PALAU-SOLITÀ I PLEGAMANS,19,3,22
2020/2021,08073077,INSTITUT MARIA CANELA,08114,081141,MARTORELL,18,9,27
2020/2021,08073031,INSTITUT NEUS CATALÀ,08073,080734,CORNELLÀ DE LLOBREGAT,13,13,26
2020/2021,08073028,INSTITUT DE SANT POL DE MAR,08235,082359,SANT POL DE MAR,31,14,45
2020/2021,08072978,INSTITUT SUNSI MÓRA,08040,080403,CANET DE MAR,19,12,31
2020/2021,08072607,EOI DE CORNELLÀ DE LLOBREGAT,08073,080734,CORNELLÀ DE LLOBREGAT,8,2,10
2020/2021,08072590,EOI DE RUBÍ,08184,081846,RUBÍ,4,2,6
2020/2021,08072589,EOI GUINARDÓ,08019,080193,BARCELONA,8,2,10
2020/2021,08072401,INSTITUT TORRENT DELS ALOUS,08184,081846,RUBÍ,41,15,56
2020/2021,08072395,ESCOLA POLINYÀ,08167,081672,POLINYÀ,15,2,17
2020/2021,08072383,INSTITUT DOMUS D'OLIVET,08041,080410,CANOVELLES,17,8,25
2020/2021,08072310,INSTITUT ESCOLA REC COMTAL,08019,080193,BARCELONA,21,8,29
2020/2021,08072292,INSTITUT ESCOLA TURÓ DE ROQUETES,08019,080193,BARCELONA,46,14,60
2020/2021,08072255,INSTITUT PREMIÀ DE MAR,08172,081727,PREMIÀ DE MAR,50,59,109
2020/2021,08072188,INSTITUT ESCOLA SANT JORDI,08141,081419,NAVÀS,44,9,53
2020/2021,08072176,INSTITUT DEL TER,08112,081120,MANLLEU,21,7,28
2020/2021,08071691,INSTITUT ESCOLA DEL PRAT,08169,081691,EL PRAT DE LLOBREGAT,21,8,29
2020/2021,08071573,ESC.SUP.DISSENY ESDAP - CATALUNYA,08019,080193,BARCELONA,2,2,4
2020/2021,08071421,ZER EL MOIANÈS LLEVANT,08239,082397,SANT QUIRZE SAFAJA,3,1,4
2020/2021,08071238,INSTITUT ESCOLA JACINT VERDAGUER,08240,082401,SANT SADURNÍ D'ANOIA,38,18,56
2020/2021,08071226,INSTITUT ESCOLA COSTA I LLOBERA,08019,080193,BARCELONA,42,20,62
2020/2021,08071214,INSTITUT ESCOLA CASTELLTERÇOL,08064,080641,CASTELLTERÇOL,31,5,36
2020/2021,08071196,INSTITUT CAN ROCA,08279,082798,TERRASSA,39,23,62
2020/2021,08071172,ESCOLA VIROLET,08187,081878,SABADELL,22,7,29
2020/2021,08071147,ESCOLA ROSER CAPDEVILA,08217,082172,SANT JOAN DESPÍ,22,2,24
2020/2021,08071020,ESCOLA ENXANETA,08301,083015,VILADECANS,18,2,20
2020/2021,08070908,INSTITUT ESCOLA LA TORDERA,08259,082592,SANTA MARIA DE PALAUTORDERA,46,6,52
2020/2021,08070799,ESCOLA TIZIANA,08282,082824,TIANA,16,0,16
2020/2021,08070234,ESCOLA CAN FABRA,08019,080193,BARCELONA,25,3,28
2020/2021,08070143,ESCOLA RIERA ALTA,08245,082457,SANTA COLOMA DE GRAMENET,26,3,29
2020/2021,08069751,ESCOLA SANTA COLOMA,08245,082457,SANTA COLOMA DE GRAMENET,14,3,17
2020/2021,08069748,ESCOLA MONTIGALÀ,08015,080155,BADALONA,11,4,15
2020/2021,08069736,ESCOLA PACO CANDEL,08101,081017,L'HOSPITALET DE LLOBREGAT,27,2,29
2020/2021,08069581,CFA CARME KARR,08218,082188,SANT JOAN DE VILATORRADA,14,1,15
2020/2021,08069499,ESCOLA VIC-CENTRE,08298,082981,VIC,15,5,20
2020/2021,08068616,INSTITUT BAGES SUD,08053,080538,CASTELLBELL I EL VILAR,19,5,24
2020/2021,08068537,INSTITUT LES AIMERIGUES,08279,082798,TERRASSA,37,19,56
2020/2021,08068495,INSTITUT JOSEFINA CASTELLVÍ I PIULACHS,08301,083015,VILADECANS,26,20,46
2020/2021,08068410,ESCOLA PALAU D'AMETLLA,08136,081363,MONTORNÈS DEL VALLÈS,11,6,17
2020/2021,08068380,INSTITUT GURB,08100,081000,GURB,22,11,33
2020/2021,08068379,ESCOLA MAR NOVA,08172,081727,PREMIÀ DE MAR,12,1,13
2020/2021,08068343,ESCOLA LES CIÈNCIES,08015,080155,BADALONA,11,4,15
2020/2021,08068331,ESCOLA BADALONA PORT,08015,080155,BADALONA,15,1,16
2020/2021,08068197,ZER EL CARDENER,08229,082299,SANT MATEU DE BAGES,3,1,4
2020/2021,08068136,CFA VÍCTOR CATALÀ,08208,082080,SANT ESTEVE SESROVIRES,17,6,23
2020/2021,08067818,ESCOLA LA SÍNIA,08298,082981,VIC,34,4,38
2020/2021,08067764,ESCOLA LA MAQUINISTA,08019,080193,BARCELONA,28,2,30
2020/2021,08067752,INSTITUT SAGRERA SANT ANDREU,08019,080193,BARCELONA,10,6,16
2020/2021,08067661,ESCOLA JOAN COROMINES,08121,081213,MATARÓ,25,3,28
2020/2021,08067648,INSTITUT LES VINYES,08074,080749,CUBELLES,17,7,24
2020/2021,08067636,INSTITUT MANRESA SIS,08113,081136,MANRESA,14,8,22
2020/2021,08067600,ESCOLA VALLDAURA,08113,081136,MANRESA,16,2,18
2020/2021,08067594,INSTITUT ESCOLA LES VINYES,08054,080543,CASTELLBISBAL,35,12,47
2020/2021,08067582,ESCOLA MARTA MATA,08252,082520,BARBERÀ DEL VALLÈS,14,4,18
2020/2021,08067430,ESCOLA MONTSERRAT SOLÀ,08121,081213,MATARÓ,23,6,29
2020/2021,08067247,ESCOLA EL VAPOR,08279,082798,TERRASSA,29,3,32
2020/2021,08067235,ESCOLA ROC ALABERN,08279,082798,TERRASSA,26,5,31
2020/2021,08067211,INSTITUT SALAS I XANDRI,08238,082384,SANT QUIRZE DEL VALLÈS,18,4,22
2020/2021,08067201,ESCOLA LOLA ANGLADA,08238,082384,SANT QUIRZE DEL VALLÈS,24,4,28
2020/2021,08067193,ESCOLA DEL BOSC,08184,081846,RUBÍ,14,4,18
2020/2021,08067181,ESCOLA DE RELLINARS,08179,081799,RELLINARS,8,3,11
2020/2021,08067144,INSTITUT DE CERVELLÓ,08068,080689,CERVELLÓ,27,12,39
2020/2021,08067132,ESCOLA JOSEFINA IBÁ¦EZ,08001,080018,ABRERA,16,1,17
2020/2021,08067120,ESCOLA SANTA AGNÈS DE MALANYANES,08181,081810,LA ROCA DEL VALLÈS,13,1,14
2020/2021,08067090,ESCOLA CAN MANENT,08046,080462,CARDEDEU,26,2,28
2020/2021,08067041,ESCOLA XORIGUER,08067,080673,CENTELLES,13,1,14
2020/2021,08067016,ESCOLA ERNEST LLUCH,08101,081017,L'HOSPITALET DE LLOBREGAT,15,3,18
2020/2021,08066905,INSTITUT VILADOMAT,08019,080193,BARCELONA,18,17,35
2020/2021,08066887,EOI DE VILADECANS,08301,083015,VILADECANS,8,4,12
2020/2021,08066851,EOI DE MOLLET DEL VALLÈS,08124,081249,MOLLET DEL VALLÈS,4,4,8
2020/2021,08066565,INSTITUT 22@,08019,080193,BARCELONA,17,7,24
2020/2021,08066541,INSTITUT MARIA ESPINALT,08019,080193,BARCELONA,30,18,48
2020/2021,08066531,ESCOLA FLUVIÀ,08019,080193,BARCELONA,27,3,30
2020/2021,08066528,INSTITUT MARTÍ POUS,08019,080193,BARCELONA,20,13,33
2020/2021,08066516,ESCOLA CONGRÉS-INDIANS,08019,080193,BARCELONA,27,2,29
2020/2021,08066504,ESCOLA L'UNIVERS,08019,080193,BARCELONA,24,1,25
2020/2021,08066462,ESCOLA DELS ENCANTS,08019,080193,BARCELONA,25,5,30
2020/2021,08066437,INSTITUT MONT PERDUT,08279,082798,TERRASSA,43,24,67
2020/2021,08066413,ESCOLA COLORS,08086,080863,LES FRANQUESES DEL VALLÈS,15,1,16
2020/2021,08066334,ESCOLA LA SERRETA,08192,081923,SANTPEDOR,13,3,16
2020/2021,08066322,INSTITUT CARDENER,08218,082188,SANT JOAN DE VILATORRADA,18,8,26
2020/2021,08066048,ESCOLA ROSER CAPDEVILA,08279,082798,TERRASSA,26,3,29
2020/2021,08065664,EOI DEL BERGUEDÀ,08022,080229,BERGA,4,1,5
2020/2021,08065652,EOI DE L'ALT PENEDÈS,08305,083054,VILAFRANCA DEL PENEDÈS,4,3,7
2020/2021,08065512,ESCOLA SERRA DE L'OBAC,08279,082798,TERRASSA,24,6,30
2020/2021,08065482,ESCOLA ELS VENTETS - ZER EL MOIANÈS LLEVANT,08070,080706,COLLSUSPINA,1,3,4
2020/2021,08065469,INSTITUT CAN RECORD,08207,082074,SANT ESTEVE DE PALAUTORDERA,20,4,24
2020/2021,08065433,INSTITUT LA SÍNIA,08159,081593,PARETS DEL VALLÈS,13,8,21
2020/2021,08065421,INSTITUT MARTA MATA,08136,081363,MONTORNÈS DEL VALLÈS,29,16,45
2020/2021,08065411,INSTITUT AIGUAVIVA,08124,081249,MOLLET DEL VALLÈS,33,11,44
2020/2021,08065408,INSTITUT HIPÀTIA D'ALEXANDRIA,08107,081075,LLIÇÀ D'AMUNT,15,6,21
2020/2021,08065391,INSTITUT EL TIL·LER,08086,080863,LES FRANQUESES DEL VALLÈS,32,16,48
2020/2021,08065366,INSTITUT DE PINEDA DE MAR,08163,081635,PINEDA DE MAR,31,12,43
2020/2021,08065354,INSTITUT BAIX A MAR,08307,083073,VILANOVA I LA GELTRÚ,31,17,48
2020/2021,08065342,INSTITUT XALOC,08231,082310,SANT PERE DE RIBES,15,7,22
2020/2021,08065330,INSTITUT CAL GRAVAT,08113,081136,MANRESA,39,18,57
2020/2021,08065329,INSTITUT DE L'ALT FOIX,08227,082270,SANT MARTÍ SARROCA,24,15,39
2020/2021,08065305,ESCOLA SOLER DE VILARDELL,08202,082021,SANT CELONI,18,2,20
2020/2021,08065299,ESCOLA EL CALDERÍ,08033,080333,CALDES DE MONTBUI,15,0,15
2020/2021,08065287,ESCOLA MARTA MATA,08121,081213,MATARÓ,28,1,29
2020/2021,08065275,ESCOLA VOLERANY,08307,083073,VILANOVA I LA GELTRÚ,24,4,28
2020/2021,08065263,ESCOLA PUIGSOLER,08262,082628,SANT VICENÇ DE CASTELLET,19,3,22
2020/2021,08065251,ESCOLA PLA DEL PUIG,08213,082135,SANT FRUITÓS DE BAGES,13,2,15
2020/2021,08065238,ESCOLA LA SAGRERA,08248,082482,SANTA EULÀLIA DE RONÇANA,23,6,29
2020/2021,08065019,INSTITUT DE VALLBONA D'ANOIA,08292,082922,VALLBONA D'ANOIA,18,5,23
2020/2021,08065007,ESCOLA POBLENOU,08163,081635,PINEDA DE MAR,13,3,16
2020/2021,08064994,ESCOLA MARIA-MERCÈ MARÇAL,08121,081213,MATARÓ,23,5,28
2020/2021,08064982,ESCOLA DE SANT QUIRZE SAFAJA - ZER EL MOIANÈS LLEVANT,08239,082397,SANT QUIRZE SAFAJA,5,0,5
2020/2021,08064970,INSTITUT NOU DE VILAFRANCA DEL PENEDÈS,08305,083054,VILAFRANCA DEL PENEDÈS,30,16,46
2020/2021,08064945,ESCOLA MANSUET,08069,080692,COLLBATÓ,14,2,16
2020/2021,08064921,INSTITUT DE SANT ANDREU,08196,081960,SANT ANDREU DE LA BARCA,23,10,33
2020/2021,08064911,INSTITUT VALÈRIA HALINÉ,08056,080569,CASTELLDEFELS,21,14,35
2020/2021,08064908,INSTITUT BEGUES,08020,080207,BEGUES,19,5,24
2020/2021,08064881,ESCOLA CAMPDERRÓS,08295,082956,VALLIRANA,17,3,20
2020/2021,08064866,ESCOLA DOLORS MARTÍ I BADIA,08102,081022,IGUALADA,29,1,30
2020/2021,08064854,ESCOLA MARTINET,08073,080734,CORNELLÀ DE LLOBREGAT,22,6,28
2020/2021,08064830,INSTITUT SERRA DE NOET,08022,080229,BERGA,25,6,31
2020/2021,08064829,ESCOLA VALLDENEU,08224,082248,SANT MARTÍ DE CENTELLES,8,0,8
2020/2021,08064817,ESCOLA CAMINS,08086,080863,LES FRANQUESES DEL VALLÈS,28,3,31
2020/2021,08064805,ESCOLA ELS QUATRE VENTS,08041,080410,CANOVELLES,27,8,35
2020/2021,08064787,ESCOLA EMILI TEIXIDOR,08183,081831,RODA DE TER,17,0,17
2020/2021,08064751,ESCOLA MAR I CEL,08074,080749,CUBELLES,14,3,17
2020/2021,08064741,ESCOLA ÍTACA,08113,081136,MANRESA,26,4,30
2020/2021,08064738,ESCOLA DOLORS PIERA,08305,083054,VILAFRANCA DEL PENEDÈS,27,4,31
2020/2021,08064659,CFA SALVADOR DALÍ,08181,081810,LA ROCA DEL VALLÈS,15,8,23
2020/2021,08064647,CFA ARTUR MARTORELL,08208,082080,SANT ESTEVE SESROVIRES,17,6,23
2020/2021,08064635,CFA SANTIAGO RUSI¦OL,08181,081810,LA ROCA DEL VALLÈS,10,4,14
2020/2021,08064623,CFA CONCEPCIÓ ARENAL,08019,080193,BARCELONA,3,1,4
2020/2021,08064222,ESCOLA LA ROUREDA,08284,082845,TORDERA,25,3,28
2020/2021,08064179,ESCOLA LA LLACUNA DEL POBLENOU,08019,080193,BARCELONA,26,3,29
2020/2021,08064167,ESCOLA SANT MARTÍ,08019,080193,BARCELONA,25,4,29
2020/2021,08064155,INSTITUT QUATRE CANTONS,08019,080193,BARCELONA,29,16,45
2020/2021,08064143,ESCOLA LA NOVA ELECTRA,08279,082798,TERRASSA,34,7,41
2020/2021,08064131,ESCOLA ELS AIGÜEROLS,08260,082606,SANTA PERPÈTUA DE MOGODA,13,3,16
2020/2021,08064118,ESCOLA CIUTAT D'ALBA,08205,082055,SANT CUGAT DEL VALLÈS,28,3,31
2020/2021,08064088,ESCOLA MAS BOADELLA,08187,081878,SABADELL,27,2,29
2020/2021,08064076,ESCOLA RIVO RUBEO,08184,081846,RUBÍ,26,3,29
2020/2021,08064027,ESCOLA EL SOL I LA LLUNA,08051,080517,CASTELLAR DEL VALLÈS,20,3,23
2020/2021,08064003,INSTITUT CAN MARGARIT,08072,080728,CORBERA DE LLOBREGAT,25,12,37
2020/2021,08063965,ESCOLA CAU DE LA GUINEU,08072,080728,CORBERA DE LLOBREGAT,14,1,15
2020/2021,08063931,ESCOLA LES FALGUERES,08082,080826,FOGARS DE LA SELVA,14,1,15
2020/2021,08063928,ESCOLA MUNTANYOLA,08129,081290,MUNTANYOLA,7,0,7
2020/2021,08063916,ESCOLA VILA PARIETES,08159,081593,PARETS DEL VALLÈS,13,3,16
2020/2021,08063904,INSTITUT MONTGRÒS,08231,082310,SANT PERE DE RIBES,26,17,43
2020/2021,08063898,ESCOLA LA SÈQUIA,08113,081136,MANRESA,23,6,29
2020/2021,08063886,ESCOLA ARRELS,08251,082515,SANTA MARGARIDA I ELS MONJOS,15,1,16
2020/2021,08063874,ESCOLA ANTONIO MACHADO,08121,081213,MATARÓ,26,3,29
2020/2021,08063862,ESCOLA L'OLIVAR,08062,080620,CASTELLNOU DE BAGES,12,3,15
2020/2021,08063837,INSTITUT LES MARGUES,08037,080370,CALLDETENES,22,8,30
2020/2021,08063813,INSTITUT CREU DE SABA,08147,081477,OLESA DE MONTSERRAT,29,17,46
2020/2021,08063801,INSTITUT DE COLLBATÓ,08069,080692,COLLBATÓ,23,8,31
2020/2021,08063795,ESCOLA MARTA MATA,08302,083020,VILANOVA DEL CAMÍ,13,2,15
2020/2021,08063783,ESCOLA MEDITERRÀNIA,08301,083015,VILADECANS,14,2,16
2020/2021,08063771,ESCOLA PLA DE LES VINYES,08244,082444,SANTA COLOMA DE CERVELLÓ,21,3,24
2020/2021,08063761,ESCOLA VICENTE FERRER,08200,082009,SANT BOI DE LLOBREGAT,13,4,17
2020/2021,08063758,ESCOLA CAN SALVI,08196,081960,SANT ANDREU DE LA BARCA,29,2,31
2020/2021,08063734,ESCOLA PUIGVENTÓS,08147,081477,OLESA DE MONTSERRAT,25,5,30
2020/2021,08063710,ESCOLA ESCOLA NOVA,08068,080689,CERVELLÓ,18,0,18
2020/2021,08063643,CFA LA COOPERATIVA,08285,082858,TORELLÓ,1,2,3
2020/2021,08063621,CFA MARTÍ I POL,08112,081120,MANLLEU,2,3,5
2020/2021,08063618,CFA ESPARREGUERA,08076,080765,ESPARREGUERA,2,2,4
2020/2021,08063394,ESCOLA MIQUEL MARTÍ I POL,08211,082114,SANT FELIU DE LLOBREGAT,27,3,30
2020/2021,08063229,INSTITUT MONTPEDRÓS,08244,082444,SANTA COLOMA DE CERVELLÓ,33,26,59
2020/2021,08063072,ESCOLA FRUCTUÓS GELABERT,08019,080193,BARCELONA,28,1,29
2020/2021,08062948,ESCOLA MIQUEL MARTÍ I POL,08301,083015,VILADECANS,34,5,39
2020/2021,08062924,ESCOLA JOSEP GUINOVART,08056,080569,CASTELLDEFELS,14,4,18
2020/2021,08062870,INSTITUT LA PLANA,08298,082981,VIC,37,15,52
2020/2021,08062869,ESCOLA SERRA DE MIRALLES,08284,082845,TORDERA,14,3,17
2020/2021,08062857,INSTITUT TIANA,08282,082824,TIANA,23,12,35
2020/2021,08062833,ESCOLA AGNÈS DE SITGES,08270,082704,SITGES,15,1,16
2020/2021,08062811,ESCOLA MATAGALLS,08259,082592,SANTA MARIA DE PALAUTORDERA,15,1,16
2020/2021,08062808,INSTITUT ESTEVE ALBERT,08264,082649,SANT VICENÇ DE MONTALT,29,18,47
2020/2021,08062791,INSTITUT VILAMAJOR,08234,082346,SANT PERE DE VILAMAJOR,32,17,49
2020/2021,08062781,ESCOLA MEDITERRÀNIA,08231,082310,SANT PERE DE RIBES,24,3,27
2020/2021,08062778,ESCOLA AMETLLERS,08218,082188,SANT JOAN DE VILATORRADA,25,3,28
2020/2021,08062754,ESCOLA LES FONTS,08091,080919,GELIDA,22,4,26
2020/2021,08062742,ESCOLA BENVIURE,08054,080543,CASTELLBISBAL,15,2,17
2020/2021,08062730,INSTITUT ELS ROURES,08075,080752,DOSRIUS,19,6,25
2020/2021,08062729,INSTITUT PLA MARCELL,08046,080462,CARDEDEU,44,14,58
2020/2021,08062717,INSTITUT CABRILS,08030,080305,CABRILS,22,14,36
2020/2021,08062705,ESCOLA LA CABANA,08027,080272,LES CABANYES,11,3,14
2020/2021,08062687,ESCOLA PONENT,08279,082798,TERRASSA,27,2,29
2020/2021,08062675,ESCOLA PERE IV,08019,080193,BARCELONA,27,3,30
2020/2021,08062641,ESCOLA L'OLIVERA,08205,082055,SANT CUGAT DEL VALLÈS,26,4,30
2020/2021,08062638,ESCOLA LA TRAMA,08187,081878,SABADELL,19,3,22
2020/2021,08062626,ESCOLA COLLSEROLA,08266,082665,CERDANYOLA DEL VALLÈS,14,1,15
2020/2021,08062614,ESCOLA JOAN BLANQUER,08051,080517,CASTELLAR DEL VALLÈS,15,1,16
2020/2021,08062523,CFA MARINADA,08136,081363,MONTORNÈS DEL VALLÈS,3,1,4
2020/2021,08062511,CFA ALARONA,08121,081213,MATARÓ,4,2,6
2020/2021,08062493,CFA SANT RAMON,08101,081017,L'HOSPITALET DE LLOBREGAT,5,2,7
2020/2021,08062481,CFA SANT JOSEP,08101,081017,L'HOSPITALET DE LLOBREGAT,4,2,6
2020/2021,08062471,CFA GAVÀ,08089,080898,GAVÀ,3,3,6
2020/2021,08062468,CFA BELLAVISTA,08086,080863,LES FRANQUESES DEL VALLÈS,3,1,4
2020/2021,08062331,CFA PERE CALDERS,08019,080193,BARCELONA,6,3,9
2020/2021,08062262,CFA MONTSERRAT ROIG,08019,080193,BARCELONA,6,1,7
2020/2021,08062250,CFA TORRENT D'EN MELIS,08019,080193,BARCELONA,4,1,5
2020/2021,08062249,CFA EL CARMEL,08019,080193,BARCELONA,5,4,9
2020/2021,08062225,EOI GARRAF,08307,083073,VILANOVA I LA GELTRÚ,6,3,9
2020/2021,08062213,EOI VALLÈS ORIENTAL,08096,080961,GRANOLLERS,4,4,8
2020/2021,08062201,EOI BARCELONA V,08019,080193,BARCELONA,6,2,8
2020/2021,08062195,EOI BARCELONA IV,08019,080193,BARCELONA,8,5,13
2020/2021,08062183,EOI OSONA,08298,082981,VIC,5,2,7
2020/2021,08062171,EOI D'IGUALADA,08102,081022,IGUALADA,7,1,8
2020/2021,08062161,EOI DE SANT CUGAT DEL VALLÈS,08205,082055,SANT CUGAT DEL VALLÈS,5,5,10
2020/2021,08062158,EOI DE MARTORELL,08114,081141,MARTORELL,5,3,8
2020/2021,08062146,CFA LA VERNEDA,08019,080193,BARCELONA,4,4,8
2020/2021,08062122,CFA MARTORELL,08114,081141,MARTORELL,3,5,8
2020/2021,08062110,CFA SANFELIU,08101,081017,L'HOSPITALET DE LLOBREGAT,2,4,6
2020/2021,08062109,AFA CIUTAT MERIDIANA,08019,080193,BARCELONA,5,2,7
2020/2021,08062092,CFA VILAFRANCA DEL PENEDÈS,08305,083054,VILAFRANCA DEL PENEDÈS,5,4,9
2020/2021,08062080,CFA EGARA,08279,082798,TERRASSA,8,2,10
2020/2021,08062079,CFA RAMON LLULL,08279,082798,TERRASSA,4,1,5
2020/2021,08062055,CFA SANT JUST DESVERN,08221,082212,SANT JUST DESVERN,2,2,4
2020/2021,08062043,CFA PARETS DEL VALLÈS,08159,081593,PARETS DEL VALLÈS,2,2,4
2020/2021,08062031,CFA MARE DE DÉU DE MONTSERRAT,08147,081477,OLESA DE MONTSERRAT,4,1,5
2020/2021,08062021,CFA MONTCADA I REIXAC,08125,081252,MONTCADA I REIXAC,5,2,7
2020/2021,08062018,CFA ANOIA,08102,081022,IGUALADA,2,2,4
2020/2021,08061993,CFA EUGENI D'ORS,08077,080771,ESPLUGUES DE LLOBREGAT,8,2,10
2020/2021,08061971,CFA BERGUEDÀ,08022,080229,BERGA,4,1,5
2020/2021,08061968,CFA LES CORTS,08019,080193,BARCELONA,6,1,7
2020/2021,08061956,CFA PROSPERITAT,08019,080193,BARCELONA,3,2,5
2020/2021,08061944,CFA MADRID,08019,080193,BARCELONA,5,0,5
2020/2021,08061932,CFA BON PASTOR,08019,080193,BARCELONA,5,2,7
2020/2021,08061919,CFA RIUS I TAULET,08019,080193,BARCELONA,9,0,9
2020/2021,08061907,CFA BARCELONETA,08019,080193,BARCELONA,5,1,6
2020/2021,08061774,ESCOLA LES ARENES,08279,082798,TERRASSA,22,8,30
2020/2021,08061762,ESCOLA MAS MARIA,08030,080305,CABRILS,18,5,23
2020/2021,08061725,EOI BARCELONA III,08019,080193,BARCELONA,7,4,11
2020/2021,08061701,CFA MARIA RUBIES,08019,080193,BARCELONA,6,3,9
2020/2021,08061683,CFA PALAU DE MAR,08019,080193,BARCELONA,4,4,8
2020/2021,08061622,ESCOLA CAN COLL,08289,082896,TORRELLES DE LLOBREGAT,16,1,17
2020/2021,08061610,ESCOLA LA SÍNIA,08123,081234,MOLINS DE REI,22,7,29
2020/2021,08061609,ESCOLA MERCÈ RODOREDA,08114,081141,MARTORELL,33,1,34
2020/2021,08061580,CFA LLOREDA-LA PAU,08015,080155,BADALONA,5,1,6
2020/2021,08061555,CFA CAN FOLGUERA,08260,082606,SANTA PERPÈTUA DE MOGODA,5,2,7
2020/2021,08061543,ESCOLA ROSER CAPDEVILA,08167,081672,POLINYÀ,23,5,28
2020/2021,08061521,ESCOLA VALL DE NÉSPOLA - ZER EL MOIANÈS PONENT,08139,081398,MURA,5,1,6
2020/2021,08061361,INSTITUT TORRELLES DE LLOBREGAT,08289,082896,TORRELLES DE LLOBREGAT,9,14,23
2020/2021,08061348,ESCOLA BUFALÀ,08015,080155,BADALONA,28,2,30
2020/2021,08061221,CFA VALLÈS,08096,080961,GRANOLLERS,10,2,12
2020/2021,08061208,INSTITUT VACARISSES,08291,082917,VACARISSES,29,21,50
2020/2021,08061191,ESCOLA FONT DE L'ORPINA,08291,082917,VACARISSES,14,2,16
2020/2021,08061181,ESCOLA SANTIGA,08260,082606,SANTA PERPÈTUA DE MOGODA,16,2,18
2020/2021,08061178,ESCOLA TURÓ DE CAN MATES,08205,082055,SANT CUGAT DEL VALLÈS,26,3,29
2020/2021,08061166,ESCOLA DE CAN LLONG,08187,081878,SABADELL,22,6,28
2020/2021,08061154,ESCOLA CA N'ALZAMORA,08184,081846,RUBÍ,30,1,31
2020/2021,08061142,ESCOLA MIQUEL MARTÍ I POL,08252,082520,BARBERÀ DEL VALLÈS,28,1,29
2020/2021,08061129,INSTITUT MONTSERRAT COLOMER,08208,082080,SANT ESTEVE SESROVIRES,38,15,53
2020/2021,08061117,INSTITUT TURÓ D'EN BALDIRI,08281,082819,TEIÀ,16,5,21
2020/2021,08061105,ESCOLA SOT DEL CAMP,08264,082649,SANT VICENÇ DE MONTALT,21,0,21
2020/2021,08061099,INSTITUT FONT DEL FERRO,08155,081555,PALAFOLLS,43,17,60
2020/2021,08061087,ESCOLA MARINA,08126,081265,MONTGAT,28,2,30
2020/2021,08061063,ESCOLA LA SERRETA,08003,080039,ALELLA,15,2,17
2020/2021,08061051,ESCOLA ÍTACA,08307,083073,VILANOVA I LA GELTRÚ,21,4,25
2020/2021,08061041,ESCOLA SANT JORDI,08307,083073,VILANOVA I LA GELTRÚ,26,4,30
2020/2021,08061038,INSTITUT DE VILANOVA DEL VALLÈS,08902,089024,VILANOVA DEL VALLÈS,27,24,51
2020/2021,08061026,ESCOLA LA FALGUERA,08902,089024,VILANOVA DEL VALLÈS,15,2,17
2020/2021,08061014,INSTITUT VINYET,08270,082704,SITGES,30,18,48
2020/2021,08061002,ESCOLA LES PARELLADES,08231,082310,SANT PERE DE RIBES,11,5,16
2020/2021,08060991,ESCOLA MOGENT,08181,081810,LA ROCA DEL VALLÈS,26,1,27
2020/2021,08060988,ESCOLA CAL MÚSIC,08124,081249,MOLLET DEL VALLÈS,20,5,25
2020/2021,08060976,INSTITUT DEL VOLTREGANÈS,08117,081173,LES MASIES DE VOLTREGÀ,27,9,36
2020/2021,08060964,ESCOLA QUATRE VENTS,08112,081120,MANLLEU,35,5,40
2020/2021,08060952,ESCOLA ELS VINYALS,08108,081081,LLIÇÀ DE VALL,13,2,15
2020/2021,08060940,ESCOLA ROSA ORIOL ANGUERA,08107,081075,LLIÇÀ D'AMUNT,22,3,25
2020/2021,08060939,ESCOLA GUERAU DE LIOST,08086,080863,LES FRANQUESES DEL VALLÈS,24,5,29
2020/2021,08060927,ESCOLA VORA DEL MAR,08074,080749,CUBELLES,30,2,32
2020/2021,08060915,INSTITUT MARIA DE BELL-LLOC,08023,080235,BIGUES I RIELLS,28,18,46
2020/2021,08060903,ESCOLA EL COLOMER,08023,080235,BIGUES I RIELLS,23,4,27
2020/2021,08060873,ESCOLA EULÀLIA BOTA,08019,080193,BARCELONA,27,3,30
2020/2021,08060851,ESCOLA L'OLIVERA,08295,082956,VALLIRANA,20,7,27
2020/2021,08060848,ESCOLA DE SANT ANDREU DE LA BARCA,08196,081960,SANT ANDREU DE LA BARCA,24,6,30
2020/2021,08060836,ESCOLA TURÓ DEL DRAC,08040,080403,CANET DE MAR,29,2,31
2020/2021,08060757,ESCOLA JOAN TORREDEMER CANELA,08120,081206,MATADEPERA,28,1,29
2020/2021,08060629,ESCOLA EL CORB,08072,080728,CORBERA DE LLOBREGAT,15,3,18
2020/2021,08060605,ESCOLA FONT DEL ROURE,08119,081192,MASQUEFA,24,6,30
2020/2021,08060599,ESCOLA GARIGOT,08056,080569,CASTELLDEFELS,24,3,27
2020/2021,08060538,EOI DEL PRAT DE LLOBREGAT,08169,081691,EL PRAT DE LLOBREGAT,9,2,11
2020/2021,08060526,ESCOLA CREIXÀ,08161,081614,PIERA,10,3,13
2020/2021,08060514,INSTITUT DE MASQUEFA,08119,081192,MASQUEFA,38,23,61
2020/2021,08060484,ESCOLA TAULA RODONA,08238,082384,SANT QUIRZE DEL VALLÈS,24,5,29
2020/2021,08060423,ESCOLA MAS PRATS,08155,081555,PALAFOLLS,25,2,27
2020/2021,08060411,CFA SANTS-SANT RAIMON DE PENYAFORT,08019,080193,BARCELONA,2,4,6
2020/2021,08060319,ESCOLA LES FONTS,08009,080095,ARGENTONA,23,2,25
2020/2021,08060290,CFA SINGUERLÍN,08245,082457,SANTA COLOMA DE GRAMENET,6,4,10
2020/2021,08060289,CFA FONDO,08245,082457,SANTA COLOMA DE GRAMENET,3,9,12
2020/2021,08060277,CFA PAU CASALS,08184,081846,RUBÍ,6,5,11
2020/2021,08060265,CFA PREMIÀ DE MAR,08172,081727,PREMIÀ DE MAR,3,4,7
2020/2021,08060253,CFA CAN MARFÀ,08121,081213,MATARÓ,10,2,12
2020/2021,08060231,CFA PEGASO,08019,080193,BARCELONA,8,2,10
2020/2021,08060228,CFA EL CLOT,08019,080193,BARCELONA,6,5,11
2020/2021,08060216,CFA MORERA POMAR,08015,080155,BADALONA,9,2,11
2020/2021,08060204,CFA GRAN SOL,08015,080155,BADALONA,7,5,12
2020/2021,08060137,CFA EDÈLIA HERNÁNDEZ,08301,083015,VILADECANS,9,2,11
2020/2021,08060113,CFA JACINT CARRIÓ I VILASECA,08113,081136,MANRESA,8,5,13
2020/2021,08060095,CFA MONTSENY,08298,082981,VIC,8,3,11
2020/2021,08060009,INSTITUT MANUEL CARRASCO I FORMIGUERA,08210,082107,SANT FELIU DE CODINES,14,8,22
2020/2021,08059998,ESCOLA LA PAU,08240,082401,SANT SADURNÍ D'ANOIA,28,3,31
2020/2021,08059871,ESCOLA GERBERT D'ORLHAC,08205,082055,SANT CUGAT DEL VALLÈS,27,3,30
2020/2021,08059822,ESCOLA ERNEST LLUCH,08001,080018,ABRERA,27,3,30
2020/2021,08059810,ESCOLA VINYA DEL SASTRET,08208,082080,SANT ESTEVE SESROVIRES,13,4,17
2020/2021,08059809,ESCOLA EL ROURE,08209,082093,SANT FOST DE CAMPSENTELLES,16,0,16
2020/2021,08059792,ESCOLA MOGENT,08136,081363,MONTORNÈS DEL VALLÈS,26,3,29
2020/2021,08059780,ESCOLA BELLAVISTA-JOAN CAMPS I GIRÓ,08086,080863,LES FRANQUESES DEL VALLÈS,23,5,28
2020/2021,08059767,ESCOLA TANIT,08245,082457,SANTA COLOMA DE GRAMENET,17,3,20
2020/2021,08059755,ESCOLA LA FONT,08113,081136,MANRESA,27,6,33
2020/2021,08059731,CFA ARQUITECTE JUJOL,08217,082172,SANT JOAN DESPÍ,9,4,13
2020/2021,08059721,ESCOLA MARTA MATA,08301,083015,VILADECANS,31,3,34
2020/2021,08059706,CFA SALVADOR ESPRIU,08279,082798,TERRASSA,6,0,6
2020/2021,08059691,CFA ANNA MURIÀ,08279,082798,TERRASSA,8,4,12
2020/2021,08059688,INSTITUT MARIA AURÈLIA CAPMANY,08073,080734,CORNELLÀ DE LLOBREGAT,38,19,57
2020/2021,08059639,ESCOLA PROGRÉS,08015,080155,BADALONA,27,3,30
2020/2021,08059551,EOI DE MANRESA,08113,081136,MANRESA,10,3,13
2020/2021,08059524,INSTITUT DE NAVARCLES,08140,081402,NAVARCLES,14,8,22
2020/2021,08059354,ESCOLA LES ROQUES BLAVES,08076,080765,ESPARREGUERA,19,1,20
2020/2021,08059329,INSTITUT CAN PEIXAUET,08245,082457,SANTA COLOMA DE GRAMENET,33,24,57
2020/2021,08059287,ZER GUILLERIES,17220,172207,VILADRAU,2,2,4
2020/2021,08059093,ESCOLA D'HORTSAVINYÀ,08284,082845,TORDERA,4,3,7
2020/2021,08059044,CFA LA LLAGOSTA,08105,081056,LA LLAGOSTA,7,3,10
2020/2021,08058969,INSTITUT EL VERN,08108,081081,LLIÇÀ DE VALL,24,8,32
2020/2021,08058957,ESCOLA ELS COSTERETS,08231,082310,SANT PERE DE RIBES,26,0,26
2020/2021,08058817,ZER TRES BRANQUES,08063,080636,CASTELLOLÍ,2,2,4
2020/2021,08058775,INSTITUT FRONT MARÍTIM,08019,080193,BARCELONA,29,17,46
2020/2021,08058520,INSTITUT PUIG DE LA CREU,08051,080517,CASTELLAR DEL VALLÈS,35,15,50
2020/2021,08058519,ESCOLA SINERA,08006,080060,ARENYS DE MAR,24,6,30
2020/2021,08058465,ESCOLA ENXANETA,08279,082798,TERRASSA,37,5,42
2020/2021,08058441,ESCOLA GIROI,08088,080885,LA GARRIGA,20,3,23
2020/2021,08058428,INSTITUT BISAURA,08237,082378,SANT QUIRZE DE BESORA,12,7,19
2020/2021,08058416,ESCOLA L'ARENAL DE LLEVANT,08019,080193,BARCELONA,27,2,29
2020/2021,08058404,INSTITUT CIRVIÀNUM DE TORELLÓ,08285,082858,TORELLÓ,42,22,64
2020/2021,08058374,ESCOLA ELS ALOCS,08219,082191,VILASSAR DE MAR,14,2,16
2020/2021,08058362,ESCOLA RIERA DE RIBES,08231,082310,SANT PERE DE RIBES,25,4,29
2020/2021,08058210,CFA BADIA DEL VALLÈS,08904,089045,BADIA DEL VALLÈS,2,0,2
2020/2021,08058209,CFA SANT BOI,08200,082009,SANT BOI DE LLOBREGAT,8,4,12
2020/2021,08058091,ZER BAIX BERGUEDÀ,08144,081445,OLVAN,4,0,4
2020/2021,08058088,ZER BERGUEDÀ CENTRE,08299,082994,VILADA,2,1,3
2020/2021,08058076,ZER ELS CASTELLS,08131,081311,MONTESQUIU,2,2,4
2020/2021,08057965,CFA CAN SERRA,08101,081017,L'HOSPITALET DE LLOBREGAT,8,3,11
2020/2021,08057874,CFA CATALÒNIA,08101,081017,L'HOSPITALET DE LLOBREGAT,7,2,9
2020/2021,08057734,ESCOLA ANTONI GAUDÍ,08250,082508,SANTA MARGARIDA DE MONTBUI,29,5,34
2020/2021,08057679,CFA BELLVITGE-GORNAL,08101,081017,L'HOSPITALET DE LLOBREGAT,8,2,10
2020/2021,08057667,CFA TRINITAT VELLA,08019,080193,BARCELONA,3,2,5
2020/2021,08057540,INSTITUT JOAN BROSSA,08019,080193,BARCELONA,47,32,79
2020/2021,08057281,ZER CEP DE SIS,08249,082495,SANTA FE DEL PENEDÈS,3,2,5
2020/2021,08057266,ESCOLA ELS CINGLES,08005,080057,L'AMETLLA DEL VALLÈS,20,3,23
2020/2021,08057254,INSTITUT PERE RIBOT,08219,082191,VILASSAR DE MAR,31,16,47
2020/2021,08057242,ESCOLA SERENA VALL,08197,081976,SANT ANDREU DE LLAVANERES,27,3,30
2020/2021,08057230,INSTITUT CUBELLES,08074,080749,CUBELLES,39,15,54
2020/2021,08057229,ESCOLA ELS ARENYS,08054,080543,CASTELLBISBAL,16,4,20
2020/2021,08057163,CFA TERESA MA¦É,08307,083073,VILANOVA I LA GELTRÚ,7,7,14
2020/2021,08057102,ESCOLA ANDERSEN,08298,082981,VIC,35,2,37
2020/2021,08057096,ESCOLA GUILLEM DE MONT-RODON,08298,082981,VIC,30,5,35
2020/2021,08057011,CFA CAN RULL,08187,081878,SABADELL,6,3,9
2020/2021,08057001,CFA LA CREU DE BARBERÀ,08187,081878,SABADELL,6,2,8
2020/2021,08056997,CFA LA CONCÒRDIA,08187,081878,SABADELL,9,7,16
2020/2021,08056985,INSTITUT RAMON BERENGUER IV,08245,082457,SANTA COLOMA DE GRAMENET,40,27,67
2020/2021,08056857,ZER GAVARRESA,08212,082129,SANT FELIU SASSERRA,4,0,4
2020/2021,08056833,ZER BAIX MONTSENY,08259,082592,SANTA MARIA DE PALAUTORDERA,2,1,3
2020/2021,08056811,ZER ALT BERGUEDÀ,08293,082938,VALLCEBRE,2,2,4
2020/2021,08056791,ZER VENT D'AVALL,08170,081705,ELS PRATS DE REI,3,1,4
2020/2021,08056781,ZER SERRA D'ANCOSA,08104,081043,LA LLACUNA,2,2,4
2020/2021,08056766,ZER SUBIRATS,08273,082732,SUBIRATS,3,0,3
2020/2021,08056742,ZER ALT LLUÇANÈS,08201,082016,SANT BOI DE LLUÇANÈS,2,1,3
2020/2021,08056729,ZER EL MOIANÈS PONENT,08034,080348,CALDERS,3,1,4
2020/2021,08056614,ESCOLA CIRERA,08121,081213,MATARÓ,22,3,25
2020/2021,08056584,CFA L'ALZINA DE CERDANYOLA,08266,082665,CERDANYOLA DEL VALLÈS,8,2,10
2020/2021,08056572,CFA TERRA BAIXA,08169,081691,EL PRAT DE LLOBREGAT,5,7,12
2020/2021,08056560,CFA BARBERÀ,08252,082520,BARBERÀ DEL VALLÈS,6,3,9
2020/2021,08056109,INSTITUT CAN VILUMARA,08101,081017,L'HOSPITALET DE LLOBREGAT,62,26,88
2020/2021,08055944,INSTITUT RUBIÓ I ORS,08101,081017,L'HOSPITALET DE LLOBREGAT,24,17,41
2020/2021,08055932,ESCOLA TORRENT DE CAN CARABASSA,08019,080193,BARCELONA,26,4,30
2020/2021,08055907,ESCOLA MIQUEL MARTÍ I POL,08107,081075,LLIÇÀ D'AMUNT,12,6,18
2020/2021,08055890,ESCOLA SOBIRANS,08007,080076,ARENYS DE MUNT,23,2,25
2020/2021,08055889,ESCOLA MIQUEL MARTÍ I POL,08187,081878,SABADELL,28,0,28
2020/2021,08055713,CFA SANT CUGAT DEL VALLÈS,08205,082055,SANT CUGAT DEL VALLÈS,7,0,7
2020/2021,08055695,CFA RAFAEL FARRÉ,08123,081234,MOLINS DE REI,1,5,6
2020/2021,08055683,CFA MANUEL SACRISTÁN,08019,080193,BARCELONA,7,5,12
2020/2021,08055440,CFA GARROSA,08263,082634,SANT VICENÇ DELS HORTS,7,3,10
2020/2021,08055439,CFA MESTRE ESTEVE,08211,082114,SANT FELIU DE LLOBREGAT,4,4,8
2020/2021,08055403,CFA SANT ROC,08015,080155,BADALONA,5,3,8
2020/2021,08055397,CFA JAUME TUSET,08180,081803,RIPOLLET,6,5,11
2020/2021,08055385,CFA MOLLET DEL VALLÈS,08124,081249,MOLLET DEL VALLÈS,6,3,9
2020/2021,08055105,ESCOLA ARRAONA,08187,081878,SABADELL,23,5,28
2020/2021,08055075,CFA TORRE ROMEU,08187,081878,SABADELL,3,3,6
2020/2021,08055063,CFA CANYELLES,08019,080193,BARCELONA,4,2,6
2020/2021,08055051,CFA CASTELLDEFELS,08056,080569,CASTELLDEFELS,5,3,8
2020/2021,08055041,CFA CANOVELLES,08041,080410,CANOVELLES,5,4,9
2020/2021,08055002,CFA BARRI GÒTIC,08019,080193,BARCELONA,5,3,8
2020/2021,08054903,ESCOLA MEDITERRÀNIA,08019,080193,BARCELONA,17,5,22
2020/2021,08054873,INSTITUT JOAQUIMA PLA I FARRERAS,08205,082055,SANT CUGAT DEL VALLÈS,40,18,58
2020/2021,08054824,ESCOLA MESTRE PLA,08051,080517,CASTELLAR DEL VALLÈS,15,0,15
2020/2021,08054411,ESCOLA VALLGORGUINA,08294,082943,VALLGORGUINA,12,2,14
2020/2021,08054401,INSTITUT EL SUI,08046,080462,CARDEDEU,36,14,50
2020/2021,08054368,CEE CA N'ORIOL,08184,081846,RUBÍ,20,1,21
2020/2021,08054344,EOI ESPLUGUES,08077,080771,ESPLUGUES DE LLOBREGAT,13,2,15
2020/2021,08054277,INSTITUT DE TONA,08283,082830,TONA,46,21,67
2020/2021,08054241,INSTITUT EUGENI XAMMAR,08005,080057,L'AMETLLA DEL VALLÈS,27,16,43
2020/2021,08054228,INSTITUT JOAN FUSTER,08019,080193,BARCELONA,35,9,44
2020/2021,08054198,INSTITUT ESTANY DE LA RICARDA,08169,081691,EL PRAT DE LLOBREGAT,29,16,45
2020/2021,08054186,INSTITUT CAN MAS,08180,081803,RIPOLLET,37,15,52
2020/2021,08054174,INSTITUT LA RIBERA,08125,081252,MONTCADA I REIXAC,29,15,44
2020/2021,08054113,ESCOLA ANXANETA,08121,081213,MATARÓ,26,4,30
2020/2021,08054061,ESCOLA MONTBAIG,08200,082009,SANT BOI DE LLOBREGAT,15,4,19
2020/2021,08054058,ESCOLA TORRE DE LA MIRANDA,08073,080734,CORNELLÀ DE LLOBREGAT,34,3,37
2020/2021,08054034,INSTITUT GALLECS,08124,081249,MOLLET DEL VALLÈS,73,39,112
2020/2021,08054022,ESCOLA MARINADA,08019,080193,BARCELONA,17,1,18
2020/2021,08053650,ESCOLA TURÓ DE GUIERA,08266,082665,CERDANYOLA DEL VALLÈS,24,6,30
2020/2021,08053601,ESCOLA LOLA ANGLADA,08114,081141,MARTORELL,30,2,32
2020/2021,08053583,ESCOLA MARIA OSSÓ,08270,082704,SITGES,29,2,31
2020/2021,08053571,INST-ESC ART. ORIOL MARTORELL,08019,080193,BARCELONA,89,46,135
2020/2021,08053522,ESCOLA LA GINESTA,08295,082956,VALLIRANA,13,3,16
2020/2021,08053510,ESCOLA PUIG D'AGULLES,08072,080728,CORBERA DE LLOBREGAT,16,4,20
2020/2021,08053492,ESCOLA TERESA CLARAMUNT,08187,081878,SABADELL,25,4,29
2020/2021,08053467,ESCOLA PALAU,08156,081568,PALAU-SOLITÀ I PLEGAMANS,23,4,27
2020/2021,08053455,ESCOLA LES AIGÜES,08046,080462,CARDEDEU,26,3,29
2020/2021,08053443,EOI SANTA COLOMA,08245,082457,SANTA COLOMA DE GRAMENET,6,7,13
2020/2021,08053431,ESCOLA EL ROURE,08168,081688,PONTONS,3,1,4
2020/2021,08053421,ESCOLA ALOC,08163,081635,PINEDA DE MAR,18,5,23
2020/2021,08053418,ESCOLA EL MORSELL,08148,081483,OLIVELLA,21,2,23
2020/2021,08053406,ESCOLA CAN BESORA,08124,081249,MOLLET DEL VALLÈS,26,2,28
2020/2021,08053391,ESCOLA LLEDONER,08096,080961,GRANOLLERS,22,8,30
2020/2021,08053364,INSTITUT JOSEP MESTRES I BUSQUETS,08301,083015,VILADECANS,39,17,56
2020/2021,08053352,INSTITUT MONTBUI,08250,082508,SANTA MARGARIDA DE MONTBUI,38,25,63
2020/2021,08053340,INSTITUT GABRIELA MISTRAL,08263,082634,SANT VICENÇ DELS HORTS,53,35,88
2020/2021,08053315,INSTITUT MONTSERRAT ROIG,08196,081960,SANT ANDREU DE LA BARCA,34,24,58
2020/2021,08053297,INSTITUT DE PALLEJÀ,08157,081574,PALLEJÀ,32,21,53
2020/2021,08053285,INSTITUT EL CASTELL,08076,080765,ESPARREGUERA,39,31,70
2020/2021,08053261,INSTITUT DE VILADECAVALLS,08300,083008,VILADECAVALLS,41,24,65
2020/2021,08053251,INSTITUT CAVALL BERNAT,08279,082798,TERRASSA,52,28,80
2020/2021,08053248,INSTITUT DE SENTMENAT,08267,082671,SENTMENAT,31,15,46
2020/2021,08053236,INSTITUT ROVIRA-FORNS,08260,082606,SANTA PERPÈTUA DE MOGODA,41,23,64
2020/2021,08053224,INSTITUT LES TERMES,08187,081878,SABADELL,34,13,47
2020/2021,08053212,INSTITUT JONQUERES,08187,081878,SABADELL,37,18,55
2020/2021,08053200,INSTITUT MIQUEL CRUSAFONT I PAIRÓ,08187,081878,SABADELL,30,17,47
2020/2021,08053194,EOI DE TERRASSA,08279,082798,TERRASSA,16,9,25
2020/2021,08053182,INSTITUT LA SERRETA,08184,081846,RUBÍ,58,29,87
2020/2021,08053170,INSTITUT POLINYÀ,08167,081672,POLINYÀ,36,21,57
2020/2021,08053169,INSTITUT MATADEPERA,08120,081206,MATADEPERA,39,22,61
2020/2021,08053157,INSTITUT GORGS,08266,082665,CERDANYOLA DEL VALLÈS,30,18,48
2020/2021,08053145,INSTITUT CASTELLBISBAL,08054,080543,CASTELLBISBAL,39,27,66
2020/2021,08053121,INSTITUT TARADELL,08278,082785,TARADELL,31,21,52
2020/2021,08053111,INSTITUT D'AURO,08192,081923,SANTPEDOR,37,14,51
2020/2021,08053108,INSTITUT REGUISSOL,08259,082592,SANTA MARIA DE PALAUTORDERA,33,15,48
2020/2021,08053091,INSTITUT EL FOIX,08251,082515,SANTA MARGARIDA I ELS MONJOS,40,18,58
2020/2021,08053078,INSTITUT NUMÀNCIA,08245,082457,SANTA COLOMA DE GRAMENET,38,17,55
2020/2021,08053054,INSTITUT GERBERT D'AURILLAC,08213,082135,SANT FRUITÓS DE BAGES,34,11,45
2020/2021,08053042,INSTITUT MIQUEL MARTÍ I POL,08183,081831,RODA DE TER,33,11,44
2020/2021,08053030,INSTITUT DE LA ROCA DEL VALLÈS,08181,081810,LA ROCA DEL VALLÈS,31,17,48
2020/2021,08053029,EOI BADALONA,08015,080155,BADALONA,8,3,11
2020/2021,08053017,INSTITUT VALERIÀ PUJOL I BOSCH,08230,082303,PREMIÀ DE DALT,27,20,47
2020/2021,08053005,INSTITUT CASTELL DE QUER,08171,081712,PRATS DE LLUÇANÈS,21,9,30
2020/2021,08052992,INSTITUT EUCLIDES,08163,081635,PINEDA DE MAR,33,21,54
2020/2021,08052980,INSTITUT MONTMELÓ,08135,081350,MONTMELÓ,36,18,54
2020/2021,08052979,INSTITUT JOSEP PUIG I CADAFALCH,08121,081213,MATARÓ,53,25,78
2020/2021,08052955,INSTITUT DE LLIÇÀ,08107,081075,LLIÇÀ D'AMUNT,39,27,66
2020/2021,08052931,EOI DEL MARESME,08121,081213,MATARÓ,12,1,13
2020/2021,08052921,INSTITUT EUGENI D'ORS,08101,081017,L'HOSPITALET DE LLOBREGAT,32,13,45
2020/2021,08052918,INSTITUT BISBE BERENGUER,08101,081017,L'HOSPITALET DE LLOBREGAT,30,19,49
2020/2021,08052906,INSTITUT LAURO,08086,080863,LES FRANQUESES DEL VALLÈS,49,21,70
2020/2021,08052891,INSTITUT L'ALT BERGUEDÀ,08016,080168,BAGÀ,19,18,37
2020/2021,08052888,INSTITUT JÚLIA MINGUELL,08015,080155,BADALONA,34,23,57
2020/2021,08052876,INSTITUT D'ARGENTONA,08009,080095,ARGENTONA,46,24,70
2020/2021,08052839,INSTITUT CONSELL DE CENT,08019,080193,BARCELONA,28,16,44
2020/2021,08052827,INSTITUT LLUÍS DOMÈNECH I MONTANER,08019,080193,BARCELONA,27,20,47
2020/2021,08052797,INSTITUT SALVADOR ESPRIU,08019,080193,BARCELONA,33,26,59
2020/2021,08052785,ESCOLA VILA OLÍMPICA,08019,080193,BARCELONA,26,4,30
2020/2021,08052761,INSTITUT JOSEP COMAS I SOLÀ,08019,080193,BARCELONA,12,6,18
2020/2021,08052724,INSTITUT FRANCISCO DE GOYA,08019,080193,BARCELONA,28,15,43
2020/2021,08052700,INSTITUT VALL D'HEBRON,08019,080193,BARCELONA,83,40,123
2020/2021,08052670,ESCOLA AURÓ,08019,080193,BARCELONA,33,1,34
2020/2021,08052669,ESCOLA FERRAN SUNYER,08019,080193,BARCELONA,27,5,32
2020/2021,08052657,ESCOLA FORT PIENC,08019,080193,BARCELONA,26,2,28
2020/2021,08052621,ESCOLA PAU ROMEVA,08019,080193,BARCELONA,27,3,30
2020/2021,08052608,INSTITUT PAU CLARIS,08019,080193,BARCELONA,25,12,37
2020/2021,08052581,INSTITUT MIQUEL TARRADELL,08019,080193,BARCELONA,49,12,61
2020/2021,08052207,INSTITUT DE PUIG-REIG,08175,081751,PUIG-REIG,21,16,37
2020/2021,08052165,ESCOLA OCTAVIO PAZ,08019,080193,BARCELONA,13,3,16
2020/2021,08051471,ESCOLA JOSEP MARIA FOLCH I TORRES,08101,081017,L'HOSPITALET DE LLOBREGAT,26,7,33
2020/2021,08051318,ESCOLA SANT LLORENÇ DEL MUNT,08279,082798,TERRASSA,27,3,30
2020/2021,08051306,ESCOLA ABAT MARCET,08279,082798,TERRASSA,28,1,29
2020/2021,08051264,INSTITUT EDUARD FONTSERÈ,08101,081017,L'HOSPITALET DE LLOBREGAT,35,12,47
2020/2021,08051240,ESCOLA MEDITERRÀNIA,08073,080734,CORNELLÀ DE LLOBREGAT,28,2,30
2020/2021,08047832,INSTITUT JOAN COROMINES,08163,081635,PINEDA DE MAR,54,21,75
2020/2021,08047820,INSTITUT GUINOVARDA,08161,081614,PIERA,51,24,75
2020/2021,08047583,INSTITUT SANT QUIRZE DEL VALLÈS,08238,082384,SANT QUIRZE DEL VALLÈS,47,27,74
2020/2021,08047509,INSTITUT ÍTACA,08200,082009,SANT BOI DE LLOBREGAT,29,23,52
2020/2021,08047492,INSTITUT RIBERA BAIXA,08169,081691,EL PRAT DE LLOBREGAT,35,21,56
2020/2021,08047480,INSTITUT MEDITERRÀNIA,08056,080569,CASTELLDEFELS,58,35,93
2020/2021,08047479,INSTITUT ALBA DEL VALLÈS,08209,082093,SANT FOST DE CAMPSENTELLES,42,20,62
2020/2021,08047467,INSTITUT ALEXANDRE GALÍ,08231,082310,SANT PERE DE RIBES,42,18,60
2020/2021,08047431,INSTITUT XXV OLIMPÍADA,08019,080193,BARCELONA,37,20,57
2020/2021,08047421,INSTITUT MONTSERRAT ROIG,08019,080193,BARCELONA,28,16,44
2020/2021,08047376,INSTITUT LLOBREGAT,08191,081918,SALLENT,26,20,46
2020/2021,08047364,INSTITUT JOAN MERCADER,08102,081022,IGUALADA,43,28,71
2020/2021,08046876,INSTITUT MIQUEL BOSCH I JOVER,08010,080109,ARTÉS,30,12,42
2020/2021,08046864,INSTITUT BELLULLA,08041,080410,CANOVELLES,38,18,56
2020/2021,08046852,INSTITUT LLAVANERES,08197,081976,SANT ANDREU DE LLAVANERES,31,16,47
2020/2021,08046840,INSTITUT CASTELLET,08262,082628,SANT VICENÇ DE CASTELLET,45,33,78
2020/2021,08046803,INSTITUT VILATZARA,08219,082191,VILASSAR DE MAR,44,29,73
2020/2021,08046797,INSTITUT LAIA L'ARQUERA,08121,081213,MATARÓ,33,27,60
2020/2021,08046785,INSTITUT D'ALELLA,08003,080039,ALELLA,32,17,49
2020/2021,08046761,INSTITUT GUILLEM CATÀ,08113,081136,MANRESA,60,40,100
2020/2021,08046751,INSTITUT VENTURA GASSOL,08015,080155,BADALONA,31,14,45
2020/2021,08046748,INSTITUT THOS I CODINA,08121,081213,MATARÓ,59,40,99
2020/2021,08046736,INSTITUT MILÀ I FONTANALS,08305,083054,VILAFRANCA DEL PENEDÈS,45,29,74
2020/2021,08046724,INSTITUT MONTSERRAT ROIG,08279,082798,TERRASSA,70,33,103
2020/2021,08046694,INSTITUT CENTRE D'ALT RENDIMENT ESPORTIU,08205,082055,SANT CUGAT DEL VALLÈS,21,31,52
2020/2021,08046682,INSTITUT DE CASTELLAR,08051,080517,CASTELLAR DEL VALLÈS,48,33,81
2020/2021,08046670,INSTITUT ANGELETA FERRER I SENSAT,08205,082055,SANT CUGAT DEL VALLÈS,42,26,68
2020/2021,08046669,INSTITUT RIBOT I SERRA,08187,081878,SABADELL,54,17,71
2020/2021,08046657,INSTITUT JOAQUIM BLUME,08077,080771,ESPLUGUES DE LLOBREGAT,13,13,26
2020/2021,08046645,INSTITUT MOLÍ DE LA VILA,08044,080446,CAPELLADES,36,15,51
2020/2021,08046608,INSTITUT PRÍNCEP DE VIANA,08019,080193,BARCELONA,27,21,48
2020/2021,08046581,INSTITUT LLUÍS VIVES,08019,080193,BARCELONA,24,16,40
2020/2021,08046293,ESCOLA CAVALL BERNAT,08019,080193,BARCELONA,14,4,18
2020/2021,08046281,ESCOLA ESTEL-GUINARDÓ,08019,080193,BARCELONA,12,4,16
2020/2021,08045860,INSTITUT MIRAMAR,08301,083015,VILADECANS,30,22,52
2020/2021,08045859,INSTITUT DE CORBERA DE LLOBREGAT,08072,080728,CORBERA DE LLOBREGAT,27,21,48
2020/2021,08045689,INSTITUT VOLTRERA,08001,080018,ABRERA,38,24,62
2020/2021,08045677,INSTITUT THALASSA,08126,081265,MONTGAT,25,17,42
2020/2021,08045665,INSTITUT RAMON TURRÓ I DARDER,08110,081108,MALGRAT DE MAR,41,28,69
2020/2021,08045653,INSTITUT DOLORS MALLAFRÈ I ROS,08307,083073,VILANOVA I LA GELTRÚ,36,19,55
2020/2021,08045641,INSTITUT LLUÍS DOMÈNECH I MONTANER,08040,080403,CANET DE MAR,45,21,66
2020/2021,08045628,INSTITUT CELESTÍ BELLERA,08096,080961,GRANOLLERS,42,15,57
2020/2021,08045604,INSTITUT ENRIC BORRÀS,08015,080155,BADALONA,47,25,72
2020/2021,08045598,ESCOLA MIL·LENARI,08046,080462,CARDEDEU,28,1,29
2020/2021,08045586,ESCOLA LES PRUNERES,08115,081154,MARTORELLES,14,0,14
2020/2021,08045574,ESCOLA SERRA DE MARINA,08245,082457,SANTA COLOMA DE GRAMENET,23,8,31
2020/2021,08045562,INSTITUT CAN PLANAS,08252,082520,BARBERÀ DEL VALLÈS,36,24,60
2020/2021,08045549,INSTITUT BANÚS,08266,082665,CERDANYOLA DEL VALLÈS,33,21,54
2020/2021,08045537,INSTITUT JOSEP LLUÍS SERT,08056,080569,CASTELLDEFELS,38,25,63
2020/2021,08045525,INSTITUT MANUEL CARRASCO I FORMIGUERA,08019,080193,BARCELONA,23,12,35
2020/2021,08045513,INSTITUT FLOS I CALCAT,08019,080193,BARCELONA,28,13,41
2020/2021,08045483,INSTITUT VILA DE GRÀCIA,08019,080193,BARCELONA,25,10,35
2020/2021,08045471,INSTITUT POMPEU FABRA,08015,080155,BADALONA,40,57,97
2020/2021,08045306,INSTITUT RAMON CASAS I CARBÓ,08156,081568,PALAU-SOLITÀ I PLEGAMANS,40,22,62
2020/2021,08045227,CEE LES AIGÜES,08121,081213,MATARÓ,42,2,44
2020/2021,08045203,INSTITUT OBERT DE CATALUNYA,08019,080193,BARCELONA,72,58,130
2020/2021,08045070,INSTITUT EUROPA,08101,081017,L'HOSPITALET DE LLOBREGAT,22,11,33
2020/2021,08045057,ESCOLA EL SAGRER,08019,080193,BARCELONA,28,1,29
2020/2021,08045045,ESCOLA MEDITERRÀNIA,08163,081635,PINEDA DE MAR,16,2,18
2020/2021,08045033,ESCOLA MONTPALAU,08163,081635,PINEDA DE MAR,12,4,16
2020/2021,08045021,INSTITUT ESTELA IBÈRICA,08260,082606,SANTA PERPÈTUA DE MOGODA,44,25,69
2020/2021,08045011,INSTITUT TORRE DEL PALAU,08279,082798,TERRASSA,42,22,64
2020/2021,08044995,INSTITUT BARRES I ONES,08015,080155,BADALONA,37,23,60
2020/2021,08044983,INSTITUT LLUÍS COMPANYS,08284,082845,TORDERA,28,23,51
2020/2021,08044971,INSTITUT PERE FONTDEVILA,08092,080924,GIRONELLA,22,11,33
2020/2021,08044961,ESCRBC DE CATALUNYA,08019,080193,BARCELONA,16,7,23
2020/2021,08044958,INSTITUT JOSEP PLA,08019,080193,BARCELONA,24,20,44
2020/2021,08044934,INSTITUT ESCOLA D'HOTELERIA I TURISME DE BARCELONA,08019,080193,BARCELONA,52,34,86
2020/2021,08044922,INSTITUT DR. PUIGVERT,08019,080193,BARCELONA,39,25,64
2020/2021,08044910,ESCOLA EL TURONET,08238,082384,SANT QUIRZE DEL VALLÈS,15,1,16
2020/2021,08044715,INSTITUT JAUME MIMÓ,08266,082665,CERDANYOLA DEL VALLÈS,43,39,82
2020/2021,08044648,ESCOLA LA RODA,08279,082798,TERRASSA,25,3,28
2020/2021,08044636,EOI DE SABADELL,08187,081878,SABADELL,17,6,23
2020/2021,08044624,INSTITUT SABADELL,08187,081878,SABADELL,45,35,80
2020/2021,08044612,INSTITUT TORRE DE MALLA,08159,081593,PARETS DEL VALLÈS,42,35,77
2020/2021,08044600,INSTITUT MOIANÈS,08138,081385,MOIÀ,27,20,47
2020/2021,08044594,INSTITUT GIOLA,08106,081069,LLINARS DEL VALLÈS,33,26,59
2020/2021,08044582,EOI DE L'HOSPITALET DE LLOBREGAT,08101,081017,L'HOSPITALET DE LLOBREGAT,20,8,28
2020/2021,08044570,INSTITUT VALL D'ARÚS,08295,082956,VALLIRANA,44,24,68
2020/2021,08044569,INSTITUT PERE BARNILS,08067,080673,CENTELLES,39,20,59
2020/2021,08044545,ESCOLA COLLBAIX,08218,082188,SANT JOAN DE VILATORRADA,11,4,15
2020/2021,08044533,INSTITUT LA FERRERIA,08125,081252,MONTCADA I REIXAC,54,48,102
2020/2021,08044521,ESCOLA ELS PINETONS,08088,080885,LA GARRIGA,25,4,29
2020/2021,08044511,EOI BARCELONA-VALL D'HEBRON,08019,080193,BARCELONA,34,5,39
2020/2021,08044508,ESCOLA ÍTACA,08015,080155,BADALONA,19,1,20
2020/2021,08044454,ESCOLA PILARÍN BAYÉS,08238,082384,SANT QUIRZE DEL VALLÈS,26,3,29
2020/2021,08044442,ESCOLA SANTA ANNA,08230,082303,PREMIÀ DE DALT,28,1,29
2020/2021,08044430,ESCOLA LA GARALDA,08157,081574,PALLEJÀ,30,1,31
2020/2021,08044314,ESCOLA ANDREU CASTELLS,08187,081878,SABADELL,28,3,31
2020/2021,08044302,ESCOLA JOAN ABELLÓ,08124,081249,MOLLET DEL VALLÈS,30,1,31
2020/2021,08044296,ESCOLA SALVADOR ESPRIU,08015,080155,BADALONA,24,4,28
2020/2021,08044247,ESCOLA ESTEL,08123,081234,MOLINS DE REI,15,0,15
2020/2021,08044223,CEE L'ESTEL- CAN BORI,08101,081017,L'HOSPITALET DE LLOBREGAT,23,6,29
2020/2021,08044201,ESCOLA DOVELLA,08019,080193,BARCELONA,14,1,15
2020/2021,08044168,INSTITUT PLA DE LES MORERES,08302,083020,VILANOVA DEL CAMÍ,43,21,64
2020/2021,08044156,EA DEIÀ,08019,080193,BARCELONA,22,17,39
2020/2021,08044120,CFA FREIRE,08019,080193,BARCELONA,5,4,9
2020/2021,08044077,EA JOSEP SERRA I ABELLA,08101,081017,L'HOSPITALET DE LLOBREGAT,27,16,43
2020/2021,08044065,INSTITUT GALILEO GALILEI,08019,080193,BARCELONA,27,18,45
2020/2021,08044053,INSTITUT SALVADOR SEGUÍ,08019,080193,BARCELONA,99,24,123
2020/2021,08044028,CEE HORITZÓ,08163,081635,PINEDA DE MAR,21,6,27
2020/2021,08044016,ESCOLA FLAMA,08213,082135,SANT FRUITÓS DE BAGES,29,2,31
2020/2021,08043981,INSTITUT JOAN RAMON BENAPRÈS,08270,082704,SITGES,47,41,88
2020/2021,08043978,INSTITUT DANIEL BLANXART I PEDRALS,08147,081477,OLESA DE MONTSERRAT,51,42,93
2020/2021,08043966,ESCOLA HEURA,08019,080193,BARCELONA,14,2,16
2020/2021,08043954,ESCOLA RIBATALLADA,08187,081878,SABADELL,11,3,14
2020/2021,08043942,ESCOLA MONTBUI,08033,080333,CALDES DE MONTBUI,27,3,30
2020/2021,08043930,ESCOLA MARINADA,08118,081189,EL MASNOU,12,3,15
2020/2021,08043929,ESCOLA LLEBETX,08307,083073,VILANOVA I LA GELTRÚ,17,3,20
2020/2021,08043917,ESCOLA COSSETÀNIA,08307,083073,VILANOVA I LA GELTRÚ,13,2,15
2020/2021,08043905,ESCOLA EL DOFÍ,08172,081727,PREMIÀ DE MAR,12,3,15
2020/2021,08043899,ESCOLA TÀBER,08019,080193,BARCELONA,29,2,31
2020/2021,08043887,ESCOLA SAGRADA FAMÍLIA,08019,080193,BARCELONA,25,4,29
2020/2021,08043875,ESCOLA PIT-ROIG,08019,080193,BARCELONA,13,2,15
2020/2021,08043863,ESCOLA ORLANDAI,08019,080193,BARCELONA,14,1,15
2020/2021,08043851,ESCOLA NABÍ,08019,080193,BARCELONA,11,4,15
2020/2021,08043841,ESCOLA LAVÍNIA,08019,080193,BARCELONA,13,2,15
2020/2021,08043838,ESCOLA TURÓ DEL CARGOL,08019,080193,BARCELONA,16,1,17
2020/2021,08043814,ESCOLA CARLIT,08019,080193,BARCELONA,14,3,17
2020/2021,08043796,ESCOLA BARRUFET,08019,080193,BARCELONA,25,4,29
2020/2021,08043784,ESCOLA ÀNGELS GARRIGA,08019,080193,BARCELONA,11,4,15
2020/2021,08043760,ESCOLA COLÒNIA GÜELL,08244,082444,SANTA COLOMA DE CERVELLÓ,30,2,32
2020/2021,08043747,ESCOLA BALOO,08019,080193,BARCELONA,13,2,15
2020/2021,08043693,INSTITUT JOAQUIM MIR,08307,083073,VILANOVA I LA GELTRÚ,57,45,102
2020/2021,08043681,INSTITUT MARIANAO,08200,082009,SANT BOI DE LLOBREGAT,43,43,86
2020/2021,08043671,INSTITUT EL PALAU,08196,081960,SANT ANDREU DE LA BARCA,54,49,103
2020/2021,08043668,INSTITUT L'ESTATUT,08184,081846,RUBÍ,41,30,71
2020/2021,08043656,INSTITUT MARINA,08105,081056,LA LLAGOSTA,43,38,81
2020/2021,08043644,INSTITUT CARLES VALLBONA,08096,080961,GRANOLLERS,49,45,94
2020/2021,08043589,INSTITUT SALVADOR DALÍ,08169,081691,EL PRAT DE LLOBREGAT,44,17,61
2020/2021,08043516,INSTITUT SANTA EULÀLIA,08279,082798,TERRASSA,45,63,108
2020/2021,08043504,INSTITUT PERE CALDERS,08266,082665,CERDANYOLA DEL VALLÈS,24,15,39
2020/2021,08043486,INSTITUT MANOLO HUGUÉ,08033,080333,CALDES DE MONTBUI,41,31,72
2020/2021,08043474,ESCOLA L'ESTEL,08019,080193,BARCELONA,14,3,17
2020/2021,08043462,INSTITUT ERNEST LLUCH,08019,080193,BARCELONA,42,18,60
2020/2021,08043437,ESCOLA FONT DE L'ALBA,08279,082798,TERRASSA,20,5,25
2020/2021,08043401,ESCOLA BARRUFET,08200,082009,SANT BOI DE LLOBREGAT,20,3,23
2020/2021,08043395,INSTITUT ALEXANDRE DE RIQUER,08031,080312,CALAF,20,13,33
2020/2021,08043383,ESCOLA NOSTRA LLAR,08187,081878,SABADELL,27,3,30
2020/2021,08043371,ESCOLA LA LIÓ,08172,081727,PREMIÀ DE MAR,13,2,15
2020/2021,08043361,ESCOLA EL TURÓ,08125,081252,MONTCADA I REIXAC,13,3,16
2020/2021,08043346,ESCOLA MONTSERRAT,08076,080765,ESPARREGUERA,14,2,16
2020/2021,08043334,ESCOLA ALEXANDRE GALÍ,08073,080734,CORNELLÀ DE LLOBREGAT,13,3,16
2020/2021,08043310,ESCOLA EDUMAR,08056,080569,CASTELLDEFELS,26,4,30
2020/2021,08043292,ESCOLA TABOR,08019,080193,BARCELONA,25,5,30
2020/2021,08043279,ESCOLA POMPEU FABRA,08019,080193,BARCELONA,11,5,16
2020/2021,08043267,ESCOLA PAU CASALS-GRÀCIA,08019,080193,BARCELONA,25,4,29
2020/2021,08043255,ESCOLA ÍTACA,08019,080193,BARCELONA,25,4,29
2020/2021,08043115,ESCOLA PROVENÇALS,08019,080193,BARCELONA,24,5,29
2020/2021,08043103,ESCOLA ANTONI BALMANYA,08019,080193,BARCELONA,25,4,29
2020/2021,08042895,ESCOLA SCHOLA,08184,081846,RUBÍ,15,0,15
2020/2021,08042883,ESCOLA SANT JOSEP - EL PI,08101,081017,L'HOSPITALET DE LLOBREGAT,12,3,15
2020/2021,08042871,ESCOLA PATUFET SANT JORDI-FRANCESC BATALLÉ I ARA,08101,081017,L'HOSPITALET DE LLOBREGAT,29,1,30
2020/2021,08042861,ESCOLA LOLA ANGLADA,08077,080771,ESPLUGUES DE LLOBREGAT,13,2,15
2020/2021,08042858,CFA ELS TARONGERS,08121,081213,MATARÓ,6,5,11
2020/2021,08042846,CFA CORNELLÀ DE LLOBREGAT,08073,080734,CORNELLÀ DE LLOBREGAT,12,2,14
2020/2021,08042834,ESCOLA CAN PALMER,08301,083015,VILADECANS,20,2,22
2020/2021,08042810,ESCOLA CHARLES DARWIN,08169,081691,EL PRAT DE LLOBREGAT,28,4,32
2020/2021,08042809,ESCOLA GALILEO GALILEI,08169,081691,EL PRAT DE LLOBREGAT,25,3,28
2020/2021,08042792,ESCOLA DAMIÀ MATEU,08106,081069,LLINARS DEL VALLÈS,16,1,17
2020/2021,08042780,ESCOLA JOSEP MARIA JUJOL,08019,080193,BARCELONA,25,5,30
2020/2021,08042342,INSTITUT DE BADIA DEL VALLÈS,08904,089045,BADIA DEL VALLÈS,38,36,74
2020/2021,08042330,INSTITUT SANT RAMON,08047,080478,CARDONA,11,6,17
2020/2021,08042329,ESCOLA ELS XIPRERS,08019,080193,BARCELONA,12,4,16
2020/2021,08042305,ESCOLA JOAN MIRÓ,08019,080193,BARCELONA,27,3,30
2020/2021,08042299,ESCOLA SANT MIQUEL,08073,080734,CORNELLÀ DE LLOBREGAT,22,6,28
2020/2021,08042287,ESCOLA SALVADOR ESPRIU,08096,080961,GRANOLLERS,27,3,30
2020/2021,08042101,INSTITUT MANUEL VÁZQUEZ MONTALBÁN,08194,081944,SANT ADRIÀ DE BESÒS,37,18,55
2020/2021,08042093,INSTITUT VINYES VELLES,08136,081363,MONTORNÈS DEL VALLÈS,37,20,57
2020/2021,08042056,INSTITUT CAN PUIG,08231,082310,SANT PERE DE RIBES,44,27,71
2020/2021,08042044,INSTITUT MIG-MÓN,08274,082747,SÚRIA,35,18,53
2020/2021,08042020,INSTITUT VALLÈS,08187,081878,SABADELL,39,22,61
2020/2021,08042019,INSTITUT BADALONA VII,08015,080155,BADALONA,37,32,69
2020/2021,08041866,INSTITUT EL CALAMOT,08089,080898,GAVÀ,60,49,109
2020/2021,08041751,ESCOLA LA CAIXA,08019,080193,BARCELONA,18,4,22
2020/2021,08041726,ESCOLA ROC BLANC,08300,083008,VILADECAVALLS,18,2,20
2020/2021,08041714,ESCOLA LES BASSEROLES,08269,082690,SEVA,13,2,15
2020/2021,08041696,ESCOLA VAIXELL BURRIAC,08219,082191,VILASSAR DE MAR,27,2,29
2020/2021,08041684,ESCOLA ESPAI 3,08217,082172,SANT JOAN DESPÍ,28,1,29
2020/2021,08041672,ESCOLA CREU ALTA,08187,081878,SABADELL,13,2,15
2020/2021,08041660,ESCOLA PONT DE LA CADENA,08123,081234,MOLINS DE REI,15,1,16
2020/2021,08041659,ESCOLA MESTRES MONTA¦A,08096,080961,GRANOLLERS,25,4,29
2020/2021,08041647,ESCOLA PONENT,08096,080961,GRANOLLERS,28,6,34
2020/2021,08041611,ESCOLA JOANOT ALISANDA,08187,081878,SABADELL,27,1,28
2020/2021,08041601,ESCOLA TORRE DE LA LLEBRE,08184,081846,RUBÍ,14,2,16
2020/2021,08041581,ESCOLA GITANJALI,08015,080155,BADALONA,14,1,15
2020/2021,08041571,ESCOLA ARTUR MARTORELL,08015,080155,BADALONA,15,2,17
2020/2021,08041568,ESCOLA JUNGFRAU,08015,080155,BADALONA,24,7,31
2020/2021,08041556,ESCOLA MONTSENY,08221,082212,SANT JUST DESVERN,17,0,17
2020/2021,08041519,INSTITUT MARTÍ DOT,08211,082114,SANT FELIU DE LLOBREGAT,53,34,87
2020/2021,08041374,INSTITUT LA MALLOLA,08077,080771,ESPLUGUES DE LLOBREGAT,33,13,46
2020/2021,08041246,ESCOLA FRANCESC ALDEA I PÉREZ,08279,082798,TERRASSA,14,2,16
2020/2021,08041234,ESCOLA COLLSEROLA,08205,082055,SANT CUGAT DEL VALLÈS,26,3,29
2020/2021,08041222,ESCOLA CAN CLADELLAS,08156,081568,PALAU-SOLITÀ I PLEGAMANS,26,1,27
2020/2021,08041210,ESCOLA DEL BOSC,08252,082520,BARBERÀ DEL VALLÈS,28,2,30
2020/2021,08041180,ESCOLA ROSSELLÓ PÒRCEL,08245,082457,SANTA COLOMA DE GRAMENET,15,1,16
2020/2021,08041179,ESCOLA MESTRE ENRIC GIBERT I CAMINS,08019,080193,BARCELONA,29,3,32
2020/2021,08041167,ESCOLA JOSEP CARNER,08015,080155,BADALONA,31,3,34
2020/2021,08041131,ESCOLA SANT ANTONI,08263,082634,SANT VICENÇ DELS HORTS,16,1,17
2020/2021,08040849,INSTITUT FORT PIUS,08019,080193,BARCELONA,27,16,43
2020/2021,08040618,ESCOLA CAN VIDALET,08077,080771,ESPLUGUES DE LLOBREGAT,13,3,16
2020/2021,08040564,INSTITUT JAUME ALMERA,08214,082140,VILASSAR DE DALT,28,18,46
2020/2021,08040552,INSTITUT ANTONI POUS I ARGILA,08112,081120,MANLLEU,55,22,77
2020/2021,08040540,INSTITUT EL CAIRAT,08076,080765,ESPARREGUERA,45,17,62
2020/2021,08040539,INSTITUT LES MARINES,08056,080569,CASTELLDEFELS,39,13,52
2020/2021,08040527,INSTITUT LA LLAUNA,08015,080155,BADALONA,31,26,57
2020/2021,08040412,ESCOLA EL MARGALLÓ,08307,083073,VILANOVA I LA GELTRÚ,17,5,22
2020/2021,08040400,ESCOLA AMADEU VIVES,08187,081878,SABADELL,24,6,30
2020/2021,08040382,ESCOLA MERCÈ RODOREDA,08245,082457,SANTA COLOMA DE GRAMENET,29,6,35
2020/2021,08040357,CEE FOLCH I CAMARASA,08019,080193,BARCELONA,9,0,9
2020/2021,08040345,ESCOLA MERCÈ RODOREDA,08015,080155,BADALONA,13,2,15
2020/2021,08040333,ESCOLA BERNAT METGE,08169,081691,EL PRAT DE LLOBREGAT,15,1,16
2020/2021,08040141,INSTITUT ICÀRIA,08019,080193,BARCELONA,45,17,62
2020/2021,08040138,INSTITUT LA SEDETA,08019,080193,BARCELONA,20,15,35
2020/2021,08040060,ESCOLA DEL MAR,08219,082191,VILASSAR DE MAR,27,3,30
2020/2021,08040059,ESCOLA JOAN SALVAT I PAPASSEIT,08245,082457,SANTA COLOMA DE GRAMENET,30,2,32
2020/2021,08040047,CEE JOSEP SOL I RODRÍGUEZ,08245,082457,SANTA COLOMA DE GRAMENET,30,6,36
2020/2021,08039896,ESCOLA BELLATERRA,08266,082665,CERDANYOLA DEL VALLÈS,30,1,31
2020/2021,08039835,ESCOLA DE LES AIGÜES,08019,080193,BARCELONA,26,6,32
2020/2021,08039744,ESCOLA DEL PONT TRENCAT - ZER BAIX MONTSENY,08259,082592,SANTA MARIA DE PALAUTORDERA,6,0,6
2020/2021,08039719,ESCOLA LES PLANES,08105,081056,LA LLAGOSTA,25,3,28
2020/2021,08039707,ESCOLA TAGAMANENT,08088,080885,LA GARRIGA,12,3,15
2020/2021,08039690,ESCOLA GERMANS CORBELLA,08046,080462,CARDEDEU,24,3,27
2020/2021,08039677,ESCOLA CONGOST,08041,080410,CANOVELLES,31,6,37
2020/2021,08039665,ESCOLA LANASPA-GIRALT,08279,082798,TERRASSA,16,1,17
2020/2021,08039653,ESCOLA AGUSTÍ BARTRA,08279,082798,TERRASSA,27,5,32
2020/2021,08039641,ESCOLA PABLO PICASSO,08252,082520,BARBERÀ DEL VALLÈS,24,1,25
2020/2021,08039631,ESCOLA L'AGULLOLA,08901,089019,RUPIT I PRUIT,3,0,3
2020/2021,08039628,ESCOLA POMPEU FABRA,08112,081120,MANLLEU,33,5,38
2020/2021,08039616,ESCOLA CAMÍ DEL CROS,08121,081213,MATARÓ,28,2,30
2020/2021,08039604,ESCOLA FRANCESC FERRER I GUÀRDIA,08118,081189,EL MASNOU,13,3,16
2020/2021,08039598,ESCOLA SANT MIQUEL DEL CROS,08009,080095,ARGENTONA,13,1,14
2020/2021,08039586,ESCOLA L'ARJAU,08307,083073,VILANOVA I LA GELTRÚ,25,6,31
2020/2021,08039574,ESCOLA PAU SANS,08101,081017,L'HOSPITALET DE LLOBREGAT,13,2,15
2020/2021,08039562,ESCOLA PRAT DE LA MANTA,08101,081017,L'HOSPITALET DE LLOBREGAT,15,2,17
2020/2021,08039537,ESCOLA TORRENT D'EN MELIS,08019,080193,BARCELONA,24,4,28
2020/2021,08039525,ESCOLA LA SEDETA,08019,080193,BARCELONA,12,3,15
2020/2021,08039513,ESCOLA TAXONERA,08019,080193,BARCELONA,29,7,36
2020/2021,08039495,ESCOLA LA PALMERA,08019,080193,BARCELONA,27,4,31
2020/2021,08039483,ESCOLA ELS HORTS,08019,080193,BARCELONA,17,0,17
2020/2021,08039471,ESCOLA MERCÈ RODOREDA,08019,080193,BARCELONA,24,5,29
2020/2021,08039434,ESCOLA DOCTOR FERRAN I CLUA,08019,080193,BARCELONA,27,4,31
2020/2021,08039380,ESCOLA GERMANS AMAT I TARGA,08301,083015,VILADECANS,25,4,29
2020/2021,08039379,ESCOLA RAFAEL CASANOVA,08200,082009,SANT BOI DE LLOBREGAT,19,7,26
2020/2021,08039367,ESCOLA JOSEP PLA,08196,081960,SANT ANDREU DE LA BARCA,26,3,29
2020/2021,08039355,ESCOLA RAMON LLULL,08169,081691,EL PRAT DE LLOBREGAT,24,3,27
2020/2021,08039343,ESCOLA JOSEP FERRÀ I ESTEVA,08147,081477,OLESA DE MONTSERRAT,26,4,30
2020/2021,08039318,ESCOLA PUIGBERENGUER,08113,081136,MANRESA,29,2,31
2020/2021,08039306,ESCOLA ELS PINS - ZER EL MOIANÈS PONENT,08191,081918,SALLENT,4,1,5
2020/2021,08039291,ESCOLA CRISTÒFOR MESTRE,08305,083054,VILAFRANCA DEL PENEDÈS,22,8,30
2020/2021,08039288,ESCOLA RENAIXENÇA,08122,081228,MEDIONA,4,4,8
2020/2021,08039264,ESCOLA MESTRES MUNGUET-CORTÉS,08902,089024,VILANOVA DEL VALLÈS,26,2,28
2020/2021,08039203,INSTITUT AGUSTÍ SERRA I FONTANET,08187,081878,SABADELL,67,59,126
2020/2021,08039069,INSTITUT MARGARIDA XIRGU,08101,081017,L'HOSPITALET DE LLOBREGAT,40,17,57
2020/2021,08039057,INSTITUT L'ALZINA,08019,080193,BARCELONA,30,14,44
2020/2021,08038582,ESCOLA CATALUNYA,08187,081878,SABADELL,31,1,32
2020/2021,08038570,EOI DE BARCELONA,08019,080193,BARCELONA,78,21,99
2020/2021,08038351,ESCOLA XARAU,08266,082665,CERDANYOLA DEL VALLÈS,13,4,17
2020/2021,08038326,ESCOLA EL VALLÈS,08279,082798,TERRASSA,23,3,26
2020/2021,08038314,ESCOLA MARE DE DÉU DE MONTSERRAT,08279,082798,TERRASSA,18,1,19
2020/2021,08038284,ESCOLA LA GUÀRDIA,08263,082634,SANT VICENÇ DELS HORTS,14,4,18
2020/2021,08038272,ESCOLA GARCÍA LORCA,08250,082508,SANTA MARGARIDA DE MONTBUI,28,6,34
2020/2021,08038260,ESCOLA JOAN MARAGALL,08205,082055,SANT CUGAT DEL VALLÈS,27,3,30
2020/2021,08038259,ESCOLA ANTONI TÀPIES,08200,082009,SANT BOI DE LLOBREGAT,25,3,28
2020/2021,08038247,ESCOLA POMPEU FABRA,08302,083020,VILANOVA DEL CAMÍ,21,5,26
2020/2021,08038223,ESCOLA BENVIURE,08200,082009,SANT BOI DE LLOBREGAT,23,6,29
2020/2021,08038211,ESCOLA JOSÉ JUAN ORTIZ,08196,081960,SANT ANDREU DE LA BARCA,24,4,28
2020/2021,08038201,ESCOLA LA BAUMETA - ZER ELS CASTELLS,08253,082536,SANTA MARIA DE BESORA,2,0,2
2020/2021,08038181,ESCOLA SERRA I HÚNTER,08113,081136,MANRESA,30,7,37
2020/2021,08038171,ESCOLA MONTESSORI,08184,081846,RUBÍ,25,5,30
2020/2021,08038168,ESCOLA LA TORRETA,08181,081810,LA ROCA DEL VALLÈS,14,3,17
2020/2021,08038156,ESCOLA ESCURSELL I BARTALOT,08180,081803,RIPOLLET,27,2,29
2020/2021,08038090,ESCOLA SANT JAUME,08169,081691,EL PRAT DE LLOBREGAT,24,7,31
2020/2021,08038089,ESCOLA SANT ESTEVE - ZER EL CARDENER,08229,082299,SANT MATEU DE BAGES,4,1,5
2020/2021,08038077,ESCOLA CAN PARERA,08136,081363,MONTORNÈS DEL VALLÈS,21,4,25
2020/2021,08038065,ESCOLA MONTSENY,08124,081249,MOLLET DEL VALLÈS,24,4,28
2020/2021,08038041,ESCOLA FEDERICO GARCÍA LORCA,08124,081249,MOLLET DEL VALLÈS,8,2,10
2020/2021,08038031,ESCOLA ROSA SENSAT,08118,081189,EL MASNOU,14,2,16
2020/2021,08038004,ESCOLA JOSEP JANÉS,08101,081017,L'HOSPITALET DE LLOBREGAT,27,6,33
2020/2021,08037991,ESCOLA MARCEL·LÍ MORAGAS,08089,080898,GAVÀ,25,2,27
2020/2021,08037981,ESCOLA DE L'ESTANY - ZER EL MOIANÈS LLEVANT,08079,080790,L'ESTANY,2,3,5
2020/2021,08037978,ESCOLA SURIS,08073,080734,CORNELLÀ DE LLOBREGAT,28,3,31
2020/2021,08037966,ESCOLA IGNASI IGLÉSIAS,08073,080734,CORNELLÀ DE LLOBREGAT,27,3,30
2020/2021,08037930,ESCOLA MARGALLÓ,08056,080569,CASTELLDEFELS,26,3,29
2020/2021,08037929,ESCOLA TORRE BARONA,08056,080569,CASTELLDEFELS,25,3,28
2020/2021,08037917,ESCOLA JOAN MIRÓ,08041,080410,CANOVELLES,13,4,17
2020/2021,08037899,ESCOLA FOLCH I TORRES,08015,080155,BADALONA,15,3,18
2020/2021,08037887,ESCOLA BALDIRI REIXAC,08015,080155,BADALONA,18,7,25
2020/2021,08037875,ESCOLA RAFAEL CASANOVA,08015,080155,BADALONA,27,3,30
2020/2021,08037863,ESCOLA SEAT,08019,080193,BARCELONA,29,2,31
2020/2021,08037841,ESCOLA SPLAI,08019,080193,BARCELONA,15,1,16
2020/2021,08037814,ESCOLA ALEXANDRE GALÍ,08019,080193,BARCELONA,24,2,26
2020/2021,08037528,ESCOLA SANT DOMÈNEC,08251,082515,SANTA MARGARIDA I ELS MONJOS,13,2,15
2020/2021,08037504,ESCOLA MONTNEGRE,08202,082021,SANT CELONI,13,1,14
2020/2021,08037292,CEE CENTRE DE FORMACIÓ I TREBALL FLOR DE MAIG,08266,082665,CERDANYOLA DEL VALLÈS,16,6,22
2020/2021,08037206,INSTITUT LLUÍS COMPANYS,08180,081803,RIPOLLET,42,27,69
2020/2021,08037176,INSTITUT LA BASTIDA,08245,082457,SANTA COLOMA DE GRAMENET,60,28,88
2020/2021,08037152,INSTITUT JOAN ORÓ,08114,081141,MARTORELL,71,50,121
2020/2021,08036411,ESCOLA SALTELLS,08266,082665,CERDANYOLA DEL VALLÈS,22,3,25
2020/2021,08036391,INSTITUT ARQUITECTE MANUEL RASPALL,08046,080462,CARDEDEU,37,14,51
2020/2021,08036378,ESCOLA CHARLIE RIVEL,08101,081017,L'HOSPITALET DE LLOBREGAT,14,6,20
2020/2021,08036366,ESCOLA LOLA ANGLADA,08101,081017,L'HOSPITALET DE LLOBREGAT,17,4,21
2020/2021,08036342,ESCOLA JOAN LLONGUERAS,08015,080155,BADALONA,15,4,19
2020/2021,08036330,INSTITUT J.V. FOIX,08184,081846,RUBÍ,25,27,52
2020/2021,08036147,ESCOLA PAU PICASSO,08015,080155,BADALONA,19,8,27
2020/2021,08036135,ESCOLA JOAN CORET,08015,080155,BADALONA,22,5,27
2020/2021,08036111,ESCOLA MAS I PERERA,08305,083054,VILAFRANCA DEL PENEDÈS,25,6,31
2020/2021,08036101,ESCOLA SAGRADA FAMÍLIA,08245,082457,SANTA COLOMA DE GRAMENET,25,2,27
2020/2021,08036056,ESCOLA FOLCH I TORRES,08077,080771,ESPLUGUES DE LLOBREGAT,27,3,30
2020/2021,08036044,ESCOLA PAU VILA,08076,080765,ESPARREGUERA,25,4,29
2020/2021,08036007,ESCOLA PAU VILA,08211,082114,SANT FELIU DE LLOBREGAT,16,3,19
2020/2021,08035994,ESCOLA SALVADOR ESPRIU,08211,082114,SANT FELIU DE LLOBREGAT,24,4,28
2020/2021,08035969,ESCOLA JOAQUIM BLUME,08187,081878,SABADELL,22,4,26
2020/2021,08035957,ESCOLA CAN DEU,08187,081878,SABADELL,13,3,16
2020/2021,08035945,ESCOLA LA CARPA,08101,081017,L'HOSPITALET DE LLOBREGAT,42,6,48
2020/2021,08035881,ESCOLA L'ARENY,08073,080734,CORNELLÀ DE LLOBREGAT,26,4,30
2020/2021,08035878,ESCOLA PERE DE TERA,08015,080155,BADALONA,25,5,30
2020/2021,08035854,ESCOLA LLORENS I ARTIGAS,08015,080155,BADALONA,27,1,28
2020/2021,08035696,ESCOLA SANT JULIÀ,08187,081878,SABADELL,20,3,23
2020/2021,08035684,ESCOLA MARIÀ MANENT,08230,082303,PREMIÀ DE DALT,25,5,30
2020/2021,08035623,CEE JERONI DE MORAGAS,08266,082665,CERDANYOLA DEL VALLÈS,18,1,19
2020/2021,08035544,CEE JOSEP PLA,08019,080193,BARCELONA,10,2,12
2020/2021,08035519,ESCOLA ANTONI GAUDÍ,08245,082457,SANTA COLOMA DE GRAMENET,32,4,36
2020/2021,08035477,ESCOLA SANTIAGO RUSI¦OL,08019,080193,BARCELONA,28,3,31
2020/2021,08035465,ESCOLA MARE NOSTRUM,08019,080193,BARCELONA,26,1,27
2020/2021,08035453,ESCOLA TOMÀS MORO,08019,080193,BARCELONA,15,2,17
2020/2021,08035441,ESCOLA CATALÒNIA,08019,080193,BARCELONA,23,6,29
2020/2021,08035431,ESCOLA BOGATELL,08019,080193,BARCELONA,26,2,28
2020/2021,08035428,ESCOLA LA FARIGOLA DEL CLOT,08019,080193,BARCELONA,25,5,30
2020/2021,08035416,ESCOLA JOSEP BOADA,08015,080155,BADALONA,33,4,37
2020/2021,08035404,ESCOLA JOAN MIRÓ,08015,080155,BADALONA,15,4,19
2020/2021,08035398,ESCOLA MIGUEL HERNÁNDEZ,08015,080155,BADALONA,15,4,19
2020/2021,08035362,INSTITUT ALT PENEDÈS,08305,083054,VILAFRANCA DEL PENEDÈS,48,37,85
2020/2021,08035350,ESCOLA SANT JOSEP,08263,082634,SANT VICENÇ DELS HORTS,27,2,29
2020/2021,08035349,INSTITUT LA ROMÀNICA,08252,082520,BARBERÀ DEL VALLÈS,62,30,92
2020/2021,08035325,INSTITUT TORRENT DE LES BRUIXES,08245,082457,SANTA COLOMA DE GRAMENET,32,21,53
2020/2021,08035313,INSTITUT QUERCUS,08218,082188,SANT JOAN DE VILATORRADA,46,24,70
2020/2021,08035301,INSTITUT DUC DE MONTBLANC,08184,081846,RUBÍ,47,24,71
2020/2021,08035295,INSTITUT PALAU AUSIT,08180,081803,RIPOLLET,42,52,94
2020/2021,08035283,ESCOLA REIXAC,08125,081252,MONTCADA I REIXAC,29,1,30
2020/2021,08035258,INSTITUT APEL·LES MESTRES,08101,081017,L'HOSPITALET DE LLOBREGAT,25,27,52
2020/2021,08035246,INSTITUT GELIDA,08091,080919,GELIDA,21,23,44
2020/2021,08035234,INSTITUT VIL·LA ROMANA,08088,080885,LA GARRIGA,34,19,53
2020/2021,08035222,INSTITUT MANUEL BLANCAFORT,08088,080885,LA GARRIGA,36,15,51
2020/2021,08035209,INSTITUT PABLO R. PICASSO,08019,080193,BARCELONA,29,20,49
2020/2021,08035167,INSTITUT BARCELONA-CONGRÉS,08019,080193,BARCELONA,33,13,46
2020/2021,08035155,INSTITUT ELS TRES TURONS,08006,080060,ARENYS DE MAR,40,24,64
2020/2021,08035143,INSTITUT MIQUEL MARTÍ I POL,08073,080734,CORNELLÀ DE LLOBREGAT,63,42,105
2020/2021,08035003,EA DE VIC,08298,082981,VIC,23,23,46
2020/2021,08034990,ESCOLA PARELLADA,08200,082009,SANT BOI DE LLOBREGAT,21,6,27
2020/2021,08034989,ESCOLA CATALUNYA,08194,081944,SANT ADRIÀ DE BESÒS,28,2,30
2020/2021,08034965,ESCOLA MARGARIDA XIRGU,08015,080155,BADALONA,33,1,34
2020/2021,08034904,ESCOLA EMILI CARLES I TOLRÀ,08051,080517,CASTELLAR DEL VALLÈS,12,3,15
2020/2021,08034862,ESCOLA AUSIÀS MARCH,08101,081017,L'HOSPITALET DE LLOBREGAT,16,2,18
2020/2021,08034850,ESCOLA PAU CASALS,08101,081017,L'HOSPITALET DE LLOBREGAT,31,5,36
2020/2021,08034837,ESCOLA BERNAT DESCLOT,08101,081017,L'HOSPITALET DE LLOBREGAT,16,1,17
2020/2021,08034795,ESCOLA HEUROM - ZER ALT LLUÇANÈS,08160,081607,PERAFITA,4,1,5
2020/2021,08034783,ESCOLA ELVIRA CUYÀS,08125,081252,MONTCADA I REIXAC,25,4,29
2020/2021,08034746,ESCOLA ROCAFONDA,08121,081213,MATARÓ,33,2,35
2020/2021,08034734,ESCOLA CAMÍ DEL MIG,08121,081213,MATARÓ,27,4,31
2020/2021,08034667,ESCOLA ESTEVE BARRACHINA,08270,082704,SITGES,28,3,31
2020/2021,08034643,INSTITUT LES VINYES,08245,082457,SANTA COLOMA DE GRAMENET,53,33,86
2020/2021,08034621,INSTITUT DE SALES,08301,083015,VILADECANS,56,29,85
2020/2021,08034606,INSTITUT BAIX MONTSENY,08202,082021,SANT CELONI,49,25,74
2020/2021,08034591,INSTITUT JOAN OLIVER,08187,081878,SABADELL,34,15,49
2020/2021,08034576,INSTITUT JOAN SALVAT I PAPASSEIT,08019,080193,BARCELONA,18,12,30
2020/2021,08034564,INSTITUT LES CORTS,08019,080193,BARCELONA,42,17,59
2020/2021,08034527,ESCOLA RAMON MUNTANER,08101,081017,L'HOSPITALET DE LLOBREGAT,15,1,16
2020/2021,08034497,ESCOLA L'ARAGAI,08307,083073,VILANOVA I LA GELTRÚ,18,2,20
2020/2021,08034485,ESCOLA JOAN MARQUÈS I CASALS,08279,082798,TERRASSA,24,7,31
2020/2021,08034461,ESCOLA BERNAT DE MOGODA,08260,082606,SANTA PERPÈTUA DE MOGODA,21,3,24
2020/2021,08034448,ESCOLA SANTA EULÀLIA,08231,082310,SANT PERE DE RIBES,22,5,27
2020/2021,08034412,ESCOLA CAN MASSALLERA,08200,082009,SANT BOI DE LLOBREGAT,14,3,17
2020/2021,08034400,ESCOLA ANTONI GAUDÍ,08200,082009,SANT BOI DE LLOBREGAT,16,1,17
2020/2021,08034382,ESCOLA RAMON LLULL,08184,081846,RUBÍ,24,5,29
2020/2021,08034357,ESCOLA VISTA ALEGRE,08121,081213,MATARÓ,13,2,15
2020/2021,08034333,ESCOLA LA LLÀNTIA,08121,081213,MATARÓ,25,5,30
2020/2021,08034321,ESCOLA TORRE LLAUDER,08121,081213,MATARÓ,20,3,23
2020/2021,08034278,ESCOLA VICENTE ALEIXANDRE,08114,081141,MARTORELL,24,3,27
2020/2021,08034266,ESCOLA JOAN MARAGALL,08101,081017,L'HOSPITALET DE LLOBREGAT,15,1,16
2020/2021,08034242,ESCOLA PABLO NERUDA,08101,081017,L'HOSPITALET DE LLOBREGAT,16,2,18
2020/2021,08034229,ESCOLA BONAVISTA,08051,080517,CASTELLAR DEL VALLÈS,13,2,15
2020/2021,08034217,INSTITUT BERNAT EL FERRER,08123,081234,MOLINS DE REI,57,44,101
2020/2021,08034205,INSTITUT LA GUINEUETA,08019,080193,BARCELONA,62,62,124
2020/2021,08034187,INSTITUT DOMÈNEC PERRAMON,08007,080076,ARENYS DE MUNT,23,18,41
2020/2021,08034138,INSTITUT POBLENOU,08019,080193,BARCELONA,33,28,61
2020/2021,08034126,ESCOLA PAU BOADA,08305,083054,VILAFRANCA DEL PENEDÈS,19,6,25
2020/2021,08034102,ESCOLA JOSEP MARIA MADORELL,08123,081234,MOLINS DE REI,18,2,20
2020/2021,08034096,ESCOLA ANTONI GAUDÍ,08056,080569,CASTELLDEFELS,24,6,30
2020/2021,08034084,ESCOLA CAN ROCA,08056,080569,CASTELLDEFELS,27,2,29
2020/2021,08034060,ESCOLA MOSSÈN CINTO VERDAGUER,08184,081846,RUBÍ,26,7,33
2020/2021,08034059,INSTITUT NICOLAU COPÈRNIC,08279,082798,TERRASSA,31,42,73
2020/2021,08034035,INSTITUT FEDERICA MONTSENY,08904,089045,BADIA DEL VALLÈS,28,17,45
2020/2021,08034011,INSTITUT FREDERIC MOMPOU,08263,082634,SANT VICENÇ DELS HORTS,39,19,58
2020/2021,08034001,INSTITUT TERRA ROJA,08245,082457,SANTA COLOMA DE GRAMENET,45,13,58
2020/2021,08033997,ESCOLA PRIMAVERA,08245,082457,SANTA COLOMA DE GRAMENET,14,2,16
2020/2021,08033985,INSTITUT DE SANT JUST DESVERN,08221,082212,SANT JUST DESVERN,36,19,55
2020/2021,08033973,INSTITUT JAUME SALVADOR I PEDROL,08217,082172,SANT JOAN DESPÍ,38,27,65
2020/2021,08033961,INSTITUT RAFAEL CASANOVA,08200,082009,SANT BOI DE LLOBREGAT,43,25,68
2020/2021,08033948,ESCOLA ENRIC TATCHÉ I POL,08180,081803,RIPOLLET,26,5,31
2020/2021,08033924,INSTITUT PIUS FONT I QUER,08113,081136,MANRESA,34,27,61
2020/2021,08033912,INSTITUT MERCÈ RODOREDA,08101,081017,L'HOSPITALET DE LLOBREGAT,40,24,64
2020/2021,08033900,INSTITUT JOAN MIRÓ,08073,080734,CORNELLÀ DE LLOBREGAT,35,16,51
2020/2021,08033894,INSTITUT TERESA PÀMIES,08019,080193,BARCELONA,28,19,47
2020/2021,08033882,INSTITUT JOAN COROMINES,08019,080193,BARCELONA,20,14,34
2020/2021,08033869,INSTITUT PAU CASALS,08015,080155,BADALONA,30,25,55
2020/2021,08033602,ESCOLA CAN SERRA,08252,082520,BARBERÀ DEL VALLÈS,25,3,28
2020/2021,08033560,ESCOLA MÀRIUS TORRES,08101,081017,L'HOSPITALET DE LLOBREGAT,30,7,37
2020/2021,08033535,ESCOLA JOAN MARAGALL,08077,080771,ESPLUGUES DE LLOBREGAT,30,1,31
2020/2021,08033523,ESCOLA LA MUNTANYETA,08019,080193,BARCELONA,12,3,15
2020/2021,08033501,ESCOLA ANTONI BRUSI,08019,080193,BARCELONA,25,5,30
2020/2021,08033468,ESCOLA LA SALUT,08069,080692,COLLBATÓ,18,3,21
2020/2021,08033407,ESCOLA PURIFICACIÓ SALAS I XANDRI,08238,082384,SANT QUIRZE DEL VALLÈS,14,3,17
2020/2021,08033341,ESCOLA BANÚS,08245,082457,SANTA COLOMA DE GRAMENET,14,3,17
2020/2021,08032762,ESCOLA DOCTOR TRUETA,08301,083015,VILADECANS,27,2,29
2020/2021,08032750,ESCOLA PAU CASALS,08301,083015,VILADECANS,28,2,30
2020/2021,08032737,ESCOLA CAN RULL,08187,081878,SABADELL,23,5,28
2020/2021,08032725,ESCOLA HONORABLE JOSEP TARRADELLAS,08169,081691,EL PRAT DE LLOBREGAT,28,4,32
2020/2021,08032713,ESCOLA SANT JORDI,08124,081249,MOLLET DEL VALLÈS,22,4,26
2020/2021,08032701,ESCOLA LLUÍS MILLET,08118,081189,EL MASNOU,27,3,30
2020/2021,08032658,ESCOLA L'ERAMPRUNYÀ,08089,080898,GAVÀ,27,3,30
2020/2021,08032634,ESCOLA FERRER I GUÀRDIA,08019,080193,BARCELONA,31,6,37
2020/2021,08032592,ESCOLA SANT JORDI,08264,082649,SANT VICENÇ DE MONTALT,16,0,16
2020/2021,08032580,ESCOLA CANIGÓ,08221,082212,SANT JUST DESVERN,27,3,30
2020/2021,08032521,ESCOLA VALL DE PALAU,08196,081960,SANT ANDREU DE LA BARCA,28,1,29
2020/2021,08032491,ESCOLA SANT VICENÇ,08124,081249,MOLLET DEL VALLÈS,25,5,30
2020/2021,08032476,ESCOLA PRAT DE LA RIBA,08077,080771,ESPLUGUES DE LLOBREGAT,14,2,16
2020/2021,08032351,ESCOLA PAU CASALS,08184,081846,RUBÍ,27,4,31
2020/2021,08032348,ESCOLA 25 DE SETEMBRE,08184,081846,RUBÍ,36,8,44
2020/2021,08032312,ESCOLA MIGUEL DE UNAMUNO,08245,082457,SANTA COLOMA DE GRAMENET,28,5,33
2020/2021,08032300,ESCOLA FRAY LUIS DE LEÓN,08245,082457,SANTA COLOMA DE GRAMENET,28,4,32
2020/2021,08031873,INSTITUT ARNAU CADELL,08205,082055,SANT CUGAT DEL VALLÈS,32,28,60
2020/2021,08031861,INSTITUT LEONARDO DA VINCI,08205,082055,SANT CUGAT DEL VALLÈS,49,18,67
2020/2021,08031836,INSTITUT ILLA DELS BANYOLS,08169,081691,EL PRAT DE LLOBREGAT,12,43,55
2020/2021,08031812,INSTITUT VALLDEMOSSA,08019,080193,BARCELONA,29,16,45
2020/2021,08031800,ESCOLA PAU CASALS,08019,080193,BARCELONA,12,6,18
2020/2021,08031794,ESCOLA PALMA DE MALLORCA,08019,080193,BARCELONA,20,0,20
2020/2021,08031770,INSTITUT CAN JOFRESA,08279,082798,TERRASSA,41,16,57
2020/2021,08031757,INSTITUT FORAT DEL VENT,08266,082665,CERDANYOLA DEL VALLÈS,38,26,64
2020/2021,08031711,INSTITUT MANUEL DE CABANYES,08307,083073,VILANOVA I LA GELTRÚ,49,29,78
2020/2021,08031681,INSTITUT FRANCESC XAVIER LLUCH I RAFECAS,08307,083073,VILANOVA I LA GELTRÚ,46,45,91
2020/2021,08031666,ESCOLA CANIGÓ,08307,083073,VILANOVA I LA GELTRÚ,23,4,27
2020/2021,08031484,ESCOLA GINESTA,08307,083073,VILANOVA I LA GELTRÚ,27,6,33
2020/2021,08031472,ESCOLA POMPEU FABRA,08307,083073,VILANOVA I LA GELTRÚ,25,4,29
2020/2021,08031460,ESCOLA TRENTAPASSES,08306,083067,VILALBA SASSERRA,14,1,15
2020/2021,08031459,INSTITUT EUGENI D'ORS,08305,083054,VILAFRANCA DEL PENEDÈS,56,45,101
2020/2021,08031332,ESCOLA JOSEP BALTÀ I ELIAS,08305,083054,VILAFRANCA DEL PENEDÈS,27,4,31
2020/2021,08031320,ESCOLA ESTALELLA I GRAELLS,08305,083054,VILAFRANCA DEL PENEDÈS,28,2,30
2020/2021,08031319,ESCOLA LLEBEIG,08304,083041,VILOBÍ DEL PENEDÈS,12,3,15
2020/2021,08031290,ESCOLA LES ROQUES,08303,083036,VILANOVA DE SAU,5,0,5
2020/2021,08031277,ESCOLA JOAN MARAGALL,08302,083020,VILANOVA DEL CAMÍ,30,3,33
2020/2021,08031228,INSTITUT TORRE ROJA,08301,083015,VILADECANS,59,38,97
2020/2021,08031204,ESCOLA EL GARROFER,08301,083015,VILADECANS,27,3,30
2020/2021,08031101,ESCOLA MONTSERRATINA,08301,083015,VILADECANS,27,3,30
2020/2021,08031083,ESCOLA ÀNGELA ROCA,08301,083015,VILADECANS,22,1,23
2020/2021,08031061,ESCOLA ROSELLA,08300,083008,VILADECAVALLS,27,3,30
2020/2021,08031046,ESCOLA SERRA DE PICAMILL - ZER BERGUEDÀ CENTRE,08299,082994,VILADA,4,0,4
2020/2021,08031034,INSTITUT JAUME CALLÍS,08298,082981,VIC,44,16,60
2020/2021,08031022,INSTITUT DE VIC,08298,082981,VIC,77,67,144
2020/2021,08031009,ESCOLA DOCTOR JOAQUIM SALARICH,08298,082981,VIC,34,4,38
2020/2021,08030819,ESCOLA SENTFORES,08298,082981,VIC,17,0,17
2020/2021,08030789,ESCOLA POMPEU FABRA,08295,082956,VALLIRANA,16,2,18
2020/2021,08030728,ESCOLA SERRAT VOLTOR - ZER ALT BERGUEDÀ,08293,082938,VALLCEBRE,2,0,2
2020/2021,08030698,ESCOLA JOSEP MASCLANS,08292,082922,VALLBONA D'ANOIA,11,3,14
2020/2021,08030686,ESCOLA PAU CASALS,08291,082917,VACARISSES,23,3,26
2020/2021,08030662,ESCOLA SERRALAVELLA,08290,082900,ULLASTRELL,17,4,21
2020/2021,08030649,ESCOLA SANT MARTÍ,08289,082896,TORRELLES DE LLOBREGAT,22,2,24
2020/2021,08030637,ESCOLA GUERAU DE PEGUERA,08288,082883,TORRELLES DE FOIX,14,2,16
2020/2021,08030613,ESCOLA J.J. RÀFOLS,08287,082877,TORRELAVIT,11,3,14
2020/2021,08030595,ESCOLA TORRESCASANA,08286,082861,LA TORRE DE CLARAMUNT,11,3,14
2020/2021,08030583,ESCOLA LA TORRE,08286,082861,LA TORRE DE CLARAMUNT,14,1,15
2020/2021,08030522,ESCOLA VALL DEL GES,08285,082858,TORELLÓ,15,1,16
2020/2021,08030510,ESCOLA DOCTOR FORTIÀ I SOLÀ,08285,082858,TORELLÓ,28,1,29
2020/2021,08030467,ESCOLA IGNASI IGLESIAS,08284,082845,TORDERA,27,5,32
2020/2021,08030421,ESCOLA L'ERA DE DALT,08283,082830,TONA,25,5,30
2020/2021,08030388,ESCOLA LOLA ANGLADA,08282,082824,TIANA,25,4,29
2020/2021,08030364,ESCOLA EL CIM,08281,082819,TEIÀ,26,5,31
2020/2021,08030340,INSTITUT INVESTIGADOR BLANXART,08279,082798,TERRASSA,56,27,83
2020/2021,08030339,INSTITUT DE TERRASSA,08279,082798,TERRASSA,92,53,145
2020/2021,08030315,ESCOLA JOAN XXIII,08279,082798,TERRASSA,26,4,30
2020/2021,08030297,ESCOLA SALVADOR VINYALS I GALÍ,08279,082798,TERRASSA,18,2,20
2020/2021,08030285,ESCOLA AURÓ,08279,082798,TERRASSA,19,6,25
2020/2021,08030248,ESCOLA PAU VILA I DINARÈS,08279,082798,TERRASSA,33,2,35
2020/2021,08030212,ESCOLA JOSEP VENTALLÓ I VINTRÓ,08279,082798,TERRASSA,19,0,19
2020/2021,08030200,ESCOLA MARIÀ GALÍ GUIX,08279,082798,TERRASSA,20,2,22
2020/2021,08029507,ESCOLA ISAAC PERAL,08279,082798,TERRASSA,16,1,17
2020/2021,08029386,ESCOLA RAMÓN Y CAJAL,08279,082798,TERRASSA,26,6,32
2020/2021,08029374,ESCOLA BISBAT D'EGARA,08279,082798,TERRASSA,41,2,43
2020/2021,08029350,ESCOLA FRANÇA,08279,082798,TERRASSA,24,6,30
2020/2021,08029301,ESCOLA LES PINEDIQUES,08278,082785,TARADELL,26,4,30
2020/2021,08029283,ESCOLA EL GURRI - ZER GUILLERIES,08278,082785,TARADELL,4,0,4
2020/2021,08029222,ESCOLA FRANCESC MACIÀ,08274,082747,SÚRIA,15,1,16
2020/2021,08029209,ESCOLA MARE DE DÉU DE MONTSERRAT,08274,082747,SÚRIA,11,3,14
2020/2021,08029192,ESCOLA SANT JORDI,08273,082732,SUBIRATS,13,1,14
2020/2021,08029155,ESCOLA EL MONTCAU - ZER SUBIRATS,08273,082732,SUBIRATS,7,1,8
2020/2021,08029143,ESCOLA SUBIRATS - ZER SUBIRATS,08273,082732,SUBIRATS,9,0,9
2020/2021,08029088,ESCOLA MIQUEL UTRILLO,08270,082704,SITGES,20,9,29
2020/2021,08029027,ESCOLA FARIGOLA,08269,082690,SEVA,12,3,15
2020/2021,08029015,ESCOLA SANT SALVADOR,08268,082687,CERCS,9,1,10
2020/2021,08028990,ESCOLA CAN SORTS,08267,082671,SENTMENAT,36,7,43
2020/2021,08028941,ESCOLA LA SARDANA,08904,089045,BADIA DEL VALLÈS,23,3,26
2020/2021,08028928,ESCOLA LA JOTA,08904,089045,BADIA DEL VALLÈS,27,7,34
2020/2021,08028916,ESCOLA LAS SEGUIDILLAS,08904,089045,BADIA DEL VALLÈS,32,2,34
2020/2021,08028904,ESCOLA CARLES BUÏGAS,08266,082665,CERDANYOLA DEL VALLÈS,18,0,18
2020/2021,08028783,ESCOLA SERRAPARERA,08266,082665,CERDANYOLA DEL VALLÈS,24,4,28
2020/2021,08028758,ESCOLA LES FONTETES,08266,082665,CERDANYOLA DEL VALLÈS,12,5,17
2020/2021,08028746,ESCOLA SANT MARTÍ,08266,082665,CERDANYOLA DEL VALLÈS,15,3,18
2020/2021,08028709,ESCOLA LLORIANA,08265,082652,SANT VICENÇ DE TORELLÓ,12,2,14
2020/2021,08028667,ESCOLA JOAN JUNCADELLA,08263,082634,SANT VICENÇ DELS HORTS,27,0,27
2020/2021,08028591,ESCOLA LA VINYALA,08263,082634,SANT VICENÇ DELS HORTS,21,2,23
2020/2021,08028588,ESCOLA SANT JORDI,08263,082634,SANT VICENÇ DELS HORTS,15,1,16
2020/2021,08028576,ESCOLA SANT VICENÇ,08262,082628,SANT VICENÇ DE CASTELLET,29,4,33
2020/2021,08028515,ESCOLA SANTA SUSANNA,08261,082613,SANTA SUSANNA,13,4,17
2020/2021,08028497,ESCOLA SANTA PERPÈTUA,08260,082606,SANTA PERPÈTUA DE MOGODA,21,5,26
2020/2021,08028436,ESCOLA LA FLORIDA,08260,082606,SANTA PERPÈTUA DE MOGODA,26,2,28
2020/2021,08028424,ESCOLA FONTMARTINA,08259,082592,SANTA MARIA DE PALAUTORDERA,20,4,24
2020/2021,08028382,ESCOLA SESMON D'OLÓ,08258,082589,SANTA MARIA D'OLÓ,11,0,11
2020/2021,08028345,ESCOLA LES MIMOSES,08256,082567,SANTA MARIA DE MARTORELLES,10,3,13
2020/2021,08028333,ESCOLA EL CABRERÈS,08254,082541,L'ESQUIROL,13,3,16
2020/2021,08028229,ESCOLA ELISA BADIA,08252,082520,BARBERÀ DEL VALLÈS,25,2,27
2020/2021,08028217,ESCOLA DOCTOR SAMARANCH I FINA,08251,082515,SANTA MARGARIDA I ELS MONJOS,26,4,30
2020/2021,08028163,ESCOLA MONTBOU,08250,082508,SANTA MARGARIDA DE MONTBUI,11,3,14
2020/2021,08028151,ESCOLA LES MORERES - ZER CEP DE SIS,08249,082495,SANTA FE DEL PENEDÈS,5,0,5
2020/2021,08028102,ESCOLA RONÇANA,08248,082482,SANTA EULÀLIA DE RONÇANA,19,1,20
2020/2021,08028072,ESCOLA EL ROURE GROS,08247,082476,SANTA EULÀLIA DE RIUPRIMER,11,3,14
2020/2021,08028059,ESCOLA JACINT VERDAGUER,08246,082460,SANTA EUGÈNIA DE BERGA,13,4,17
2020/2021,08028047,INSTITUT PUIG CASTELLAR,08245,082457,SANTA COLOMA DE GRAMENET,50,35,85
2020/2021,08028035,ESCOLA AUSIÀS MARCH,08245,082457,SANTA COLOMA DE GRAMENET,14,3,17
2020/2021,08027985,ESCOLA JAUME SALVATELLA,08245,082457,SANTA COLOMA DE GRAMENET,25,4,29
2020/2021,08027973,ESCOLA BEETHOVEN,08245,082457,SANTA COLOMA DE GRAMENET,19,3,22
2020/2021,08027870,ESCOLA LES PALMERES,08245,082457,SANTA COLOMA DE GRAMENET,24,5,29
2020/2021,08027511,ESCOLA TORRE BALLDOVINA,08245,082457,SANTA COLOMA DE GRAMENET,27,6,33
2020/2021,08027471,ESCOLA SANT JUST,08245,082457,SANTA COLOMA DE GRAMENET,26,3,29
2020/2021,08027456,ESCOLA FERRAN DE SAGARRA,08245,082457,SANTA COLOMA DE GRAMENET,30,8,38
2020/2021,08027432,ESCOLA WAGNER,08245,082457,SANTA COLOMA DE GRAMENET,18,3,21
2020/2021,08027249,ESCOLA SEGIMON COMAS,08237,082378,SANT QUIRZE DE BESORA,16,1,17
2020/2021,08027225,ESCOLA SANT PAU,08235,082359,SANT POL DE MAR,27,4,31
2020/2021,08027183,ESCOLA TORRE ROJA,08234,082346,SANT PERE DE VILAMAJOR,23,5,28
2020/2021,08027146,ESCOLA SANT JERONI,08232,082325,SANT PERE DE RIUDEBITLLES,13,3,16
2020/2021,08027134,ESCOLA LES ROQUETES,08231,082310,SANT PERE DE RIBES,18,6,24
2020/2021,08027110,ESCOLA EL PI,08231,082310,SANT PERE DE RIBES,13,2,15
2020/2021,08027021,ESCOLA FONT DE L'ANOIA - ZER VENT D'AVALL,08228,082286,SANT MARTÍ SESGUEIOLES,1,2,3
2020/2021,08027018,ESCOLA JAUME BALMES,08227,082270,SANT MARTÍ SARROCA,19,4,23
2020/2021,08026956,ESCOLA CÉRVOLA BLANCA,08226,082264,SANT MARTÍ DE TOUS,14,2,16
2020/2021,08026919,ESCOLA JOSEP GRAS,08223,082233,SANT LLORENÇ SAVALL,13,1,14
2020/2021,08026907,ESCOLA PAU CASALS,08222,082227,SANT LLORENÇ D'HORTONS,12,3,15
2020/2021,08026889,ESCOLA VINYES VERDES,08119,081192,MASQUEFA,11,4,15
2020/2021,08026816,ESCOLA MONTSERRAT,08221,082212,SANT JUST DESVERN,25,3,28
2020/2021,08026786,ESCOLA BELLPUIG,08220,082205,SANT JULIÀ DE VILATORTA,15,1,16
2020/2021,08026749,ESCOLA PÉREZ SALA,08219,082191,VILASSAR DE MAR,19,7,26
2020/2021,08026725,ESCOLA JONCADELLA,08218,082188,SANT JOAN DE VILATORRADA,24,3,27
2020/2021,08026683,INSTITUT FRANCESC FERRER I GUÀRDIA,08217,082172,SANT JOAN DESPÍ,66,23,89
2020/2021,08026671,ESCOLA JOAN PERICH I VALLS,08217,082172,SANT JOAN DESPÍ,16,1,17
2020/2021,08026661,ESCOLA PAU CASALS,08217,082172,SANT JOAN DESPÍ,26,2,28
2020/2021,08026567,ESCOLA SANT FRANCESC D'ASSÍS,08217,082172,SANT JOAN DESPÍ,25,5,30
2020/2021,08026476,ESCOLA FRANCESC MACIÀ,08214,082140,VILASSAR DE DALT,27,4,31
2020/2021,08026464,ESCOLA MONSENYOR GIBERT,08213,082135,SANT FRUITÓS DE BAGES,22,5,27
2020/2021,08026415,ESCOLA ELS ROURES - ZER GAVARRESA,08212,082129,SANT FELIU SASSERRA,6,1,7
2020/2021,08026397,INSTITUT OLORDA,08211,082114,SANT FELIU DE LLOBREGAT,45,16,61
2020/2021,08026385,ESCOLA ARQUITECTE GAUDÍ,08211,082114,SANT FELIU DE LLOBREGAT,18,1,19
2020/2021,08026373,ESCOLA JOSEP MONMANY AMAT,08211,082114,SANT FELIU DE LLOBREGAT,21,2,23
2020/2021,08026221,ESCOLA FALGUERA,08211,082114,SANT FELIU DE LLOBREGAT,12,5,17
2020/2021,08026211,ESCOLA NADAL,08211,082114,SANT FELIU DE LLOBREGAT,26,3,29
2020/2021,08026208,ESCOLA JAUME BALMES,08210,082107,SANT FELIU DE CODINES,20,7,27
2020/2021,08026154,ESCOLA JOAQUIM ABRIL,08209,082093,SANT FOST DE CAMPSENTELLES,24,1,25
2020/2021,08026130,ESCOLA LA ROUREDA,08208,082080,SANT ESTEVE SESROVIRES,25,2,27
2020/2021,08026117,ESCOLA VALLMANYA,08207,082074,SANT ESTEVE DE PALAUTORDERA,26,1,27
2020/2021,08026099,ESCOLA LES VINYES,08206,082068,SANT CUGAT SESGARRIGUES,12,1,13
2020/2021,08026087,ESCOLA JAUME FERRAN I CLUA,08205,082055,SANT CUGAT DEL VALLÈS,27,2,29
2020/2021,08026026,ESCOLA PINS DEL VALLÈS,08205,082055,SANT CUGAT DEL VALLÈS,27,4,31
2020/2021,08025927,ESCOLA PI D'EN XANDRI,08205,082055,SANT CUGAT DEL VALLÈS,20,8,28
2020/2021,08025824,ESCOLA LA FLORESTA,08205,082055,SANT CUGAT DEL VALLÈS,15,1,16
2020/2021,08025812,ESCOLA SANT CLIMENT,08204,082042,SANT CLIMENT DE LLOBREGAT,27,3,30
2020/2021,08025666,ESCOLA AURORA - ZER ALT LLUÇANÈS,08201,082016,SANT BOI DE LLUÇANÈS,2,2,4
2020/2021,08025654,INSTITUT JOAQUIM RUBIÓ I ORS,08200,082009,SANT BOI DE LLOBREGAT,40,26,66
2020/2021,08025642,ESCOLA JOSEP MARIA CIURANA,08200,082009,SANT BOI DE LLOBREGAT,28,1,29
2020/2021,08025605,INSTITUT CAMPS BLANCS,08200,082009,SANT BOI DE LLOBREGAT,80,47,127
2020/2021,08025599,ESCOLA MARIANAO,08200,082009,SANT BOI DE LLOBREGAT,16,2,18
2020/2021,08025587,ESCOLA CASABLANCA,08200,082009,SANT BOI DE LLOBREGAT,29,3,32
2020/2021,08025526,ESCOLA CIUTAT COOPERATIVA,08200,082009,SANT BOI DE LLOBREGAT,15,3,18
2020/2021,08025344,ESCOLA AMAT VERDÚ,08200,082009,SANT BOI DE LLOBREGAT,19,3,22
2020/2021,08025320,ESCOLA LA MONJOIA,08199,081995,SANT BARTOMEU DEL GRAU,9,1,10
2020/2021,08025319,ESCOLA JOAN CASAS,08198,081982,SANT ANTONI DE VILAMAJOR,22,4,26
2020/2021,08025265,ESCOLA ÀNGEL GUIMERÀ,08196,081960,SANT ANDREU DE LA BARCA,25,5,30
2020/2021,08025241,ESCOLA JOAN MARAGALL,08196,081960,SANT ANDREU DE LA BARCA,14,2,16
2020/2021,08025083,ESCOLA POMPEU FABRA,08194,081944,SANT ADRIÀ DE BESÒS,26,8,34
2020/2021,08025071,ESCOLA DONES D'AIGUA,08193,081939,SANT ISCLE DE VALLALTA,12,2,14
2020/2021,08025058,ESCOLA RIU D'OR,08192,081923,SANTPEDOR,24,4,28
2020/2021,08024972,ESCOLA TORRES AMAT,08191,081918,SALLENT,26,2,28
2020/2021,08024893,INSTITUT CASTELLARNAU,08187,081878,SABADELL,50,46,96
2020/2021,08024881,INSTITUT FERRAN CASABLANCAS,08187,081878,SABADELL,41,49,90
2020/2021,08024871,INSTITUT PAU VILA,08187,081878,SABADELL,44,30,74
2020/2021,08024856,ESCOLA FONT ROSELLA,08187,081878,SABADELL,23,4,27
2020/2021,08024844,ESCOLA TORREGUITART,08187,081878,SABADELL,15,2,17
2020/2021,08024832,ESCOLA FLORESTA,08187,081878,SABADELL,12,4,16
2020/2021,08024820,ESCOLA PAU CASALS,08187,081878,SABADELL,24,6,30
2020/2021,08024819,ESCOLA CALVET D'ESTRELLA,08187,081878,SABADELL,17,1,18
2020/2021,08024807,ESCOLA AGNÈS ARMENGOL,08187,081878,SABADELL,17,3,20
2020/2021,08024790,ESCOLA ROUREDA,08187,081878,SABADELL,25,4,29
2020/2021,08024789,CEE FRANCESC BELLAPART,08187,081878,SABADELL,34,4,38
2020/2021,08024777,INSTITUT EGARA,08279,082798,TERRASSA,31,19,50
2020/2021,08024765,INSTITUT ARRAONA,08187,081878,SABADELL,35,23,58
2020/2021,08024741,INSTITUT ESCOLA INDUSTRIAL,08187,081878,SABADELL,57,57,114
2020/2021,08024066,ESCOLA TARLATANA,08187,081878,SABADELL,16,2,18
2020/2021,08024042,ESCOLA LA ROMÀNICA,08187,081878,SABADELL,25,4,29
2020/2021,08024030,ESCOLA SAMUNTADA,08187,081878,SABADELL,18,1,19
2020/2021,08024017,ESCOLA MIQUEL CARRERAS,08187,081878,SABADELL,13,5,18
2020/2021,08024005,ESCOLA JOAN MARAGALL,08187,081878,SABADELL,22,1,23
2020/2021,08023980,ESCOLA JUAN RAMÓN JIMÉNEZ,08187,081878,SABADELL,16,1,17
2020/2021,08023979,ESCOLA JOAN MONTLLOR,08187,081878,SABADELL,13,5,18
2020/2021,08023955,ESCOLA CIFUENTES,08187,081878,SABADELL,26,4,30
2020/2021,08023943,ESCOLA GAUDÍ,08187,081878,SABADELL,18,0,18
2020/2021,08023931,ESCOLA ENRIC CASASSAS,08187,081878,SABADELL,12,3,15
2020/2021,08023921,ESCOLA ESPRONCEDA,08187,081878,SABADELL,28,5,33
2020/2021,08023918,ESCOLA CONCÒRDIA,08187,081878,SABADELL,29,0,29
2020/2021,08023852,ESCOLA JOAN MARAGALL,08184,081846,RUBÍ,20,1,21
2020/2021,08023669,ESCOLA MARE DE DÉU DEL SÒL DEL PONT,08183,081831,RODA DE TER,26,2,28
2020/2021,08023591,ESCOLA PILAR MESTRES-JAUME TORRENS,08181,081810,LA ROCA DEL VALLÈS,15,2,17
2020/2021,08023566,ESCOLA ANSELM CLAVÉ,08180,081803,RIPOLLET,23,3,26
2020/2021,08023554,ESCOLA JOSEP MARIA GINESTA,08180,081803,RIPOLLET,28,0,28
2020/2021,08023542,ESCOLA TIANA DE LA RIBA,08180,081803,RIPOLLET,13,5,18
2020/2021,08023426,ESCOLA GASSÓ I VIDAL,08180,081803,RIPOLLET,14,1,15
2020/2021,08023372,ESCOLA ALFRED MATA,08175,081751,PUIG-REIG,12,4,16
2020/2021,08023359,ESCOLA VIROLAI - ZER CEP DE SIS,08174,081748,PUIGDÀLBER,5,0,5
2020/2021,08023335,ESCOLA MONTSERRAT,08172,081727,PREMIÀ DE MAR,21,6,27
2020/2021,08023232,ESCOLA SANT CRISTÒFOL,08172,081727,PREMIÀ DE MAR,22,2,24
2020/2021,08023207,ESCOLA LLUÇANÈS,08171,081712,PRATS DE LLUÇANÈS,14,2,16
2020/2021,08023141,ESCOLA MARE DE DÉU DEL PORTAL - ZER VENT D'AVALL,08170,081705,ELS PRATS DE REI,6,1,7
2020/2021,08023131,INSTITUT BALDIRI GUILERA,08169,081691,EL PRAT DE LLOBREGAT,43,19,62
2020/2021,08022938,ESCOLA JACINT VERDAGUER,08169,081691,EL PRAT DE LLOBREGAT,26,5,31
2020/2021,08022926,CEE CAN RIGOL,08169,081691,EL PRAT DE LLOBREGAT,26,5,31
2020/2021,08022914,ESCOLA JAUME BALMES,08169,081691,EL PRAT DE LLOBREGAT,29,4,33
2020/2021,08022902,ESCOLA DEL PARC,08169,081691,EL PRAT DE LLOBREGAT,28,2,30
2020/2021,08022884,ESCOLA JOAN MARAGALL,08169,081691,EL PRAT DE LLOBREGAT,15,2,17
2020/2021,08022872,ESCOLA PERE CALDERS,08167,081672,POLINYÀ,18,7,25
2020/2021,08022860,ESCOLA LILLET A GÜELL,08166,081666,LA POBLA DE LILLET,7,1,8
2020/2021,08022859,ESCOLA MARIA BORÉS,08165,081653,LA POBLA DE CLARAMUNT,13,2,15
2020/2021,08022847,ESCOLA SANTS ABDÓ I SENÉN,08164,081640,EL PLA DEL PENEDÈS,9,5,14
2020/2021,08022835,ESCOLA JAUME I,08163,081635,PINEDA DE MAR,24,2,26
2020/2021,08022801,ESCOLA ANTONI DOLTRA,08163,081635,PINEDA DE MAR,15,2,17
2020/2021,08022768,ESCOLA HEROIS DEL BRUC,08161,081614,PIERA,29,3,32
2020/2021,08022707,ESCOLA POMPEU FABRA,08159,081593,PARETS DEL VALLÈS,15,1,16
2020/2021,08022690,ESCOLA LLUÍS PIQUER,08159,081593,PARETS DEL VALLÈS,26,4,30
2020/2021,08022689,ESCOLA PAU VILA,08158,081580,EL PAPIOL,28,1,29
2020/2021,08022677,ESCOLA JACINT VERDAGUER,08157,081574,PALLEJÀ,15,1,16
2020/2021,08022665,ESCOLA ÀNGEL GUIMERÀ,08157,081574,PALLEJÀ,14,4,18
2020/2021,08022616,ESCOLA JOSEP MARIA FOLCH I TORRES,08156,081568,PALAU-SOLITÀ I PLEGAMANS,18,2,20
2020/2021,08022598,ESCOLA LES FERRERIES DE PALAFOLLS,08155,081555,PALAFOLLS,27,4,31
2020/2021,08022586,ESCOLA EL DRAC,08154,081542,PACS DEL PENEDÈS,11,1,12
2020/2021,08022574,ESCOLA FRANCESC MACIÀ,08153,081537,ÒRRIUS,11,2,13
2020/2021,08022549,ESCOLA LLEVANT - ZER GAVARRESA,08151,081516,ORISTÀ,3,0,3
2020/2021,08022495,ESCOLA TERRA NOSTRA,08149,081496,OLOST,10,1,11
2020/2021,08022461,ESCOLA SANT BERNAT,08147,081477,OLESA DE MONTSERRAT,25,4,29
2020/2021,08022380,ESCOLA MARE DE DÉU DE MONTSERRAT,08147,081477,OLESA DE MONTSERRAT,21,2,23
2020/2021,08022379,ESCOLA PONT DE L'ARCADA,08146,081461,OLESA DE BONESVALLS,9,3,12
2020/2021,08022367,ESCOLA ROSSEND MONTANÉ,08145,081458,OLÈRDOLA,13,2,15
2020/2021,08022343,ESCOLA CIRCELL,08145,081458,OLÈRDOLA,14,3,17
2020/2021,08022331,ESCOLA D'OLVAN - ZER BAIX BERGUEDÀ,08144,081445,OLVAN,6,0,6
2020/2021,08022197,ESCOLA CATALUNYA,08140,081402,NAVARCLES,27,6,33
2020/2021,08022094,ESCOLA JOSEP ORRIOLS I ROCA,08138,081385,MOIÀ,24,5,29
2020/2021,08022082,ESCOLA PUIG DRAU - ZER BAIX MONTSENY,08137,081379,MONTSENY,4,0,4
2020/2021,08022070,ESCOLA MARINADA,08136,081363,MONTORNÈS DEL VALLÈS,29,3,32
2020/2021,08022057,ESCOLA SANT SADURNÍ,08136,081363,MONTORNÈS DEL VALLÈS,12,3,15
2020/2021,08022045,ESCOLA SANT JORDI,08135,081350,MONTMELÓ,26,3,29
2020/2021,08022011,ESCOLA PAU CASALS,08135,081350,MONTMELÓ,22,1,23
2020/2021,08022008,ESCOLA MONTMANY,08134,081347,FIGARÓ-MONTMANY,9,1,10
2020/2021,08021983,ESCOLA GIRA-SOL - ZER BAIX BERGUEDÀ,08132,081326,MONTMAJOR,7,0,7
2020/2021,08021961,ESCOLA EL ROCAL - ZER ELS CASTELLS,08131,081311,MONTESQUIU,9,1,10
2020/2021,08021934,ESCOLA L'ESQUEIX - ZER EL MOIANÈS PONENT,08128,081287,MONISTROL DE CALDERS,3,1,4
2020/2021,08021892,ESCOLA SANT PERE,08127,081271,MONISTROL DE MONTSERRAT,19,0,19
2020/2021,08021880,ESCOLA SALVADOR ESPRIU,08126,081265,MONTGAT,27,1,28
2020/2021,08021788,INSTITUT MONTSERRAT MIRÓ I VILA,08125,081252,MONTCADA I REIXAC,37,17,54
2020/2021,08021764,ESCOLA MITJA COSTA,08125,081252,MONTCADA I REIXAC,12,3,15
2020/2021,08021685,ESCOLA FONT FREDA,08125,081252,MONTCADA I REIXAC,21,3,24
2020/2021,08021600,INSTITUT VICENÇ PLANTADA,08124,081249,MOLLET DEL VALLÈS,41,27,68
2020/2021,08021594,INSTITUT DE MOLLET DEL VALLÈS,08124,081249,MOLLET DEL VALLÈS,33,75,108
2020/2021,08021582,ESCOLA JOAN SALVAT PAPASSEIT,08124,081249,MOLLET DEL VALLÈS,12,4,16
2020/2021,08021570,ESCOLA DEL BOSC,08124,081249,MOLLET DEL VALLÈS,12,3,15
2020/2021,08021466,ESCOLA COL·LEGIS NOUS,08124,081249,MOLLET DEL VALLÈS,23,1,24
2020/2021,08021442,ESCOLA CASTELL CIURÓ,08123,081234,MOLINS DE REI,18,7,25
2020/2021,08021430,INSTITUT LLUÍS DE REQUESENS,08123,081234,MOLINS DE REI,46,25,71
2020/2021,08021363,ESCOLA L'ALZINA,08123,081234,MOLINS DE REI,15,1,16
2020/2021,08021351,ESCOLA EL PALAU,08123,081234,MOLINS DE REI,15,1,16
2020/2021,08021326,ESCOLA LA FASSINA,08122,081228,MEDIONA,7,1,8
2020/2021,08021302,INSTITUT DAMIÀ CAMPENY,08121,081213,MATARÓ,33,20,53
2020/2021,08021260,INSTITUT ALEXANDRE SATORRAS,08121,081213,MATARÓ,59,32,91
2020/2021,08021041,ESCOLA JOSEP MONTSERRAT,08121,081213,MATARÓ,16,3,19
2020/2021,08020929,ESCOLA GERMANES BERTOMEU,08121,081213,MATARÓ,32,3,35
2020/2021,08020917,ESCOLA JOSEP MANUEL PERAMÀS,08121,081213,MATARÓ,28,3,31
2020/2021,08020905,ESCOLA ANGELETA FERRER,08121,081213,MATARÓ,21,4,25
2020/2021,08020863,ESCOLA GINESTA,08120,081206,MATADEPERA,26,2,28
2020/2021,08020841,ESCOLA EL TURÓ,08119,081192,MASQUEFA,22,6,28
2020/2021,08020838,INSTITUT MEDITERRÀNIA,08118,081189,EL MASNOU,16,22,38
2020/2021,08020826,INSTITUT MAREMAR,08118,081189,EL MASNOU,43,18,61
2020/2021,08020723,ESCOLA OCATA,08118,081189,EL MASNOU,15,1,16
2020/2021,08020701,ESCOLA COMTES DE LACAMBRA,08117,081173,LES MASIES DE VOLTREGÀ,12,1,13
2020/2021,08020656,ESCOLA SIMEÓ RABASA,08115,081154,MARTORELLES,12,2,14
2020/2021,08020620,INSTITUT POMPEU FABRA,08114,081141,MARTORELL,44,35,79
2020/2021,08020619,ESCOLA JOSÉ ECHEGARAY,08114,081141,MARTORELL,28,4,32
2020/2021,08020607,ESCOLA JUAN RAMÓN JIMÉNEZ,08114,081141,MARTORELL,24,5,29
2020/2021,08020516,CEE EL PONTARRÓ,08114,081141,MARTORELL,28,2,30
2020/2021,08020498,ESCOLA ELS CONVENTS,08114,081141,MARTORELL,15,1,16
2020/2021,08020474,INSTITUT LLUÍS DE PEGUERA,08113,081136,MANRESA,57,26,83
2020/2021,08020462,INSTITUT LACETÀNIA,08113,081136,MANRESA,57,79,136
2020/2021,08020127,ESCOLA BAGES,08113,081136,MANRESA,31,1,32
2020/2021,08020097,ESCOLA PARE ALGUÉ,08113,081136,MANRESA,17,3,20
2020/2021,08020073,ESCOLA SANT IGNASI,08113,081136,MANRESA,28,5,33
2020/2021,08020061,ESCOLA LA RENAIXENÇA,08113,081136,MANRESA,20,2,22
2020/2021,08020012,ESCOLA MUNTANYA DEL DRAC,08113,081136,MANRESA,15,1,16
2020/2021,08019940,ESCOLA PUIG-AGUT,08112,081120,MANLLEU,31,3,34
2020/2021,08019927,ESCOLA MARIÀ CUBÍ I SOLER,08110,081108,MALGRAT DE MAR,20,7,27
2020/2021,08019873,ESCOLA MARE DE DÉU DE MONTSERRAT,08110,081108,MALGRAT DE MAR,13,4,17
2020/2021,08019861,ESCOLA GAFARRÓ - ZER ALT LLUÇANÈS,08109,081094,LLUÇÀ,4,1,5
2020/2021,08019824,ESCOLA LES LLISSES,08108,081081,LLIÇÀ DE VALL,21,3,24
2020/2021,08019782,ESCOLA SALVADOR SANROMÀ,08106,081069,LLINARS DEL VALLÈS,25,4,29
2020/2021,08019745,ESCOLA JOAN MARAGALL,08105,081056,LA LLAGOSTA,23,3,26
2020/2021,08019711,ESCOLA SAGRADA FAMÍLIA,08105,081056,LA LLAGOSTA,18,4,22
2020/2021,08019691,ESCOLA VILADEMÀGER - ZER SERRA D'ANCOSA,08104,081043,LA LLACUNA,4,0,4
2020/2021,08019678,ESCOLA GUERAU DE JORBA,08103,081038,JORBA,9,1,10
2020/2021,08019654,INSTITUT MILÀ I FONTANALS,08102,081022,IGUALADA,66,61,127
2020/2021,08019642,ESCOLA PARE RAMON CASTELLTORT I MIRALDA,08102,081022,IGUALADA,30,1,31
2020/2021,08019630,INSTITUT PERE VIVES I VICH,08102,081022,IGUALADA,45,29,74
2020/2021,08019460,ESCOLA EMILI VALLÈS,08102,081022,IGUALADA,15,3,18
2020/2021,08019459,ESCOLA GABRIEL CASTELLA I RAICH,08102,081022,IGUALADA,20,0,20
2020/2021,08019435,ESCOLA GARCÍA I FOSSAS,08102,081022,IGUALADA,27,3,30
2020/2021,08019411,INSTITUT BELLVITGE,08101,081017,L'HOSPITALET DE LLOBREGAT,25,17,42
2020/2021,08019401,INSTITUT PROVENÇANA,08101,081017,L'HOSPITALET DE LLOBREGAT,47,42,89
2020/2021,08019371,INSTITUT LLOBREGAT,08101,081017,L'HOSPITALET DE LLOBREGAT,10,28,38
2020/2021,08019320,INSTITUT TORRAS I BAGES,08101,081017,L'HOSPITALET DE LLOBREGAT,37,22,59
2020/2021,08019319,INSTITUT PEDRAFORCA,08101,081017,L'HOSPITALET DE LLOBREGAT,64,36,100
2020/2021,08019307,INSTITUT SANTA EULÀLIA,08101,081017,L'HOSPITALET DE LLOBREGAT,41,12,53
2020/2021,08019290,ESCOLA PROVENÇANA,08101,081017,L'HOSPITALET DE LLOBREGAT,14,3,17
2020/2021,08019277,ESCOLA LA MARINA,08101,081017,L'HOSPITALET DE LLOBREGAT,26,3,29
2020/2021,08019265,ESCOLA JOAQUIM RUYRA,08101,081017,L'HOSPITALET DE LLOBREGAT,27,8,35
2020/2021,08019241,ESCOLA FREDERIC MISTRAL,08101,081017,L'HOSPITALET DE LLOBREGAT,24,3,27
2020/2021,08019231,ESCOLA MILAGROS CONSARNAU,08101,081017,L'HOSPITALET DE LLOBREGAT,28,4,32
2020/2021,08019216,ESCOLA BUSQUETS I PUNSET,08101,081017,L'HOSPITALET DE LLOBREGAT,21,8,29
2020/2021,08019198,ESCOLA POMPEU FABRA,08101,081017,L'HOSPITALET DE LLOBREGAT,26,5,31
2020/2021,08019149,ESCOLA BERNAT METGE,08101,081017,L'HOSPITALET DE LLOBREGAT,18,2,20
2020/2021,08018157,ESCOLA SANTIAGO RAMON Y CAJAL,08101,081017,L'HOSPITALET DE LLOBREGAT,31,8,39
2020/2021,08018145,ESCOLA PAU VILA,08101,081017,L'HOSPITALET DE LLOBREGAT,20,4,24
2020/2021,08018091,ESCOLA PEP VENTURA,08101,081017,L'HOSPITALET DE LLOBREGAT,35,2,37
2020/2021,08018078,ESCOLA BELLVITGE,08101,081017,L'HOSPITALET DE LLOBREGAT,16,2,18
2020/2021,08018066,ESCOLA MENÉNDEZ PIDAL,08101,081017,L'HOSPITALET DE LLOBREGAT,48,7,55
2020/2021,08018029,ESCOLA LES ESCOLES,08100,081000,GURB,26,2,28
2020/2021,08018017,ESCOLA L'ALBIOL - ZER ALT BERGUEDÀ,08903,089030,SANT JULIÀ DE CERDANYOLA,2,0,2
2020/2021,08018005,ESCOLA SANT LLORENÇ,08099,080996,GUARDIOLA DE BERGUEDÀ,6,4,10
2020/2021,08017992,ESCOLA MONTSERRAT,08098,080983,SANT SALVADOR DE GUARDIOLA,20,2,22
2020/2021,08017979,ESCOLA AQUA ALBA,08097,080977,GUALBA,10,4,14
2020/2021,08017931,INSTITUT ANTONI CUMELLA,08096,080961,GRANOLLERS,39,21,60
2020/2021,08017918,ESCOLA GRANULLARIUS,08096,080961,GRANOLLERS,27,3,30
2020/2021,08017712,ESCOLA FERRER I GUÀRDIA,08096,080961,GRANOLLERS,15,2,17
2020/2021,08017700,ESCOLA JOAN SOLANS,08096,080961,GRANOLLERS,15,5,20
2020/2021,08017694,ESCOLA PEREANTON,08096,080961,GRANOLLERS,14,2,16
2020/2021,08017682,ESCOLA JACINT VERDAGUER,08094,080945,LA GRANADA,13,2,15
2020/2021,08017645,ESCOLA DE GIRONELLA,08092,080924,GIRONELLA,15,1,16
2020/2021,08017633,ESCOLA SANT MARC,08092,080924,GIRONELLA,14,1,15
2020/2021,08017611,ESCOLA MONTCAU,08091,080919,GELIDA,24,3,27
2020/2021,08017530,INSTITUT DE BRUGUERS,08089,080898,GAVÀ,27,22,49
2020/2021,08017505,ESCOLA JUAN SALAMERO,08089,080898,GAVÀ,12,3,15
2020/2021,08017360,ESCOLA JACME MARCH,08089,080898,GAVÀ,18,1,19
2020/2021,08017359,ESCOLA SALVADOR LLUCH,08089,080898,GAVÀ,30,1,31
2020/2021,08017311,ESCOLA PUIGGRACIÓS,08088,080885,LA GARRIGA,26,4,30
2020/2021,08017271,ESCOLA JOAN SANPERA I TORRAS,08086,080863,LES FRANQUESES DEL VALLÈS,29,1,30
2020/2021,08017244,ESCOLA FONT-RÚBIA,08085,080850,FONT-RUBÍ,14,1,15
2020/2021,08017232,ESCOLA AGRUPACIÓ SANT JORDI,08084,080847,FONOLLOSA,11,4,15
2020/2021,08017153,INSTITUT JOANOT MARTORELL,08077,080771,ESPLUGUES DE LLOBREGAT,36,15,51
2020/2021,08017131,INSTITUT SEVERO OCHOA,08077,080771,ESPLUGUES DE LLOBREGAT,63,31,94
2020/2021,08017116,ESCOLA MATILDE ORDU¦A,08077,080771,ESPLUGUES DE LLOBREGAT,13,3,16
2020/2021,08017104,ESCOLA GRAS I SOLER,08077,080771,ESPLUGUES DE LLOBREGAT,14,3,17
2020/2021,08016941,ESCOLA ISIDRE MARTÍ,08077,080771,ESPLUGUES DE LLOBREGAT,24,0,24
2020/2021,08016938,ESCOLA TAQUÍGRAF GARRIGA,08076,080765,ESPARREGUERA,23,4,27
2020/2021,08016872,ESCOLA MARE DE DÉU DE LA MUNTANYA,08076,080765,ESPARREGUERA,14,2,16
2020/2021,08016811,ESCOLA JOSEP ANDREU - CHARLIE RIVEL,08074,080749,CUBELLES,30,6,36
2020/2021,08016793,INSTITUT FRANCESC MACIÀ,08073,080734,CORNELLÀ DE LLOBREGAT,38,27,65
2020/2021,08016781,INSTITUT ESTEVE TERRADAS I ILLA,08073,080734,CORNELLÀ DE LLOBREGAT,73,81,154
2020/2021,08016771,ESCOLA ELS PINS,08073,080734,CORNELLÀ DE LLOBREGAT,24,4,28
2020/2021,08016744,ESCOLA ANTONI GAUDÍ,08073,080734,CORNELLÀ DE LLOBREGAT,18,2,20
2020/2021,08016422,ESCOLA ABAT OLIBA,08073,080734,CORNELLÀ DE LLOBREGAT,19,4,23
2020/2021,08016410,ESCOLA SANT ILDEFONS,08073,080734,CORNELLÀ DE LLOBREGAT,20,3,23
2020/2021,08016409,ESCOLA MONTSERRAT,08073,080734,CORNELLÀ DE LLOBREGAT,12,4,16
2020/2021,08016392,ESCOLA MOSSÈN JACINT VERDAGUER,08073,080734,CORNELLÀ DE LLOBREGAT,15,1,16
2020/2021,08016380,ESCOLA ANSELM CLAVÉ,08073,080734,CORNELLÀ DE LLOBREGAT,14,2,16
2020/2021,08016367,ESCOLA DOLORS ALMEDA,08073,080734,CORNELLÀ DE LLOBREGAT,25,3,28
2020/2021,08016331,ESCOLA JAUME BALMES,08072,080728,CORBERA DE LLOBREGAT,21,7,28
2020/2021,08016291,ESCOLA COPONS - ZER VENT D'AVALL,08071,080713,COPONS,6,0,6
2020/2021,08016264,ESCOLA EL SOLELL,08905,089058,LA PALMA DE CERVELLÓ,12,5,17
2020/2021,08016240,ESCOLA SANTA MARIA DE CERVELLÓ,08068,080689,CERVELLÓ,23,5,28
2020/2021,08016185,ESCOLA ILDEFONS CERDÀ,08067,080673,CENTELLES,22,4,26
2020/2021,08016173,ESCOLA MARE DE DÉU DE MONTSERRAT,08066,080667,CASTELLVÍ DE ROSANES,13,1,14
2020/2021,08016161,ESCOLA EL CASTELLOT,08065,080654,CASTELLVÍ DE LA MARCA,10,3,13
2020/2021,08016136,ESCOLA LES PASSERES - ZER TRES BRANQUES,08063,080636,CASTELLOLÍ,6,1,7
2020/2021,08016094,ESCOLA SANT MIQUEL,08061,080615,CASTELLGALÍ,14,1,15
2020/2021,08016082,ESCOLA SANT ROC - ZER VENT D'AVALL,08060,080608,CASTELLFOLLIT DE RIUBREGÓS,3,0,3
2020/2021,08016070,ESCOLA DE MAIANS - ZER TRES BRANQUES,08059,080594,CASTELLFOLLIT DEL BOIX,2,0,2
2020/2021,08016069,ESCOLA COLL DE GOSSEM - ZER TRES BRANQUES,08059,080594,CASTELLFOLLIT DEL BOIX,3,0,3
2020/2021,08016033,ESCOLA MONTANYANS,08058,080581,CASTELLET I LA GORNAL,11,3,14
2020/2021,08015961,ESCOLA JACINT VERDAGUER,08056,080569,CASTELLDEFELS,14,2,16
2020/2021,08015855,ESCOLA ELS PINS,08056,080569,CASTELLDEFELS,26,3,29
2020/2021,08015843,ESCOLA LLUÍS VIVES,08056,080569,CASTELLDEFELS,28,1,29
2020/2021,08015831,ESCOLA LA POPA,08055,080556,CASTELLCIR,9,3,12
2020/2021,08015821,ESCOLA MARE DE DÉU DE MONTSERRAT,08054,080543,CASTELLBISBAL,27,1,28
2020/2021,08015806,ESCOLA JAUME BALMES,08053,080538,CASTELLBELL I EL VILAR,16,2,18
2020/2021,08015651,ESCOLA PRINCESA LÀSCARIS,08049,080497,CASSERRES,10,4,14
2020/2021,08015648,ESCOLA SERRA DE COLL-BAS,08048,080484,CARME,9,1,10
2020/2021,08015612,ESCOLA JOAN DE PALÀ - ZER EL CARDENER,08047,080478,CARDONA,5,1,6
2020/2021,08015582,ESCOLA PATROCINI,08047,080478,CARDONA,13,3,16
2020/2021,08015454,ESCOLA RAMON MACIP - DOLORS GRANÉS,08046,080462,CARDEDEU,18,4,22
2020/2021,08015430,ESCOLA MARQUÈS DE LA POBLA,08044,080446,CAPELLADES,21,8,29
2020/2021,08015399,ESCOLA SANT NICOLAU,08043,080431,CANYELLES,23,4,27
2020/2021,08015375,ESCOLA L'ESTELADA,08042,080425,CÀNOVES I SAMALÚS,15,3,18
2020/2021,08015351,ESCOLA JACINT VERDAGUER,08041,080410,CANOVELLES,20,4,24
2020/2021,08015302,ESCOLA MISERICÒRDIA,08040,080403,CANET DE MAR,23,4,27
2020/2021,08015259,ESCOLA L'ALZINAR - ZER BAIX MONTSENY,08039,080399,CAMPINS,4,0,4
2020/2021,08015247,ESCOLA JOVENTUT,08038,080386,CALLÚS,14,2,16
2020/2021,08015193,ESCOLA SANT MARC,08037,080370,CALLDETENES,20,3,23
2020/2021,08015171,INSTITUT BISBE SIVILLA,08035,080351,CALELLA,47,20,67
2020/2021,08015144,ESCOLA EL FAR,08035,080351,CALELLA,23,3,26
2020/2021,08015119,ESCOLA LA MINERVA,08035,080351,CALELLA,22,4,26
2020/2021,08015107,ESCOLA ANTON BUSQUETS I PUNSET - ZER EL MOIANÈS PONENT,08034,080348,CALDERS,8,0,8
2020/2021,08015077,ESCOLA EL FARELL,08033,080333,CALDES DE MONTBUI,27,1,28
2020/2021,08015004,ESCOLA SAGRADA FAMÍLIA,08032,080327,CALDES D'ESTRAC,16,0,16
2020/2021,08014929,ESCOLA ALTA SEGARRA,08031,080312,CALAF,29,3,32
2020/2021,08014905,ESCOLA L'OLIVERA,08030,080305,CABRILS,22,3,25
2020/2021,08014841,ESCOLA LES OLIVERES - ZER SERRA D'ANCOSA,08028,080288,CABRERA D'ANOIA,4,1,5
2020/2021,08014814,ESCOLA EL BRUC,08025,080253,EL BRUC,13,2,15
2020/2021,08014796,ESCOLA DE BORREDÀ - ZER BERGUEDÀ CENTRE,08024,080240,BORREDÀ,3,0,3
2020/2021,08014747,ESCOLA EL TURÓ,08023,080235,BIGUES I RIELLS,17,3,20
2020/2021,08014693,INSTITUT GUILLEM DE BERGUEDÀ,08022,080229,BERGA,41,17,58
2020/2021,08014681,ESCOLA SANTA EULÀLIA,08022,080229,BERGA,28,2,30
2020/2021,08014668,ESCOLA DE LA VALLDAN,08022,080229,BERGA,11,1,12
2020/2021,08014620,ESCOLA SANT JOAN,08022,080229,BERGA,19,6,25
2020/2021,08014589,ESCOLA SANT CRISTÒFOR,08020,080207,BEGUES,28,5,33
2020/2021,08014401,INSTITUT MARE DE DÉU DE LA MERCÈ,08019,080193,BARCELONA,54,80,134
2020/2021,08013470,INSTITUT BARRI BESÒS,08019,080193,BARCELONA,32,17,49
2020/2021,08013469,INSTITUT RAMBLA PRIM,08019,080193,BARCELONA,20,30,50
2020/2021,08013457,ESCOLA PEGASO,08019,080193,BARCELONA,27,2,29
2020/2021,08013411,ESCOLA POBLE-SEC,08019,080193,BARCELONA,26,4,30
2020/2021,08013408,ESCOLA BARCELONA,08019,080193,BARCELONA,27,3,30
2020/2021,08013366,INSTITUT SANT ANDREU,08019,080193,BARCELONA,34,15,49
2020/2021,08013329,EA LLOTJA,08019,080193,BARCELONA,61,50,111
2020/2021,08013305,ESCOLA RAMON BERENGUER III,08019,080193,BARCELONA,14,1,15
2020/2021,08013275,INSTITUT ESCOLA DEL TREBALL,08019,080193,BARCELONA,86,128,214
2020/2021,08013238,INSTITUT VERDAGUER,08019,080193,BARCELONA,26,10,36
2020/2021,08013226,INSTITUT MENÉNDEZ Y PELAYO,08019,080193,BARCELONA,34,27,61
2020/2021,08013214,INSTITUT NARCÍS MONTURIOL,08019,080193,BARCELONA,24,11,35
2020/2021,08013202,INSTITUT MONTSERRAT,08019,080193,BARCELONA,41,27,68
2020/2021,08013196,INSTITUT MILÀ I FONTANALS,08019,080193,BARCELONA,31,21,52
2020/2021,08013184,INSTITUT BERNAT METGE,08019,080193,BARCELONA,23,20,43
2020/2021,08013160,INSTITUT POETA MARAGALL,08019,080193,BARCELONA,42,22,64
2020/2021,08013159,INSTITUT INFANTA ISABEL D'ARAGÓ,08019,080193,BARCELONA,37,27,64
2020/2021,08013147,INSTITUT EMPERADOR CARLES,08019,080193,BARCELONA,43,15,58
2020/2021,08013135,INSTITUT MOISÈS BROGGI,08019,080193,BARCELONA,50,17,67
2020/2021,08013111,INSTITUT JAUME BALMES,08019,080193,BARCELONA,46,37,83
2020/2021,08013101,INSTITUT JOAN D'ÀUSTRIA,08019,080193,BARCELONA,44,33,77
2020/2021,08013093,INSTITUT MONTJUÏC,08019,080193,BARCELONA,25,13,38
2020/2021,08002991,ESCOLA CASCAVELL,08194,081944,SANT ADRIÀ DE BESÒS,16,4,20
2020/2021,08002988,ESCOLA PARE POVEDA,08019,080193,BARCELONA,24,3,27
2020/2021,08002976,ESCOLA RAMON CASAS,08019,080193,BARCELONA,26,3,29
2020/2021,08002952,ESCOLA ENRIC GRANADOS,08019,080193,BARCELONA,16,4,20
2020/2021,08002927,ESCOLA JOAQUIM RUYRA,08019,080193,BARCELONA,21,9,30
2020/2021,08002915,ESCOLA BRASIL,08019,080193,BARCELONA,20,4,24
2020/2021,08002903,CEE SANT JOAN DE LA CREU,08019,080193,BARCELONA,31,2,33
2020/2021,08002897,ESCOLA MESTRE MORERA,08019,080193,BARCELONA,21,1,22
2020/2021,08002885,ESCOLA PROSPERITAT,08019,080193,BARCELONA,16,1,17
2020/2021,08002873,ESCOLA BAC DE RODA,08019,080193,BARCELONA,27,3,30
2020/2021,08002800,ESCOLA MAS CASANOVAS,08019,080193,BARCELONA,17,2,19
2020/2021,08002770,ESCOLA ÀGORA,08019,080193,BARCELONA,11,6,17
2020/2021,08002745,ESCOLA EL CARMEL,08019,080193,BARCELONA,35,3,38
2020/2021,08002733,ESCOLA MIRALLETES,08019,080193,BARCELONA,16,1,17
2020/2021,08002721,ESCOLA FONT D'EN FARGAS,08019,080193,BARCELONA,27,3,30
2020/2021,08002681,ESCOLA DURAN I BAS,08019,080193,BARCELONA,25,4,29
2020/2021,08002666,CEE CONCHA ESPINA,08019,080193,BARCELONA,16,4,20
2020/2021,08002654,ESCOLA PRIM,08019,080193,BARCELONA,22,1,23
2020/2021,08002642,ESCOLA POBLENOU,08019,080193,BARCELONA,19,4,23
2020/2021,08002630,ESCOLA ELS PORXOS,08019,080193,BARCELONA,14,2,16
2020/2021,08002629,ESCOLA LES ACÀCIES,08019,080193,BARCELONA,23,7,30
2020/2021,08002617,ESCOLA RAMBLETA DEL CLOT,08019,080193,BARCELONA,24,5,29
2020/2021,08002599,ESCOLA EDUARD MARQUINA,08019,080193,BARCELONA,15,5,20
2020/2021,08002587,ESCOLA CONCEPCIÓN ARENAL,08019,080193,BARCELONA,16,5,21
2020/2021,08002575,ESCOLA LA PAU,08019,080193,BARCELONA,20,1,21
2020/2021,08002563,ESCOLA LA MAR BELLA,08019,080193,BARCELONA,21,3,24
2020/2021,08002551,ESCOLA MOLÍ DE FINESTRELLES,08019,080193,BARCELONA,29,2,31
2020/2021,08002538,ESCOLA VÍCTOR CATALÀ,08019,080193,BARCELONA,31,1,32
2020/2021,08002526,ESCOLA TIBIDABO,08019,080193,BARCELONA,13,3,16
2020/2021,08002484,ESCOLA MARTA MATA,08019,080193,BARCELONA,14,4,18
2020/2021,08002459,ESCOLA ELISENDA DE MONTCADA,08019,080193,BARCELONA,29,9,38
2020/2021,08002411,ESCOLA BARÓ DE VIVER,08019,080193,BARCELONA,16,1,17
2020/2021,08002393,ESCOLA L'ARC DE SANT MARTÍ,08019,080193,BARCELONA,20,1,21
2020/2021,08002368,ESCOLA TIMBALER DEL BRUC,08019,080193,BARCELONA,12,5,17
2020/2021,08002344,ESCOLA EL TURÓ,08019,080193,BARCELONA,15,2,17
2020/2021,08002320,ESCOLA CIUTAT COMTAL,08019,080193,BARCELONA,15,3,18
2020/2021,08002290,ESCOLA EMILI JUNCADELLA,08019,080193,BARCELONA,16,1,17
2020/2021,08002277,ESCOLA CALDERÓN DE LA BARCA,08019,080193,BARCELONA,28,4,32
2020/2021,08002216,ESCOLA JOSEP MARIA DE SAGARRA,08019,080193,BARCELONA,15,2,17
2020/2021,08002204,ESCOLA MONTSENY,08019,080193,BARCELONA,17,0,17
2020/2021,08002198,ESCOLA LA FARIGOLA DE VALLCARCA,08019,080193,BARCELONA,13,3,16
2020/2021,08002186,ESCOLA MARE DE DÉU DE MONTSERRAT,08019,080193,BARCELONA,14,4,18
2020/2021,08002174,ESCOLA BALDIRI REIXAC,08019,080193,BARCELONA,14,2,16
2020/2021,08002113,ESCOLA RIUS I TAULET,08019,080193,BARCELONA,28,3,31
2020/2021,08002071,ESCOLA GAYARRE,08019,080193,BARCELONA,16,1,17
2020/2021,08002061,ESCOLA JAUME I,08019,080193,BARCELONA,31,7,38
2020/2021,08002058,ESCOLA PRÀCTIQUES,08019,080193,BARCELONA,28,4,32
2020/2021,08002022,ESCOLA CAL MAIOL,08019,080193,BARCELONA,13,4,17
2020/2021,08002010,ESCOLA LLUÍS VIVES,08019,080193,BARCELONA,14,3,17
2020/2021,08002009,ESCOLA FRANCESC MACIÀ,08019,080193,BARCELONA,13,4,17
2020/2021,08001947,ESCOLA MALLORCA,08019,080193,BARCELONA,25,4,29
2020/2021,08001923,ESCOLA DIPUTACIÓ,08019,080193,BARCELONA,25,4,29
2020/2021,08001911,ESCOLA ELS LLORERS,08019,080193,BARCELONA,28,5,33
2020/2021,08001868,ESCOLA RUBÉN DARÍO,08019,080193,BARCELONA,17,3,20
2020/2021,08001856,ESCOLA DRASSANES,08019,080193,BARCELONA,29,8,37
2020/2021,08001832,ESCOLA CASTELLA,08019,080193,BARCELONA,18,2,20
2020/2021,08001820,ESCOLA MILÀ I FONTANALS,08019,080193,BARCELONA,32,4,36
2020/2021,08001819,ESCOLA COLLASO I GIL,08019,080193,BARCELONA,32,7,39
2020/2021,08001807,ESCOLA DE LA CONCEPCIÓ,08019,080193,BARCELONA,13,3,16
2020/2021,08001790,ESCOLA PERE VILA,08019,080193,BARCELONA,33,6,39
2020/2021,08001789,ESCOLA CERVANTES,08019,080193,BARCELONA,15,3,18
2020/2021,08001777,ESCOLA RAMON LLULL,08019,080193,BARCELONA,29,6,35
2020/2021,08001731,ESCOLA POETA FOIX,08019,080193,BARCELONA,16,1,17
2020/2021,08001716,ESCOLA DOLORS MONSERDÀ-SANTAPAU,08019,080193,BARCELONA,24,5,29
2020/2021,08001674,ESCOLA CAN CLOS,08019,080193,BARCELONA,17,1,18
2020/2021,08001650,ESCOLA EL POLVORÍ,08019,080193,BARCELONA,12,6,18
2020/2021,08001649,ESCOLA MOSSÈN JACINT VERDAGUER,08019,080193,BARCELONA,35,3,38
2020/2021,08001601,ESCOLA PARC DE LA CIUTADELLA,08019,080193,BARCELONA,17,2,19
2020/2021,08001595,ESCOLA BAIXERAS,08019,080193,BARCELONA,17,2,19
2020/2021,08001583,ESCOLA GUILLEM DE BALSARENY,08018,080180,BALSARENY,12,3,15
2020/2021,08001522,ESCOLA GALCERAN DE PINÓS,08016,080168,BAGÀ,12,1,13
2020/2021,08001509,ESCOLA ANTONI BOTEY,08015,080155,BADALONA,33,2,35
2020/2021,08001480,EA PAU GARGALLO,08015,080155,BADALONA,21,26,47
2020/2021,08001443,INSTITUT EUGENI D'ORS,08015,080155,BADALONA,56,30,86
2020/2021,08001431,INSTITUT ISAAC ALBÉNIZ,08015,080155,BADALONA,27,31,58
2020/2021,08001421,INSTITUT LA PINEDA,08015,080155,BADALONA,52,48,100
2020/2021,08001391,ESCOLA PLANAS I CASALS,08015,080155,BADALONA,23,6,29
2020/2021,08000402,ESCOLA FELIU I VEGUÉS,08015,080155,BADALONA,24,5,29
2020/2021,08000396,ESCOLA VENTÓS I MIR,08015,080155,BADALONA,20,3,23
2020/2021,08000384,ESCOLA LOLA ANGLADA,08015,080155,BADALONA,28,2,30
2020/2021,08000359,ESCOLA LA MUNTANYA,08014,080142,AIGUAFREDA,16,2,18
2020/2021,08000347,ESCOLA D'AVINYONET DEL PENEDÈS,08013,080137,AVINYONET DEL PENEDÈS,10,1,11
2020/2021,08000271,ESCOLA SANTA MARIA D'AVIÀ,08011,080116,AVIÀ,19,1,20
2020/2021,08000244,ESCOLA DOCTOR FERRER,08010,080109,ARTÉS,24,5,29
2020/2021,08000189,ESCOLA BERNAT DE RIUDEMEIA,08009,080095,ARGENTONA,13,3,16
2020/2021,08000098,ESCOLA BERTÍ,08005,080057,L'AMETLLA DEL VALLÈS,24,1,25
2020/2021,08000153,ESCOLA JOAN MARAGALL,08006,080060,ARENYS DE MAR,35,3,38
2020/2021,08000165,ESCOLA SANT MARTÍ,08007,080076,ARENYS DE MUNT,19,7,26
2019/2020,43010414,INSTITUT COSTER DE LA TORRE,43028,430287,LA BISBAL DEL PENEDÈS,38,22,60
2019/2020,08035350,ESCOLA SANT JOSEP,08263,082634,SANT VICENÇ DELS HORTS,30,2,32
2019/2020,43010402,ESCOLA EL ROQUISSAR,43012,430120,ALTAFULLA,15,2,17
2019/2020,43010396,ESCOLA DE PONENT,43148,431482,TARRAGONA,21,2,23
2019/2020,43010372,INSTITUT LA TALAIA,43037,430379,CALAFELL,31,21,52
2019/2020,43010347,INSTITUT MARTA MATA,43905,439057,SALOU,33,12,45
2019/2020,43010335,INSTITUT LA MAR DE LA FRAU,43038,430385,CAMBRILS,31,13,44
2019/2020,43010323,CFA MONTBLANC,43086,430862,MONTBLANC,3,1,4
2019/2020,43010311,CFA RIBERA D'EBRE,43093,430939,MÓRA D'EBRE,3,4,7
2019/2020,43010220,ESCOLA DE MASPUJOLS,43081,430810,MASPUJOLS,13,1,14
2019/2020,43010189,INSTITUT MEDITERRÀNIA,43163,431634,EL VENDRELL,27,17,44
2019/2020,43010177,ESCOLA PLA DE MAR,43163,431634,EL VENDRELL,14,3,17
2019/2020,43010165,ESCOLA MARTA MATA,43163,431634,EL VENDRELL,22,9,31
2019/2020,43010153,ESCOLA VORA MAR,43905,439057,SALOU,29,4,33
2019/2020,43010141,ESCOLA GUILLEM FORTUNY,43038,430385,CAMBRILS,25,6,31
2019/2020,43010098,ESCOLA LA GINESTA,43037,430379,CALAFELL,23,8,31
2019/2020,43010086,CFA VILASECA,43171,431711,VILA-SECA,6,0,6
2019/2020,43010074,CFA VALLS,43161,431613,VALLS,5,2,7
2019/2020,43010062,CFA EL VENDRELL,43163,431634,EL VENDRELL,5,2,7
2019/2020,43010037,EOI DEL VENDRELL,43163,431634,EL VENDRELL,5,2,7
2019/2020,43009977,INSTITUT D'ALTAFULLA,43012,430120,ALTAFULLA,32,24,56
2019/2020,43009898,ESCOLA CASTELL DE CALAFELL,43037,430379,CALAFELL,24,5,29
2019/2020,43009886,ESCOLA JOSEP VECIANA,43103,431037,PERAFORT,15,1,16
2019/2020,43009862,EOI DE TORTOSA,43155,431554,TORTOSA,7,3,10
2019/2020,43009850,INSTITUT ERNEST LLUCH I MARTÍ,43051,430516,CUNIT,49,30,79
2019/2020,43009771,CFA TORTOSA,43155,431554,TORTOSA,6,2,8
2019/2020,43009722,INSTITUT CAL·LÍPOLIS,43148,431482,TARRAGONA,77,32,109
2019/2020,43009710,EOI DE REUS,43123,431233,REUS,8,3,11
2019/2020,43009618,ZER MESTRAL,43155,431554,TORTOSA,3,1,4
2019/2020,43009606,ZER BENISSANET-MIRAVET,43026,430265,BENISSANET,2,2,4
2019/2020,43009497,INSTITUT FONTS DEL GLORIETA,43005,430056,ALCOVER,20,11,31
2019/2020,43009461,ZER TERRA ALTA-CENTRE,43048,430483,CORBERA D'EBRE,2,2,4
2019/2020,43009451,ESCOLA SALOU,43905,439057,SALOU,26,3,29
2019/2020,43009394,ZER LA FONT DE L'AIGUADÍ,43067,430672,GINESTAR,1,2,3
2019/2020,43009370,ZER TERRA ALTA NORD,43175,431750,VILALBA DELS ARCS,3,1,4
2019/2020,43009369,ESCOLA SAAVEDRA,43148,431482,TARRAGONA,17,1,18
2019/2020,43009345,ZER RIBERA D'EBRE NORD,43065,430653,GARCIA,3,1,4
2019/2020,43009321,ZER RIU I SERRA,43025,430252,BENIFALLET,2,1,3
2019/2020,43009311,ZER MONT CARO,43008,430081,ALFARA DE CARLES,4,0,4
2019/2020,43009308,ZER MEDITERRÀNIA,43004,430043,ALCANAR,1,3,4
2019/2020,43009242,ESCOLA L'ANTINA,43153,431536,TORREDEMBARRA,26,4,30
2019/2020,43009230,ESCOLA TARRAGONA,43148,431482,TARRAGONA,21,3,24
2019/2020,43009229,ZER PORTS-ALGARS,43018,430189,ARNES,1,2,3
2019/2020,43009217,ESCOLA DEL POBLE NOU DEL DELTA - ZER MEDITERRÀNIA,43014,430141,AMPOSTA,2,1,3
2019/2020,43009187,INSTITUT MARTÍ L'HUMÀ,43086,430862,MONTBLANC,38,22,60
2019/2020,43009141,ZER POBLET,43176,431763,VIMBODÍ I POBLET,4,0,4
2019/2020,43009138,ZER LA PARELLADA,43059,430593,FIGUEROLA DEL CAMP,3,1,4
2019/2020,43009126,ZER BAIX CAMP SUD,43167,431671,VILANOVA D'ESCORNALBOU,3,1,4
2019/2020,43009114,ZER EL FRANCOLÍ,43161,431613,VALLS,3,0,3
2019/2020,43009096,ZER ELS CEPS,43079,430799,MASLLORENÇ,2,2,4
2019/2020,43009084,ZER MONTSIÀ,43078,430786,MASDENVERGE,4,1,5
2019/2020,43009072,ZER CONCA DE BARBERÀ,43147,431476,SOLIVELLA,4,1,5
2019/2020,43009059,ZER BAIX CAMP NORD,43007,430075,L'ALEIXAR,2,3,5
2019/2020,43009047,ZER BAIX PRIORAT,43114,431140,PORRERA,3,1,4
2019/2020,43009035,ZER ATZAVARA,43098,430982,NULLES,3,1,4
2019/2020,43009023,ZER L'AGLÀ,43069,430691,GRATALLOPS,3,0,3
2019/2020,43009011,ZER RIU AVALL,43149,431495,TIVENYS,4,0,4
2019/2020,43009001,ZER MONTSANT-SERRA DE PRADES,43049,430496,CORNUDELLA DE MONTSANT,3,1,4
2019/2020,43008912,ESCOLA CINTA CURTO,43155,431554,TORTOSA,15,2,17
2019/2020,43008857,CFA REUS,43123,431233,REUS,5,4,9
2019/2020,43008754,CFA SEBASTIÀ JUAN ARBÓ,43014,430141,AMPOSTA,5,1,6
2019/2020,43008729,CFA TARRAGONA,43148,431482,TARRAGONA,8,5,13
2019/2020,43008638,INSTITUT ANTONI BALLESTER,43092,430923,MONT-ROIG DEL CAMP,23,13,36
2019/2020,43008547,ESCOLA CAMBRILS,43038,430385,CAMBRILS,26,3,29
2019/2020,43008535,ESCOLA SOLCUNIT,43051,430516,CUNIT,20,9,29
2019/2020,43008523,INSTITUT VILA-SECA,43171,431711,VILA-SECA,35,22,57
2019/2020,43008511,INSTITUT JOAN PUIG I FERRETER,43145,431457,LA SELVA DEL CAMP,35,19,54
2019/2020,43008501,INSTITUT PONT DEL DIABLE,43148,431482,TARRAGONA,32,8,40
2019/2020,43008481,INSTITUT COLLBLANC,43907,439076,LA CANONJA,40,21,61
2019/2020,43008456,INSTITUT LES PLANES,43138,431384,SANTA BÀRBARA,21,10,31
2019/2020,43008444,INSTITUT JOSEP TAPIRÓ,43123,431233,REUS,48,22,70
2019/2020,43008432,INSTITUT SANT PERE I SANT PAU,43148,431482,TARRAGONA,42,13,55
2019/2020,43008420,INSTITUT ROQUETES,43133,431331,ROQUETES,44,21,65
2019/2020,43008419,INSTITUT CAMARLES,43903,439039,CAMARLES,29,12,41
2019/2020,43008407,INSTITUT EL MORELL,43095,430957,EL MORELL,32,18,50
2019/2020,43008390,INSTITUT TORREFORTA,43148,431482,TARRAGONA,39,16,55
2019/2020,43008389,ESCOLA SANT LLATZER,43155,431554,TORTOSA,13,1,14
2019/2020,43007661,INSTITUT RAMON DE LA TORRE,43153,431536,TORREDEMBARRA,47,17,64
2019/2020,43007658,INSTITUT JOAN GUINJOAN I GISPERT,43129,431299,RIUDOMS,38,23,61
2019/2020,43007646,INSTITUT DE CONSTANTÍ,43047,430477,CONSTANTÍ,31,14,45
2019/2020,43007580,INSTITUT DE L'ARBOÇ,43016,430167,L'ARBOÇ,34,28,62
2019/2020,43007543,INSTITUT JAUME I,43905,439057,SALOU,57,25,82
2019/2020,43007385,INSTITUT D'HORTICULTURA I JARDINERIA,43123,431233,REUS,11,18,29
2019/2020,43007257,INSTITUT CAMÍ DE MAR,43037,430379,CALAFELL,58,31,89
2019/2020,43007233,INSTITUT DE FLIX,43060,430607,FLIX,25,14,39
2019/2020,43007221,INSTITUT ELS ALFACS,43136,431362,SANT CARLES DE LA RÀPITA,50,29,79
2019/2020,43007211,INSTITUT BLANCA D'ANJOU,43104,431042,EL PERELLÓ,14,10,24
2019/2020,43007208,INSTITUT BERENGUER D'ENTENÇA,43162,431628,VANDELLÒS I L'HOSPITALET DE L'INFANT,33,16,49
2019/2020,43007178,ESCOLA MOWGLI,43123,431233,REUS,14,2,16
2019/2020,43007166,INSTITUT LLUÍS DOMÈNECH I MONTANER,43123,431233,REUS,43,47,90
2019/2020,43007129,INSTITUT JULIO ANTONIO,43093,430939,MÓRA D'EBRE,36,28,64
2019/2020,43007117,ESCOLA PAX,43148,431482,TARRAGONA,26,4,30
2019/2020,43007105,ESCOLA MONTSANT,43123,431233,REUS,14,2,16
2019/2020,43007087,INSTITUT SÒL DE RIU,43004,430043,ALCANAR,24,21,45
2019/2020,43007051,CFA JOSEPA MASSANÉS I DALMAU,43148,431482,TARRAGONA,5,6,11
2019/2020,43007038,INSTITUT ESCOLA D'HOTELERIA I TURISME,43038,430385,CAMBRILS,24,23,47
2019/2020,43006988,CEE GARBÍ,43163,431634,EL VENDRELL,15,0,15
2019/2020,43006976,INSTITUT CANDELERA,43013,430136,L'AMETLLA DE MAR,29,18,47
2019/2020,43006964,INSTITUT DE DELTEBRE,43901,439018,DELTEBRE,42,22,64
2019/2020,43006952,INSTITUT TORREDEMBARRA,43153,431536,TORREDEMBARRA,32,22,54
2019/2020,43006940,EOI DE TARRAGONA,43148,431482,TARRAGONA,26,9,35
2019/2020,43006873,ESCOLA RIUMAR,43901,439018,DELTEBRE,11,5,16
2019/2020,43006861,ESCOLA ENXANETA,43161,431613,VALLS,16,1,17
2019/2020,43006851,ESCOLA MOLÍ DE VENT,43153,431536,TORREDEMBARRA,28,3,31
2019/2020,43006708,INSTITUT JOAN SEGURA I VALLS,43139,431397,SANTA COLOMA DE QUERALT,13,5,18
2019/2020,43006691,INSTITUT PRIORAT,43055,430555,FALSET,29,19,48
2019/2020,43006681,INSTITUT DE LA SÉNIA,43044,430445,LA SÉNIA,28,15,43
2019/2020,43006678,INSTITUT GABRIEL FERRATER I SOLER,43123,431233,REUS,51,33,84
2019/2020,43006654,INSTITUT CAMBRILS,43038,430385,CAMBRILS,35,14,49
2019/2020,43006642,INSTITUT TERRA ALTA,43064,430640,GANDESA,33,16,49
2019/2020,43006630,INSTITUT PERE MARTELL,43148,431482,TARRAGONA,33,80,113
2019/2020,43006617,INSTITUT JOAN AMIGÓ I CALLAU,43054,430542,L'ESPLUGA DE FRANCOLÍ,17,8,25
2019/2020,43006587,ESCOLA ÀNGELS GARRIGA,43163,431634,EL VENDRELL,33,6,39
2019/2020,43006575,ESCOLA ELADI HOMS,43161,431613,VALLS,22,2,24
2019/2020,43006563,ESCOLA MARCEL·LÍ DOMINGO,43148,431482,TARRAGONA,25,3,28
2019/2020,43006551,ESCOLA HORTA VELLA,43136,431362,SANT CARLES DE LA RÀPITA,25,6,31
2019/2020,43006541,ESCOLA TERESA MIQUEL I PÀMIES,43123,431233,REUS,25,5,30
2019/2020,43006496,INSTITUT MANUEL SALES I FERRÉ,43156,431567,ULLDECONA,28,16,44
2019/2020,43006393,ESCOLA EUROPA,43905,439057,SALOU,24,6,30
2019/2020,43006371,ESCOLA SANT ROC - ZER CONCA DE BARBERÀ,43130,431303,ROCAFORT DE QUERALT,3,0,3
2019/2020,43006356,ESCOLA MARINADA,43038,430385,CAMBRILS,27,2,29
2019/2020,43006332,ESCOLA MESTRAL,43171,431711,VILA-SECA,23,4,27
2019/2020,43006241,ESCOLA LA PLANA,43171,431711,VILA-SECA,10,3,13
2019/2020,43006228,ESCOLA ROSA SENSAT,43123,431233,REUS,16,4,20
2019/2020,43006216,ESCOLA CÈLIA ARTIGA,43123,431233,REUS,14,2,16
2019/2020,43006186,ESCOLA SORIANO MONTAGUT,43014,430141,AMPOSTA,27,4,31
2019/2020,43006174,ESCOLA LES MORERES,43001,430017,AIGUAMÚRCIA,7,1,8
2019/2020,43006125,INSTITUT CAMPCLAR,43148,431482,TARRAGONA,48,22,70
2019/2020,43006101,INSTITUT MONTSIÀ,43014,430141,AMPOSTA,45,46,91
2019/2020,43006061,ESCOLA RUBIÓ I ORS,43123,431233,REUS,31,6,37
2019/2020,43006046,ESCOLA DIVINA PASTORA - ZER MESTRAL,43155,431554,TORTOSA,3,0,3
2019/2020,43005972,INSTITUT RAMON BARBAT I MIRACLE,43171,431711,VILA-SECA,38,30,68
2019/2020,43005959,ESCOLA CÈSAR AUGUST,43148,431482,TARRAGONA,33,5,38
2019/2020,43005947,ESCOLA CAL·LÍPOLIS,43171,431711,VILA-SECA,23,6,29
2019/2020,43005935,ESCOLA SANT BERNAT CALVÓ,43123,431233,REUS,23,8,31
2019/2020,43005911,ESCOLA CAMPCLAR,43148,431482,TARRAGONA,26,2,28
2019/2020,43005901,ESCOLA JOAN REBULL,43123,431233,REUS,35,5,40
2019/2020,43005893,ESCOLA CENTCELLES,43047,430477,CONSTANTÍ,16,7,23
2019/2020,43005765,ESCOLA EDUARD TODA I GÜELL,43123,431233,REUS,25,5,30
2019/2020,43005753,ESCOLA DOCTOR ALBERICH I CASAS,43123,431233,REUS,30,5,35
2019/2020,43005704,INSTITUT FRANCESC VIDAL I BARRAQUER,43148,431482,TARRAGONA,65,42,107
2019/2020,43005698,ESCOLA MARJAL - ZER MEDITERRÀNIA,43004,430043,ALCANAR,8,2,10
2019/2020,43005686,ESCOLA RIU CLAR,43148,431482,TARRAGONA,15,3,18
2019/2020,43005674,ESCOLA RAVAL DE CRISTO - ZER MONT CARO,43133,431331,ROQUETES,6,2,8
2019/2020,43005662,ESCOLA JOSEP NIN,43135,431359,SALOMÓ,8,2,10
2019/2020,43005650,ESCOLA EL DIVÍ MESTRE - ZER TERRA ALTA NORD,43175,431750,VILALBA DELS ARCS,4,1,5
2019/2020,43005637,ESCOLA MANUEL DE CASTELLVÍ I FELIU - ZER ATZAVARA,43165,431652,VILABELLA,8,0,8
2019/2020,43005625,ESCOLA SANT ANTONI ABAT - ZER MONT CARO,43155,431554,TORTOSA,5,0,5
2019/2020,43005613,ESCOLA SETZE DE FEBRER - ZER MEDITERRÀNIA,43902,439023,SANT JAUME D'ENVEJA,3,0,3
2019/2020,43005601,ESCOLA EL TORMO - ZER RIBERA D'EBRE NORD,43152,431520,LA TORRE DE L'ESPANYOL,4,0,4
2019/2020,43005595,ESCOLA LA PARELLADA,43140,431401,SANTA OLIVA,18,6,24
2019/2020,43005583,ESCOLA ELS QUATRE VENTS,43137,431378,SANT JAUME DELS DOMENYS,20,4,24
2019/2020,43005571,ESCOLA LES COMES,43132,431325,RODONYÀ,13,1,14
2019/2020,43005561,ESCOLA MARE DE DÉU DEL ROSER,43128,431286,RIUDECOLS,8,2,10
2019/2020,43005558,ESCOLA SANT MATEU,43127,431270,RIUDECANYES,10,1,11
2019/2020,43005546,ESCOLA DE LA RIBA - ZER EL FRANCOLÍ,43124,431248,LA RIBA,3,3,6
2019/2020,43005534,ESCOLA LES ERES DE RASQUERA - ZER LA FONT DE L'AIGUADÍ,43121,431212,RASQUERA,7,0,7
2019/2020,43005522,ESCOLA SANTA MARINA,43118,431188,PRATDIP,6,2,8
2019/2020,43005510,ESCOLA SERRA DE PRADES - ZER MONTSANT-SERRA DE PRADES,43116,431166,PRADES,5,0,5
2019/2020,43005509,ESCOLA ROSSEND GIOL - ZER BAIX PRIORAT,43114,431140,PORRERA,2,1,3
2019/2020,43005492,ESCOLA SANTA MAGDALENA - ZER LA PARELLADA,43113,431135,EL PONT D'ARMENTERA,4,1,5
2019/2020,43005480,ESCOLA MARE DE DÉU DEL LLEDÓ,43109,431093,LA POBLA DE MAFUMET,23,7,30
2019/2020,43005479,ESCOLA 1 D'ABRIL - ZER EBRE,43099,430995,LA PALMA D'EBRE,3,0,3
2019/2020,43005467,ESCOLA LES CODINETES,43097,430976,LA NOU DE GAIÀ,11,3,14
2019/2020,43005455,ESCOLA PIUS XII - ZER L'AGLÀ,43085,430859,EL MOLAR,3,0,3
2019/2020,43005443,ESCOLA ROC LLOP I CONVALIA - ZER BENISSANET-MIRAVET,43084,430846,MIRAVET,5,0,5
2019/2020,43005421,ESCOLA BERENGUER DE MONTOLIU - ZER ELS CEPS,43079,430799,MASLLORENÇ,4,3,7
2019/2020,43005418,ESCOLA SANT SALVADOR - ZER MONTSIÀ,43068,430688,GODALL,5,0,5
2019/2020,43005406,ESCOLA EL VERGER - ZER RIBERA D'EBRE NORD,43065,430653,GARCIA,4,0,4
2019/2020,43005391,ESCOLA SANT LLORENÇ - ZER MONTSIÀ,43063,430635,LA GALERA,4,3,7
2019/2020,43005388,ESCOLA MESTRE JOSEP RONCERO I PALLARÈS - ZER MONTSIÀ,43062,430629,FREGINALS,3,1,4
2019/2020,43005376,ESCOLA PUIGMARÍ - ZER BAIX CAMP SUD,43053,430537,DUESAIGÜES,3,0,3
2019/2020,43005364,ESCOLA LES ERES,43050,430509,CREIXELL,15,5,20
2019/2020,43005340,ESCOLA SANTA ANNA,43042,430424,CASTELLVELL DEL CAMP,17,2,19
2019/2020,43005339,ESCOLA MONTSANT - ZER MONTSANT,43027,430271,LA BISBAL DE FALSET,3,0,3
2019/2020,43005327,ESCOLA RAMON SUGRAÑES,43011,430115,ALMOSTER,11,5,16
2019/2020,43005315,ESCOLA D'ALFARA DE CARLES - ZER MONT CARO,43008,430081,ALFARA DE CARLES,4,0,4
2019/2020,43005303,ESCOLA SANT JORDI - ZER RIU I SERRA,43006,430069,ALDOVER,5,1,6
2019/2020,43005297,ESCOLA JOAN PERUCHO,43002,430022,ALBINYANA,11,4,15
2019/2020,43005194,ESCOLA MEDITERRANI,43906,439060,L'AMPOLLA,13,5,18
2019/2020,43005170,ESCOLA LA FLORESTA,43148,431482,TARRAGONA,14,3,17
2019/2020,43005169,ESCOLA PAU DELCLÒS,43148,431482,TARRAGONA,24,7,31
2019/2020,43005157,ESCOLA MONTOLIU,43126,431264,LA RIERA DE GAIÀ,14,2,16
2019/2020,43005145,ESCOLA ELS AMETLLERS,43111,431114,LA POBLA DE MONTORNÈS,13,4,17
2019/2020,43005133,ESCOLA MARE DE DÉU DEL PRIORAT,43020,430206,BANYERES DEL PENEDÈS,13,4,17
2019/2020,43005121,ESCOLA SANTA CATERINA,43178,431785,VINYOLS I ELS ARCS,12,5,17
2019/2020,43005108,ESCOLA LES ERES - ZER RIBERA D'EBRE NORD,43177,431779,VINEBRE,5,0,5
2019/2020,43005081,ESCOLA MARE DE DÉU DELS TORRENTS - ZER POBLET,43176,431763,VIMBODÍ I POBLET,7,1,8
2019/2020,43005017,ESCOLA DEL MONTGOI - ZER POBLET,43172,431726,VILAVERD,3,1,4
2019/2020,43005005,ESCOLA SANT BERNAT CALVÓ,43171,431711,VILA-SECA,25,4,29
2019/2020,43004979,ESCOLA TORROJA I MIRET,43171,431711,VILA-SECA,28,3,31
2019/2020,43004931,ESCOLA SANTA MARIA DEL MAR,43905,439057,SALOU,26,4,30
2019/2020,43004921,ESCOLA BERNARDÍ TOLRÀ,43170,431704,VILA-RODONA,13,3,16
2019/2020,43004888,ESCOLA FONT DE L'ARC - ZER BAIX CAMP SUD,43167,431671,VILANOVA D'ESCORNALBOU,6,1,7
2019/2020,43004864,ESCOLA PERE VIRGILI,43166,431665,VILALLONGA DEL CAMP,23,4,27
2019/2020,43004815,ESCOLA PAU CASALS,43163,431634,EL VENDRELL,26,5,31
2019/2020,43004803,INSTITUT ANDREU NIN,43163,431634,EL VENDRELL,70,58,128
2019/2020,43004797,INSTITUT BAIX PENEDÈS,43163,431634,EL VENDRELL,44,27,71
2019/2020,43004748,ESCOLA ÀNGEL GUIMERÀ,43163,431634,EL VENDRELL,32,6,38
2019/2020,43004736,ESCOLA ELS SECALLETS,43163,431634,EL VENDRELL,13,6,19
2019/2020,43004700,ESCOLA VALDELORS,43162,431628,VANDELLÒS I L'HOSPITALET DE L'INFANT,8,2,10
2019/2020,43004657,ESCOLA MESTRAL,43162,431628,VANDELLÒS I L'HOSPITALET DE L'INFANT,35,7,42
2019/2020,43004633,ESCOLA EUGENI D'ORS,43161,431613,VALLS,27,4,31
2019/2020,43004611,INSTITUT JAUME HUGUET,43161,431613,VALLS,59,44,103
2019/2020,43004608,INSTITUT NARCÍS OLLER,43161,431613,VALLS,55,29,84
2019/2020,43004530,ESCOLA BALTASAR SEGÚ,43161,431613,VALLS,15,5,20
2019/2020,43004529,ESCOLA MARE DE DÉU DE LA CANDELA,43161,431613,VALLS,16,4,20
2019/2020,43004517,ESCOLA ROCABRUNA - ZER EL FRANCOLÍ,43161,431613,VALLS,6,1,7
2019/2020,43004505,ESCOLA MARE DE DÉU DEL ROSER,43160,431606,VALLMOLL,13,2,15
2019/2020,43004487,ESCOLA MONTSANT - ZER MONTSANT-SERRA DE PRADES,43157,431573,ULLDEMOLINS,2,1,3
2019/2020,43004463,ESCOLA RAMÓN Y CAJAL,43156,431567,ULLDECONA,34,9,43
2019/2020,43004441,INSTITUT DE L'EBRE,43155,431554,TORTOSA,57,57,114
2019/2020,43004438,INSTITUT DERTOSA,43155,431554,TORTOSA,59,41,100
2019/2020,43004268,ESCOLA REMOLINS,43155,431554,TORTOSA,16,4,20
2019/2020,43004256,ESCOLA FERRERIES,43155,431554,TORTOSA,24,11,35
2019/2020,43004244,ESCOLA EL TEMPLE,43155,431554,TORTOSA,29,5,34
2019/2020,43004232,ESCOLA LA MERCÈ,43155,431554,TORTOSA,18,6,24
2019/2020,43004189,ESCOLA SANT JAUME,43902,439023,SANT JAUME D'ENVEJA,17,2,19
2019/2020,43004116,ESCOLA DEL LLIGALLO DEL GÀNGUIL - ZER MESTRAL,43903,439039,CAMARLES,6,2,8
2019/2020,43004074,ESCOLA L'ASSUMPCIÓ,43901,439018,DELTEBRE,18,6,24
2019/2020,43004050,ESCOLA 21 D'ABRIL,43904,439044,L'ALDEA,14,3,17
2019/2020,43004037,ESCOLA MARIA GARCÍA I CABANES,43904,439044,L'ALDEA,13,4,17
2019/2020,43004013,ESCOLA SANT MIQUEL,43901,439018,DELTEBRE,25,8,33
2019/2020,43003987,ESCOLA PORT RODÓ - ZER MESTRAL,43155,431554,TORTOSA,10,0,10
2019/2020,43003975,ESCOLA SANT ÀNGEL,43903,439039,CAMARLES,13,3,16
2019/2020,43003951,ESCOLA BÍTEM - ZER RIU AVALL,43155,431554,TORTOSA,8,1,9
2019/2020,43003884,ESCOLA ANTONI ROIG,43153,431536,TORREDEMBARRA,25,6,31
2019/2020,43003847,ESCOLA MARCEL·LÍ DOMINGO,43150,431508,TIVISSA,11,1,12
2019/2020,43003835,ESCOLA JOSEP RIBA - ZER LES VINYES,43150,431508,TIVISSA,3,0,3
2019/2020,43003801,ESCOLA LA PINEDA - ZER RIU AVALL,43149,431495,TIVENYS,5,1,6
2019/2020,43003768,ESCOLA ELS ÀNGELS,43148,431482,TARRAGONA,37,3,40
2019/2020,43003756,ESCOLA TORREFORTA,43148,431482,TARRAGONA,24,8,32
2019/2020,43003732,INSTITUT PONS D'ICART,43148,431482,TARRAGONA,35,20,55
2019/2020,43003720,ESCOLA EL MIRACLE,43148,431482,TARRAGONA,19,0,19
2019/2020,43003690,ESCOLA DE PRÀCTIQUES,43148,431482,TARRAGONA,24,6,30
2019/2020,43003653,INSTITUT COMTE DE RIUS,43148,431482,TARRAGONA,42,54,96
2019/2020,43003641,INSTITUT ANTONI DE MARTÍ I FRANQUÈS,43148,431482,TARRAGONA,73,39,112
2019/2020,43003321,ESCOLA SANT PERE I SANT PAU,43148,431482,TARRAGONA,20,2,22
2019/2020,43003306,ESCOLA SERRALLO,43148,431482,TARRAGONA,20,1,21
2019/2020,43003227,ESCOLA SANT SALVADOR,43148,431482,TARRAGONA,30,9,39
2019/2020,43003185,ESCOLA LA CANONJA,43907,439076,LA CANONJA,36,5,41
2019/2020,43003136,ESCOLA BONAVISTA,43148,431482,TARRAGONA,35,5,40
2019/2020,43003124,ESCOLA SAGRAT COR - ZER CONCA DE BARBERÀ,43147,431476,SOLIVELLA,4,1,5
2019/2020,43003100,ESCOLA ABEL FERRATER,43145,431457,LA SELVA DEL CAMP,28,4,32
2019/2020,43003082,ESCOLA GUILLEM DE CLARAMUNT,43144,431444,LA SECUITA,13,2,15
2019/2020,43003069,ESCOLA SALVADOR NINOT,43142,431423,SARRAL,14,2,16
2019/2020,43003011,ESCOLA COR DE ROURE,43139,431397,SANTA COLOMA DE QUERALT,12,4,16
2019/2020,43003008,ESCOLA JAUME BALMES,43138,431384,SANTA BÀRBARA,21,6,27
2019/2020,43002892,ESCOLA CARLES III,43136,431362,SANT CARLES DE LA RÀPITA,37,6,43
2019/2020,43002831,ESCOLA MESTRE MARCEL·LÍ DOMINGO,43133,431331,ROQUETES,35,9,44
2019/2020,43002776,ESCOLA SALVADOR ESPRIU,43131,431310,RODA DE BERÀ,19,6,25
2019/2020,43002752,ESCOLA BEAT BONAVENTURA GRAN,43129,431299,RIUDOMS,28,2,30
2019/2020,43002661,ESCOLA SANT AGUSTÍ - ZER EBRE,43125,431251,RIBA-ROJA D'EBRE,8,0,8
2019/2020,43002594,INSTITUT BAIX CAMP,43123,431233,REUS,87,52,139
2019/2020,43002582,INSTITUT SALVADOR VILASECA,43123,431233,REUS,43,19,62
2019/2020,43002570,INSTITUT GAUDÍ,43123,431233,REUS,62,19,81
2019/2020,43002272,ESCOLA GENERAL PRIM,43123,431233,REUS,22,4,26
2019/2020,43002260,ESCOLA CIUTAT DE REUS,43123,431233,REUS,7,1,8
2019/2020,43002259,ESCOLA MARIÀ FORTUNY,43123,431233,REUS,30,7,37
2019/2020,43002247,ESCOLA MISERICÒRDIA,43123,431233,REUS,16,6,22
2019/2020,43002235,ESCOLA POMPEU FABRA,43123,431233,REUS,16,5,21
2019/2020,43002211,ESCOLA PRAT DE LA RIBA,43123,431233,REUS,14,3,17
2019/2020,43002171,ESCOLA JOAN PLANA,43119,431191,PUIGPELAT,14,1,15
2019/2020,43002144,ESCOLA MARE DE DÉU DE LA FONTCALDA - ZER PORTS-ALGARS,43117,431172,PRAT DE COMTE,3,0,3
2019/2020,43002053,ESCOLA GARBÍ - ZER MONTSANT-SERRA DE PRADES,43112,431129,POBOLEDA,2,1,3
2019/2020,43002016,ESCOLA L'AMETLLER - ZER TERRA ALTA NORD,43110,431107,LA POBLA DE MASSALUCA,3,0,3
2019/2020,43001966,ESCOLA SANT RAMON,43108,431080,EL PLA DE SANTA MARIA,13,3,16
2019/2020,43001954,ESCOLA ANTONI TOUS - ZER CONCA DE BARBERÀ,43107,431074,PIRA,4,3,7
2019/2020,43001942,ESCOLA CÈSAR MARTINELL - ZER TERRA ALTA-CENTRE,43106,431068,EL PINELL DE BRAI,5,2,7
2019/2020,43001929,ESCOLA JAUME II,43104,431042,EL PERELLÓ,16,6,22
2019/2020,43001851,ESCOLA SANT ROC - ZER RIU I SERRA,43102,431021,PAÜLS,6,0,6
2019/2020,43001826,ESCOLA SANT SEBASTIÀ,43100,431009,ELS PALLARESOS,19,5,24
2019/2020,43001796,ESCOLA SANT SEBASTIÀ - ZER ATZAVARA,43098,430982,NULLES,5,3,8
2019/2020,43001735,ESCOLA VENTURA GASSOL,43095,430957,EL MORELL,30,3,33
2019/2020,43001681,ESCOLA LLUÍS VIÑAS I VIÑOLES,43093,430939,MÓRA D'EBRE,29,2,31
2019/2020,43001668,ESCOLA MARE DE DÉU DE LA ROCA,43092,430923,MONT-ROIG DEL CAMP,25,7,32
2019/2020,43001656,ESCOLA TERESA GODES I DOMÈNECH,43090,430901,EL MONTMELL,10,4,14
2019/2020,43001607,ESCOLA JOSEP M. SOLER I GENÉ,43088,430884,MONTBRIÓ DEL CAMP,19,4,23
2019/2020,43001553,ESCOLA LES MURALLES,43086,430862,MONTBLANC,30,3,33
2019/2020,43001498,ESCOLA ONZE DE SETEMBRE - ZER BAIX PRIORAT,43082,430825,EL MASROIG,4,0,4
2019/2020,43001462,ESCOLA ELS TIL·LERS - ZER EL FRANCOLÍ,43080,430803,LA MASÓ,2,1,3
2019/2020,43001437,ESCOLA ROSA GISBERT - ZER MONTSIÀ,43078,430786,MASDENVERGE,6,2,8
2019/2020,43001395,ESCOLA TERESA SUBIRATS I MESTRE - ZER MONTSIÀ,43077,430770,MAS DE BARBERANS,4,1,5
2019/2020,43001383,ESCOLA ANICET VILLAR - ZER LES VINYES,43076,430764,MARÇÀ,4,0,4
2019/2020,43001361,ESCOLA LES COMETES,43074,430748,LLORENÇ DEL PENEDÈS,18,6,24
2019/2020,43001346,ESCOLA MONTSAGRE,43071,430712,HORTA DE SANT JOAN,11,0,11
2019/2020,43001334,ESCOLA SANT FELIU - ZER LES VINYES,43070,430705,ELS GUIAMETS,3,0,3
2019/2020,43001310,ESCOLA LLICORELLA - ZER L'AGLÀ,43069,430691,GRATALLOPS,3,0,3
2019/2020,43001280,ESCOLA PÀMIES - ZER LA FONT DE L'AIGUADÍ,43067,430672,GINESTAR,6,0,6
2019/2020,43001231,ESCOLA PUIG CAVALLER,43064,430640,GANDESA,20,8,28
2019/2020,43001127,ESCOLA ENRIC GRAU I FONTSERÈ,43060,430607,FLIX,17,4,21
2019/2020,43001115,ESCOLA MARE DE DÉU DE L'ESPERANÇA - ZER LA PARELLADA,43059,430593,FIGUEROLA DEL CAMP,5,0,5
2019/2020,43001097,ESCOLA LOS CASTELLETS - ZER TERRA ALTA NORD,43056,430568,LA FATARELLA,7,0,7
2019/2020,43001051,ESCOLA ANTONI VILANOVA,43055,430555,FALSET,24,3,27
2019/2020,43001036,ESCOLA MARTÍ POCH,43054,430542,L'ESPLUGA DE FRANCOLÍ,13,2,15
2019/2020,43001000,ESCOLA DE XERTA,43052,430521,XERTA,9,1,10
2019/2020,43000998,ESCOLA POMPEU FABRA,43051,430516,CUNIT,22,6,28
2019/2020,43000950,ESCOLA DOCTOR FERRAN - ZER TERRA ALTA-CENTRE,43048,430483,CORBERA D'EBRE,6,1,7
2019/2020,43000895,ESCOLA MOSSÈN RAMON BERGADÀ,43047,430477,CONSTANTÍ,29,7,36
2019/2020,43000871,ESCOLA JAUME I,43044,430445,LA SÉNIA,32,4,36
2019/2020,43000809,ESCOLA LA GESSERA - ZER PORTS-ALGARS,43041,430419,CASERES,4,0,4
2019/2020,43000792,ESCOLA SANT ISIDRE - ZER LES VINYES,43040,430402,CAPÇANES,3,1,4
2019/2020,43000779,INSTITUT RAMON BERENGUER IV,43038,430385,CAMBRILS,42,25,67
2019/2020,43000731,ESCOLA JOAN ARDÈVOL,43038,430385,CAMBRILS,20,7,27
2019/2020,43000721,ESCOLA MOSSÈN JACINT VERDAGUER,43037,430379,CALAFELL,31,4,35
2019/2020,43000706,ESCOLA SANTA CREU DE CALAFELL,43037,430379,CALAFELL,29,8,37
2019/2020,43000688,ESCOLA DE CABRA DEL CAMP - ZER LA PARELLADA,43036,430363,CABRA DEL CAMP,3,2,5
2019/2020,43000676,ESCOLA EL CASTELL - ZER MONTSANT,43035,430350,CABACÉS,4,0,4
2019/2020,43000652,ESCOLA SANT JAUME DE BRÀFIM - ZER ATZAVARA,43034,430347,BRÀFIM,7,2,9
2019/2020,43000640,ESCOLA MARE DE DÉU DE LA CANDELA,43033,430332,BOTARELL,15,0,15
2019/2020,43000639,ESCOLA SANT BLAI - ZER TERRA ALTA-CENTRE,43032,430326,BOT,5,0,5
2019/2020,43000627,ESCOLA ROCABRUNA,43031,430311,LES BORGES DEL CAMP,12,4,16
2019/2020,43000615,ESCOLA L'ESTEL - ZER ELS CEPS,43030,430304,BONASTRE,3,4,7
2019/2020,43000603,ESCOLA DE BLANCAFORT - ZER POBLET,43029,430290,BLANCAFORT,3,0,3
2019/2020,43000597,ESCOLA ULL DEL VENT,43028,430287,LA BISBAL DEL PENEDÈS,18,5,23
2019/2020,43000561,ESCOLA ANTONI NAT - ZER BENISSANET-MIRAVET,43026,430265,BENISSANET,7,1,8
2019/2020,43000551,ESCOLA LLORENÇ VALLESPÍ I VIDIELLA - ZER RIU I SERRA,43025,430252,BENIFALLET,5,0,5
2019/2020,43000548,ESCOLA LA MUNTANYETA,43024,430249,BELLVEI,16,5,21
2019/2020,43000512,ESCOLA EL SARRAÍ - ZER BAIX PRIORAT,43023,430234,BELLMUNT DEL PRIORAT,1,1,2
2019/2020,43000470,ESCOLA VALLDEMUR - ZER CONCA DE BARBERÀ,43021,430213,BARBERÀ DE LA CONCA,6,1,7
2019/2020,43000433,ESCOLA SANT MIQUEL,43019,430192,ASCÓ,14,1,15
2019/2020,43000421,ESCOLA LA MIRANDA - ZER PORTS-ALGARS,43018,430189,ARNES,5,1,6
2019/2020,43000378,ESCOLA SANT JULIÀ,43016,430167,L'ARBOÇ,24,9,33
2019/2020,43000329,INSTITUT RAMON BERENGUER IV,43014,430141,AMPOSTA,50,30,80
2019/2020,43000275,ESCOLA MIQUEL GRANELL,43014,430141,AMPOSTA,25,6,31
2019/2020,43000263,ESCOLA SANT JORDI,43013,430136,L'AMETLLA DE MAR,35,4,39
2019/2020,43000251,ESCOLA LA PORTALADA,43012,430120,ALTAFULLA,27,2,29
2019/2020,43000226,ESCOLA LA BARQUERA - ZER ATZAVARA,43010,430108,ALIÓ,3,0,3
2019/2020,43000214,ESCOLA JOSEP FUSTÉ,43009,430094,ALFORJA,16,0,16
2019/2020,43000184,ESCOLA TERESA SALVAT I LLAURADÓ - ZER BAIX CAMP NORD,43007,430075,L'ALEIXAR,6,0,6
2019/2020,43000135,ESCOLA MARE DE DÉU DEL REMEI,43005,430056,ALCOVER,30,5,35
2019/2020,43000081,ESCOLA JOAN BAPTISTA SERRA,43004,430043,ALCANAR,44,4,48
2019/2020,43000020,ESCOLA SANT MIQUEL,43001,430017,AIGUAMÚRCIA,6,2,8
2019/2020,25010334,INSTITUT ESCOLA MAGRANERS,25120,251207,LLEIDA,16,6,22
2019/2020,25010310,INSTITUT DE MOLLERUSSA IV,25137,251370,MOLLERUSSA,11,0,11
2019/2020,25010280,INSTITUT ESCOLA TORRE QUERALT,25120,251207,LLEIDA,28,9,37
2019/2020,25010231,ESCOLA DE SALÀS DE PALLARS - ZER PALLARS JUSSÀ,25190,251902,SALÀS DE PALLARS,3,0,3
2019/2020,25010127,INSTITUT CASTELL DELS TEMPLERS,25120,251207,LLEIDA,19,13,32
2019/2020,25010085,ESCOLA JOSEP MAÑÉ I GAVALDÀ - ZER PONENT,25120,251207,LLEIDA,6,0,6
2019/2020,25009836,INSTITUT LA MITJANA,25120,251207,LLEIDA,43,7,50
2019/2020,25009800,ESCOLA TORRELAMEU - ZER ARGELAGA,25231,252311,TORRELAMEU,6,0,6
2019/2020,25009733,INSTITUT JOAN SOLÀ,25228,252287,TORREFARRERA,36,14,50
2019/2020,25009721,INSTITUT D'ALPICAT,25023,250236,ALPICAT,14,3,17
2019/2020,25009368,ESCOLA LA VALIRA,25203,252038,LA SEU D'URGELL,7,1,8
2019/2020,25009356,ESCOLA LES ARRELS,25137,251370,MOLLERUSSA,16,3,19
2019/2020,25009344,ESCOLA LA MITJANA,25120,251207,LLEIDA,26,3,29
2019/2020,25009186,INSTITUT LA VALIRA,25203,252038,LA SEU D'URGELL,15,5,20
2019/2020,25009149,ESCOLA PINYANA,25120,251207,LLEIDA,18,7,25
2019/2020,25009113,ESCOLA MESTRE RAMON ESTADELLA I TORRADEFLOT,25110,251109,GUISSONA,23,2,25
2019/2020,25009101,ESCOLA EL VINYET,25207,252075,SOLSONA,17,0,17
2019/2020,25009095,ESCOLA LES SAVINES,25072,250729,CERVERA,15,1,16
2019/2020,25009071,ESCOLA PAÏSOS CATALANS,25120,251207,LLEIDA,29,3,32
2019/2020,25009034,ESCOLA CIUTAT JARDÍ,25120,251207,LLEIDA,26,4,30
2019/2020,25009009,ZER EL SOLSONÈS,25207,252075,SOLSONA,4,1,5
2019/2020,25008984,CFA TREMP,25234,252347,TREMP,3,0,3
2019/2020,25008935,ESCOLA LA RÀPITA - ZER EL JONC,25240,252402,VALLFOGONA DE BALAGUER,5,0,5
2019/2020,25008923,CFA ENRIC GRANADOS,25120,251207,LLEIDA,8,7,15
2019/2020,25008893,ESCOLA PARC DEL SALADAR,25011,250117,ALCARRÀS,33,6,39
2019/2020,25008790,ESCOLA MARIA-MERCÈ MARÇAL,25217,252173,TÀRREGA,18,5,23
2019/2020,25008789,ESCOLA MONT-ROIG,25040,250404,BALAGUER,19,4,23
2019/2020,25008777,ESCOLA PARC DE L'AIGUA,25120,251207,LLEIDA,25,6,31
2019/2020,25008765,ESCOLA LA VALL FOSCA - ZER PALLARS JUSSÀ,25227,252271,LA TORRE DE CABDELLA,6,0,6
2019/2020,25008753,CFA SOLSONÈS,25207,252075,SOLSONA,6,0,6
2019/2020,25008741,CFA VAL D'ARAN,25243,252430,VIELHA E MIJARAN,1,2,3
2019/2020,25008649,ESCOLA FRANCESCO TONUCCI,25120,251207,LLEIDA,17,1,18
2019/2020,25008625,CFA MOLLERUSSA,25137,251370,MOLLERUSSA,6,3,9
2019/2020,25008595,CFA TÀRREGA,25217,252173,TÀRREGA,4,2,6
2019/2020,25008583,CFA LA SEU D'URGELL,25203,252038,LA SEU D'URGELL,5,1,6
2019/2020,25008571,CFA JOAN COMORERA,25072,250729,CERVERA,1,3,4
2019/2020,25008561,CFA BALAGUER,25040,250404,BALAGUER,1,3,4
2019/2020,25008558,EOI DE LA SEU D'URGELL,25203,252038,LA SEU D'URGELL,6,2,8
2019/2020,25008546,EOI DE TÀRREGA,25217,252173,TÀRREGA,5,1,6
2019/2020,25008534,ESCOLA DE LA VALL DE BOÍ - ZER ALTA RIBAGORÇA,25043,250432,LA VALL DE BOÍ,7,0,7
2019/2020,25008352,INSTITUT DE LA POBLA DE SEGUR,25171,251713,LA POBLA DE SEGUR,25,14,39
2019/2020,25008248,INSTITUT DE SANT LLORENÇ DE MORUNYS,25193,251930,SANT LLORENÇ DE MORUNYS,4,3,7
2019/2020,25008236,ZER PEDRERA,25081,250812,L'ESPLUGA CALBA,2,1,3
2019/2020,25008224,ZER ARGELAGA,25254,252542,VILANOVA DE LA BARCA,2,1,3
2019/2020,25008212,ESCOLA PRÀCTIQUES II,25120,251207,LLEIDA,28,2,30
2019/2020,25008157,ZER RIU ONDARA,25225,252252,TORNABOUS,3,1,4
2019/2020,25008145,ZER ALT SEGRIÀ,25251,252516,VILANOVA DE SEGRIÀ,3,1,4
2019/2020,25008133,ZER PONENT,25120,251207,LLEIDA,2,2,4
2019/2020,25008111,ZER LA COMA,25211,252115,SUDANELL,3,0,3
2019/2020,25008108,ZER L'ERAL,25200,252000,SARROCA DE LLEIDA,4,0,4
2019/2020,25008091,ZER VENT SERÈ,25068,250680,CASTELLNOU DE SEANA,3,1,4
2019/2020,25008081,ZER EL JONC,25062,250621,CAMARASA,3,1,4
2019/2020,25008078,ZER EL ROMANÍ,25138,251386,MONTGAI,3,1,4
2019/2020,25008066,ZER ESPERNALLAC,25070,250707,CASTELLSERÀ,3,1,4
2019/2020,25008054,ZER VALL DE L'ARANYÓ,25067,250674,CASTELLDANS,3,1,4
2019/2020,25008042,ZER RIU SET,25009,250096,L'ALBI,3,1,4
2019/2020,25007992,ESCOLA D'ALMENAR,25021,250215,ALMENAR,17,4,21
2019/2020,25007943,ZER PLAURCÉN,25168,251689,EL POAL,3,1,4
2019/2020,25007931,ZER VAL D'ARAN,25025,250254,NAUT ARAN,3,1,4
2019/2020,25007921,ZER L'HORTA DE LLEIDA,25120,251207,LLEIDA,4,0,4
2019/2020,25007918,ZER L'OLIVER,25133,251333,MAIALS,3,1,4
2019/2020,25007906,ZER SERRA LLARGA,25015,250156,ALGERRI,2,2,4
2019/2020,25007891,ZER ALTA RIBAGORÇA,25245,252458,VILALLER,4,1,5
2019/2020,25007888,ZER GARRIGUES ALTES,25118,251180,JUNCOSA,2,2,4
2019/2020,25007876,ZER RIU CORB,25046,250463,BELIANES,3,1,4
2019/2020,25007864,ZER URGELLET,25203,252038,LA SEU D'URGELL,3,1,4
2019/2020,25007852,ZER EL SIÓ,25138,251386,MONTGAI,3,1,4
2019/2020,25007840,ZER MONTSEC,25037,250371,LES AVELLANES I SANTA LINYA,3,1,4
2019/2020,25007839,ZER PALLARS JUSSÀ,25115,251155,ISONA I CONCA DELLÀ,3,1,4
2019/2020,25007827,ZER NARIEDA,25155,251556,ORGANYÀ,3,1,4
2019/2020,25007815,ZER ELAIA,25101,251018,LA GRANADELLA,2,1,3
2019/2020,25007803,ZER ALT PALLARS SOBIRÀ,25126,251266,LLAVORSÍ,4,0,4
2019/2020,25007797,ZER BARIDÀ-BATLLIA,25139,251399,MONTELLÀ I MARTINET,2,2,4
2019/2020,25007773,ZER LA SEGARRA,25905,259059,RIBERA D'ONDARA,2,2,4
2019/2020,25007761,ZER GUICIVERVI,25244,252445,VILAGRASSA,4,0,4
2019/2020,25007700,INSTITUT ERMENGOL IV,25047,250479,BELLCAIRE D'URGELL,26,5,31
2019/2020,25007611,CFA JOAN CARLES I,25120,251207,LLEIDA,7,5,12
2019/2020,25007529,INSTITUT SERÒS,25204,252043,SERÒS,24,12,36
2019/2020,25007517,INSTITUT LA SERRA,25137,251370,MOLLERUSSA,36,22,58
2019/2020,25007505,INSTITUT DE GUISSONA,25110,251109,GUISSONA,47,20,67
2019/2020,25007499,INSTITUT L'OLIVERA,25101,251018,LA GRANADELLA,7,5,12
2019/2020,25007189,INSTITUT MARIA RÚBIES,25120,251207,LLEIDA,37,22,59
2019/2020,25007153,INSTITUT D'ALCARRÀS,25011,250117,ALCARRÀS,42,18,60
2019/2020,25007025,INSTITUT MORELLÓ,25086,250864,ESTERRI D'ÀNEU,6,6,12
2019/2020,25006781,INSTITUT ALFONS COSTAFREDA,25217,252173,TÀRREGA,45,30,75
2019/2020,25006771,INSTITUT RONDA,25120,251207,LLEIDA,68,15,83
2019/2020,25006744,CEE ESPERANÇA,25120,251207,LLEIDA,9,4,13
2019/2020,25006732,INSTITUT TORREVICENS,25120,251207,LLEIDA,99,24,123
2019/2020,25006720,INSTITUT D'HOTELERIA I TURISME,25120,251207,LLEIDA,13,15,28
2019/2020,25006598,INSTITUT LO PLA D'URGELL,25050,250501,BELLPUIG,26,19,45
2019/2020,25006574,INSTITUT DE PONTS,25172,251728,PONTS,16,6,22
2019/2020,25006549,ESCOLA D'ESPLUGA DE SERRA - ZER ALTA RIBAGORÇA,25234,252347,TREMP,2,0,2
2019/2020,25006525,INSTITUT JOSEP VALLVERDÚ,25058,250582,LES BORGES BLANQUES,43,21,64
2019/2020,25006513,INSTITUT MANUEL DE MONTSUAR,25120,251207,LLEIDA,32,13,45
2019/2020,25006501,ESCOLA ALBA,25078,250788,CORBINS,24,5,29
2019/2020,25006495,INSTITUT JOSEP LLADONOSA,25120,251207,LLEIDA,35,22,57
2019/2020,25006483,INSTITUT CANIGÓ,25019,250194,ALMACELLES,26,14,40
2019/2020,25006471,INSTITUT AUBENÇ,25149,251497,OLIANA,9,8,17
2019/2020,25006410,CFA SEGRIÀ,25120,251207,LLEIDA,6,5,11
2019/2020,25006409,ESCOLA JOC DE LA BOLA,25120,251207,LLEIDA,32,1,33
2019/2020,25006291,INSTITUT HUG ROGER III,25209,252094,SORT,26,11,37
2019/2020,25006288,INSTITUT DE TREMP,25234,252347,TREMP,32,18,50
2019/2020,25006276,ESCOLA SANT JORDI,25120,251207,LLEIDA,13,3,16
2019/2020,25006264,ESCOLA ESPIGA,25120,251207,LLEIDA,24,4,28
2019/2020,25006252,EOI DE LLEIDA,25120,251207,LLEIDA,31,10,41
2019/2020,25006240,INSTITUT EL PONT DE SUERT,25173,251734,EL PONT DE SUERT,26,19,45
2019/2020,25006239,INSTITUT D'ARAN,25243,252430,VIELHA E MIJARAN,40,19,59
2019/2020,25006227,INSTITUT D'ALMENAR,25021,250215,ALMENAR,28,15,43
2019/2020,25006148,INSTITUT D'OSTALARIA DE LES-VAL D'ARAN,25121,251214,LES,5,5,10
2019/2020,25006069,ESCOLA D'ARDÈVOL - ZER EL SOLSONÈS,25167,251673,PINÓS,3,0,3
2019/2020,25005983,ESCOLA SANT SERNI - ZER BARIDÀ-BATLLIA,25175,251752,PRATS I SANSOR,3,1,4
2019/2020,25005910,ESCOLA ABAT RUERA - ZER PEDRERA,25180,251804,PUIGGRÒS,4,1,5
2019/2020,25005909,ESCOLA MOSSÈN RAMON MUNTANYOLA - ZER RIU CORB,25154,251543,ELS OMELLS DE NA GAIA,0,2,2
2019/2020,25005892,ESCOLA MALDANELL - ZER RIU CORB,25130,251305,MALDÀ,1,1,2
2019/2020,25005880,ESCOLA FREDERIC GODAS,25120,251207,LLEIDA,27,5,32
2019/2020,25005727,INSTITUT ALMATÀ,25040,250404,BALAGUER,38,17,55
2019/2020,25005685,INSTITUT LA SEGARRA,25072,250729,CERVERA,49,17,66
2019/2020,25005673,ESCOLA JOAN MARAGALL,25120,251207,LLEIDA,23,4,27
2019/2020,25005582,INSTITUT TERRES DE PONENT,25137,251370,MOLLERUSSA,38,9,47
2019/2020,25005557,CEE SILOÉ,25137,251370,MOLLERUSSA,9,1,10
2019/2020,25005545,ESCOLA POMPEU FABRA,25137,251370,MOLLERUSSA,27,2,29
2019/2020,25005533,ESCOLA PAU CLARIS,25203,252038,LA SEU D'URGELL,20,1,21
2019/2020,25005454,INSTITUT FRANCESC RIBALTA,25207,252075,SOLSONA,39,16,55
2019/2020,25005442,INSTITUT ESCOLA DEL TREBALL,25120,251207,LLEIDA,41,29,70
2019/2020,25005430,ESCOLA JOAN XXIII,25120,251207,LLEIDA,23,6,29
2019/2020,25005429,INSTITUT ELS PLANELLS,25034,250349,ARTESA DE SEGRE,27,4,31
2019/2020,25005260,INSTITUT RIBERA DEL SIÓ,25003,250030,AGRAMUNT,24,11,35
2019/2020,25005171,ESCOLA MESTRE IGNASI PERAIRE,25137,251370,MOLLERUSSA,25,7,32
2019/2020,25005144,ESCOLA ÀNGEL SERAFÍ I CASANOVAS,25209,252094,SORT,22,2,24
2019/2020,25005132,ESCOLA SANT JORDI,25149,251497,OLIANA,15,0,15
2019/2020,25005120,ESCOLA TERESA BERGADÀ,25016,250169,ALGUAIRE,19,1,20
2019/2020,25005119,ESCOLA PINYANA,25013,250138,ALFARRÀS,20,1,21
2019/2020,25005107,ESCOLA SANT BONIFACI - ZER RIU SET,25255,252555,VINAIXA,2,1,3
2019/2020,25005090,ESCOLA MESTRAL - ZER ARGELAGA,25254,252542,VILANOVA DE LA BARCA,7,1,8
2019/2020,25005077,ESCOLA MOSSÈN TON CLAVÉ - ZER VENT SERÈ,25252,252521,VILA-SANA,8,0,8
2019/2020,25005065,ESCOLA DE VILANOVA DE SEGRIÀ - ZER ALT SEGRIÀ,25251,252516,VILANOVA DE SEGRIÀ,7,0,7
2019/2020,25005053,ESCOLA MARE DE DÉU DEL PUIG DE MEIÀ - ZER EL ROMANÍ,25250,252509,VILANOVA DE MEIÀ,3,1,4
2019/2020,25005016,ESCOLA MARINADA,25248,252483,VILANOVA DE BELLPUIG,12,3,15
2019/2020,25004981,ESCOLA VIDAL I ABAD - ZER ALTA RIBAGORÇA,25245,252458,VILALLER,4,1,5
2019/2020,25004966,ESCOLA RAMON PERELLÓ - ZER GUICIVERVI,25244,252445,VILAGRASSA,7,1,8
2019/2020,25004929,ESCOLA GARONA,25243,252430,VIELHA E MIJARAN,37,4,41
2019/2020,25004863,ESCOLA JARDÍ - ZER GUICIVERVI,25242,252424,VERDÚ,5,3,8
2019/2020,25004851,ESCOLA SALVADOR ESPRIU,25240,252402,VALLFOGONA DE BALAGUER,13,2,15
2019/2020,25004826,ESCOLA DE TUIXENT - ZER URGELLET,25910,259101,JOSA I TUIXÉN,3,0,3
2019/2020,25004772,ESCOLA VALLDEFLORS,25234,252347,TREMP,27,4,31
2019/2020,25004759,ESCOLA EL ROSER - ZER ALT SEGRIÀ,25233,252332,TORRE-SERONA,3,0,3
2019/2020,25004747,ESCOLA CARRASSUMADA,25232,252326,TORRES DE SEGRE,15,0,15
2019/2020,25004723,ESCOLA LA BASSA,25230,252304,TORREGROSSA,15,2,17
2019/2020,25004711,ESCOLA LA CREU,25228,252287,TORREFARRERA,33,5,38
2019/2020,25004656,ESCOLA DE TORREBESSES - ZER L'ERAL,25226,252265,TORREBESSES,2,1,3
2019/2020,25004644,ESCOLA ESPÍGOL - ZER RIU ONDARA,25225,252252,TORNABOUS,7,0,7
2019/2020,25004607,ESCOLA SANT GIL,25223,252234,TORÀ,11,1,12
2019/2020,25004577,ESCOLA DE TÍRVIA - ZER ALT PALLARS SOBIRÀ,25221,252213,TÍRVIA,1,0,1
2019/2020,25004565,ESCOLA ALFRED POTRONY,25220,252206,TÉRMENS,13,0,13
2019/2020,25004531,ESCOLA ÀNGEL GUIMERÀ,25217,252173,TÀRREGA,28,3,31
2019/2020,25004528,EA ONDARA,25217,252173,TÀRREGA,17,13,30
2019/2020,25004498,INSTITUT MANUEL DE PEDROLO,25217,252173,TÀRREGA,36,15,51
2019/2020,25004462,ESCOLA JACINT VERDAGUER,25217,252173,TÀRREGA,29,2,31
2019/2020,25004413,ESCOLA DE SUNYER - ZER L'ERAL,25212,252120,SUNYER,2,1,3
2019/2020,25004401,ESCOLA EL ROSER - ZER LA COMA,25211,252115,SUDANELL,7,0,7
2019/2020,25004395,ESCOLA JAUME MIRET,25210,252108,SOSES,17,0,17
2019/2020,25004243,ESCOLA SETELSIS,25207,252075,SOLSONA,28,2,30
2019/2020,25004231,ESCOLA DEL SOLERÀS - ZER GARRIGUES ALTES,25206,252069,EL SOLERÀS,3,0,3
2019/2020,25004221,ESCOLA EL TIMÓ - ZER PLAURCÉN,25205,252056,SIDAMON,7,2,9
2019/2020,25004218,ESCOLA MIQUEL BARÓ DABAN,25204,252043,SERÒS,18,1,19
2019/2020,25004188,INSTITUT JOAN BRUDIEU,25203,252038,LA SEU D'URGELL,51,29,80
2019/2020,25004140,ESCOLA MOSSÈN ALBERT VIVES,25203,252038,LA SEU D'URGELL,27,5,32
2019/2020,25004115,ESCOLA LA ROCA - ZER L'ERAL,25200,252000,SARROCA DE LLEIDA,3,0,3
2019/2020,25004103,ESCOLA EL TALLAT - ZER RIU CORB,25902,259025,SANT MARTÍ DE RIUCORB,5,1,6
2019/2020,25004085,ESCOLA VALL ONDARA - ZER LA SEGARRA,25905,259059,RIBERA D'ONDARA,3,2,5
2019/2020,25004073,ESCOLA MARE DE DÉU DE LA MERCÈ,25194,251945,SANT RAMON,9,2,11
2019/2020,25004048,ESCOLA VALL DE LORD,25193,251930,SANT LLORENÇ DE MORUNYS,10,1,11
2019/2020,25004036,ESCOLA L'ESTEL,25192,251924,SANT GUIM DE FREIXENET,12,3,15
2019/2020,25004024,ESCOLA DE SANAÜJA - ZER LA SEGARRA,25191,251919,SANAÜJA,1,2,3
2019/2020,25004000,ESCOLA LA ROSELLA,25189,251898,ROSSELLÓ,24,1,25
2019/2020,25003974,ESCOLA DE FREIXINET DE SOLSONA - ZER EL SOLSONÈS,25186,251863,RINER,2,2,4
2019/2020,25003950,ESCOLA ARNAU MIR - ZER URGELLET,25185,251850,RIBERA D'URGELLET,5,0,5
2019/2020,25003895,ESCOLA ELS MINAIRONS - ZER ALT PALLARS SOBIRÀ,25901,259010,VALL DE CARDÓS,6,0,6
2019/2020,25003871,ESCOLA MONTSENT DE PALLARS - ZER ALT PALLARS SOBIRÀ,25183,251832,RIALP,5,1,6
2019/2020,25003861,ESCOLA SANT JORDI,25182,251826,PUIGVERD DE LLEIDA,12,1,13
2019/2020,25003858,ESCOLA DE PUIGVERD D'AGRAMUNT - ZER EL SIÓ,25181,251811,PUIGVERD D'AGRAMUNT,2,1,3
2019/2020,25003846,ESCOLA EL PUIG - ZER BARIDÀ-BATLLIA,25179,251790,PRULLANS,3,0,3
2019/2020,25003822,ESCOLA DE LES VENTOSES - ZER EL SIÓ,25177,251771,PREIXENS,1,1,2
2019/2020,25003810,ESCOLA DE PREIXENS - ZER EL SIÓ,25177,251771,PREIXENS,2,1,3
2019/2020,25003809,ESCOLA MONTALBÀ - ZER RIU CORB,25176,251765,PREIXANA,3,1,4
2019/2020,25003792,ESCOLA BLANCA DE VILLALONGA - ZER ALT SEGRIÀ,25174,251749,LA PORTELLA,4,0,4
2019/2020,25003755,ESCOLA RIBAGORÇANA,25173,251734,EL PONT DE SUERT,16,1,17
2019/2020,25003718,ESCOLA DE PONTS,25172,251728,PONTS,15,5,20
2019/2020,25003688,ESCOLA ELS RAIERS,25171,251713,LA POBLA DE SEGUR,23,2,25
2019/2020,25003676,ESCOLA ELS SET FOCS - ZER ELAIA,25170,251706,BELLAGUARDA,2,0,2
2019/2020,25003652,ESCOLA EL ROSER - ZER PLAURCÉN,25168,251689,EL POAL,6,0,6
2019/2020,25003627,ESCOLA DE SANT CLIMENT - ZER EL SOLSONÈS,25166,251667,PINELL DE SOLSONÈS,2,1,3
2019/2020,25003585,ESCOLA SANT MIQUEL - ZER NARIEDA,25165,251654,PERAMOLA,3,0,3
2019/2020,25003551,ESCOLA RAMON GOMBAL - ZER ESPERNALLAC,25164,251641,PENELLES,4,0,4
2019/2020,25003536,ESCOLA DE LA COMA - ZER EL SOLSONÈS,25163,251636,LA COMA I LA PEDRA,2,0,2
2019/2020,25003500,ESCOLA DE LES PALLARGUES - ZER LA SEGARRA,25911,259118,ELS PLANS DE SIÓ,4,0,4
2019/2020,25003494,ESCOLA ARNAU BERENGUER,25158,251581,EL PALAU D'ANGLESOLA,16,2,18
2019/2020,25003482,ESCOLA LEANDRE CRISTÒFOL - ZER MONTSEC,25156,251569,OS DE BALAGUER,4,1,5
2019/2020,25003470,ESCOLA L'ESPÍGOL - ZER MONTSEC,25156,251569,OS DE BALAGUER,6,0,6
2019/2020,25003469,ESCOLA MIRET I SANS - ZER NARIEDA,25155,251556,ORGANYÀ,7,0,7
2019/2020,25003330,ESCOLA AIGUADORA - ZER EL SOLSONÈS,25146,251462,NAVÈS,4,1,5
2019/2020,25003305,ESCOLA SANT ISIDRE - ZER LA COMA,25142,251425,MONTOLIU DE LLEIDA,2,2,4
2019/2020,25003299,ESCOLA ROSA CAMPÀ,25140,251403,MONTFERRER I CASTELLBÒ,12,1,13
2019/2020,25003275,ESCOLA RIDOLAINA,25139,251399,MONTELLÀ I MARTINET,8,0,8
2019/2020,25003263,ESCOLA PERE SARRET - ZER BARIDÀ-BATLLIA,25139,251399,MONTELLÀ I MARTINET,2,0,2
2019/2020,25003241,ESCOLA COLOMINA - ZER EL ROMANÍ,25138,251386,MONTGAI,3,0,3
2019/2020,25003238,ESCOLA DE BUTSÈNIT - ZER EL SIÓ,25138,251386,MONTGAI,1,1,2
2019/2020,25003202,INSTITUT MOLLERUSSA,25137,251370,MOLLERUSSA,32,40,72
2019/2020,25003147,ESCOLA SANT MIQUEL,25135,251351,MIRALCAMP,11,6,17
2019/2020,25003135,ESCOLA JOAN ROS I PORTA - ZER EL JONC,25134,251348,MENÀRGUENS,4,1,5
2019/2020,25003123,ESCOLA OTOGESA - ZER L'OLIVER,25133,251333,MAIALS,6,2,8
2019/2020,25003111,ESCOLA DE MASSALCOREIG - ZER L'OLIVER,25131,251312,MASSALCOREIG,5,0,5
2019/2020,25003093,ESCOLA DE LLOBERA - ZER EL SOLSONÈS,25129,251291,LLOBERA,4,0,4
2019/2020,25003056,ESCOLA PORTELLA BLANCA - ZER BARIDÀ-BATLLIA,25127,251272,LLES DE CERDANYA,3,0,3
2019/2020,25003032,ESCOLA DE LLAVORSÍ - ZER ALT PALLARS SOBIRÀ,25126,251266,LLAVORSÍ,4,0,4
2019/2020,25003019,ESCOLA ARC D'ADÀ - ZER L'OLIVER,25125,251253,LLARDECANS,3,1,4
2019/2020,25002982,ESCOLA DE LLADURS - ZER EL SOLSONÈS,25124,251240,LLADURS,3,1,4
2019/2020,25002970,ESCOLA EL SITJAR,25122,251229,LINYOLA,16,2,18
2019/2020,25002957,ESCOLA ESTUDI ALEJANDRO CASONA,25121,251214,LES,11,0,11
2019/2020,25002921,ESCOLA EL VILOT - ZER PONENT,25120,251207,LLEIDA,7,1,8
2019/2020,25002854,ESCOLA EL SEGRIÀ - ZER L'HORTA DE LLEIDA,25120,251207,LLEIDA,7,1,8
2019/2020,25002799,INSTITUT CAPARRELLA,25120,251207,LLEIDA,47,66,113
2019/2020,25002787,INSTITUT JOAN ORÓ,25120,251207,LLEIDA,46,25,71
2019/2020,25002726,INSTITUT GUINDÀVOLS,25120,251207,LLEIDA,41,31,72
2019/2020,25002696,INSTITUT MARIUS TORRES,25120,251207,LLEIDA,49,25,74
2019/2020,25002684,INSTITUT SAMUEL GILI I GAYA,25120,251207,LLEIDA,34,21,55
2019/2020,25002672,ESCOLA DE PRÀCTIQUES I,25120,251207,LLEIDA,13,4,17
2019/2020,25002659,ESCOLA SANT JOSEP DE CALASSANÇ,25120,251207,LLEIDA,18,3,21
2019/2020,25002131,ESCOLA CREU DEL BATLLE - ZER L'HORTA DE LLEIDA,25120,251207,LLEIDA,2,1,3
2019/2020,25002121,ESCOLA PRÍNCEP DE VIANA,25120,251207,LLEIDA,19,2,21
2019/2020,25002106,ESCOLA PARDINYES,25120,251207,LLEIDA,17,4,21
2019/2020,25002091,ESCOLA MAGÍ MORERA I GALÍCIA,25120,251207,LLEIDA,18,5,23
2019/2020,25002088,ESCOLA RIU SEGRE,25120,251207,LLEIDA,26,6,32
2019/2020,25002076,ESCOLA CERVANTES,25120,251207,LLEIDA,15,2,17
2019/2020,25002064,ESCOLA CAMPS ELISIS,25120,251207,LLEIDA,18,4,22
2019/2020,25002052,ESCOLA BALÀFIA,25120,251207,LLEIDA,16,5,21
2019/2020,25002003,ESCOLA SANTA MARIA DE GARDENY,25120,251207,LLEIDA,23,6,29
2019/2020,25001990,ESCOLA ANTONI BERGÓS - ZER L'HORTA DE LLEIDA,25120,251207,LLEIDA,2,1,3
2019/2020,25001953,ESCOLA ENRIC FARRENY,25120,251207,LLEIDA,12,4,16
2019/2020,25001928,ESCOLA MANUEL ORTIZ I CASTELLÓ,25119,251193,JUNEDA,24,2,26
2019/2020,25001916,ESCOLA L'ESPÍGOL - ZER GARRIGUES ALTES,25118,251180,JUNCOSA,3,0,3
2019/2020,25001886,ESCOLA AESO - ZER PALLARS JUSSÀ,25115,251155,ISONA I CONCA DELLÀ,6,1,7
2019/2020,25001801,ESCOLA MARE DE DÉU DE L'HORTA,25113,251137,IVARS D'URGELL,16,0,16
2019/2020,25001795,ESCOLA SANT SEBASTIÀ - ZER SERRA LLARGA,25112,251121,IVARS DE NOGUERA,3,1,4
2019/2020,25001761,ESCOLA RAMON FAUS I ESTEVE,25110,251109,GUISSONA,32,3,35
2019/2020,25001758,ESCOLA DE GUIMERÀ - ZER GUICIVERVI,25109,251095,GUIMERÀ,1,1,2
2019/2020,25001722,ESCOLA SANT JAUME - ZER L'OLIVER,25102,251023,LA GRANJA D'ESCARP,7,2,9
2019/2020,25001710,ESCOLA DE LA GRANADELLA - ZER ELAIA,25101,251018,LA GRANADELLA,6,0,6
2019/2020,25001709,ESCOLA SANTA MARGARIDA - ZER ALT BERGUEDÀ,25100,251001,GÓSOL,1,1,2
2019/2020,25001692,ESCOLA FRANCESC ARENES,25099,250997,GOLMÉS,14,1,15
2019/2020,25001618,ESCOLA GUILLEM ISARN,25096,250962,LA FULIOLA,12,3,15
2019/2020,25001606,ESCOLA MINYONS D'URGELL,25093,250931,FONDARELLA,12,0,12
2019/2020,25001539,ESCOLA LA CLOSA,25086,250864,ESTERRI D'ÀNEU,13,2,15
2019/2020,25001473,ESCOLA PORCEL DE CERVERA - ZER PEDRERA,25081,250812,L'ESPLUGA CALBA,3,0,3
2019/2020,25001436,ESCOLA SOL NAIXENT - ZER EL ROMANÍ,25079,250791,CUBELLS,2,1,3
2019/2020,25001424,ESCOLA SOL IXENT,25078,250788,CORBINS,15,0,15
2019/2020,25001400,ESCOLA SANT CLIMENT - ZER NARIEDA,25077,250772,COLL DE NARGÓ,5,1,6
2019/2020,25001357,ESCOLA DE CIUTADILLA - ZER GUICIVERVI,25074,250740,CIUTADILLA,2,0,2
2019/2020,25001333,ESCOLA EL CÉRVOL - ZER RIU SET,25073,250735,CERVIÀ DE LES GARRIGUES,4,1,5
2019/2020,25001321,ESCOLA MOSSÈN JOSEP ARQUES,25072,250729,CERVERA,26,4,30
2019/2020,25001311,INSTITUT ANTONI TORROJA,25072,250729,CERVERA,26,12,38
2019/2020,25001291,ESCOLA JAUME BALMES,25072,250729,CERVERA,27,2,29
2019/2020,25001281,ESCOLA EL TERRALL - ZER ESPERNALLAC,25070,250707,CASTELLSERÀ,9,1,10
2019/2020,25001278,ESCOLA SANTA MARIA - ZER SERRA LLARGA,25069,250693,CASTELLÓ DE FARFANYA,2,1,3
2019/2020,25001266,ESCOLA L'ESTEL - ZER VENT SERÈ,25068,250680,CASTELLNOU DE SEANA,4,2,6
2019/2020,25001254,ESCOLA TIMORELL - ZER VALL DE L'ARANYÓ,25067,250674,CASTELLDANS,6,1,7
2019/2020,25001242,ESCOLA CASTELL-CIUTAT - ZER URGELLET,25203,252038,LA SEU D'URGELL,4,0,4
2019/2020,25001229,ESCOLA DOS RIUS - ZER EL JONC,25062,250621,CAMARASA,5,1,6
2019/2020,25001199,ESCOLA SANT RÒC,25059,250595,BOSSÒST,11,1,12
2019/2020,25001141,ESCOLA JOAN XXIII,25058,250582,LES BORGES BLANQUES,26,4,30
2019/2020,25001138,ESCOLA CASTETH LEON - ZER VAL D'ARAN,25057,250576,ES BÒRDES,4,0,4
2019/2020,25001126,ESCOLA VALLMAJOR - ZER ELAIA,25056,250560,BOVERA,2,1,3
2019/2020,25001096,ESCOLA SANT JOAN,25053,250539,BENAVENT DE SEGRIÀ,13,1,14
2019/2020,25001084,ESCOLA JOAQUIM PALACÍN,25052,250523,BELLVÍS,15,2,17
2019/2020,25001059,ESCOLA MARE DE DÉU DE TALLÓ,25051,250518,BELLVER DE CERDANYA,14,2,16
2019/2020,25001011,ESCOLA VALERI SERRA,25050,250501,BELLPUIG,23,1,24
2019/2020,25001001,ESCOLA SANT BARTOMEU - ZER ESPERNALLAC,25049,250498,BELLMUNT D'URGELL,2,1,3
2019/2020,25000985,ESCOLA RAMON FARRERONS,25048,250485,BELL-LLOC D'URGELL,17,1,18
2019/2020,25000961,ESCOLA BONAVISTA,25047,250479,BELLCAIRE D'URGELL,12,1,13
2019/2020,25000951,ESCOLA PERE TEIXINÉ - ZER RIU CORB,25046,250463,BELIANES,4,1,5
2019/2020,25000869,ESCOLA SANT ROC - ZER RIU ONDARA,25041,250411,BARBENS,6,1,7
2019/2020,25000857,ESCOLA LA NOGUERA,25040,250404,BALAGUER,12,4,16
2019/2020,25000833,INSTITUT CIUTAT DE BALAGUER,25040,250404,BALAGUER,34,20,54
2019/2020,25000781,ESCOLA ÀNGEL GUIMERÀ,25040,250404,BALAGUER,21,1,22
2019/2020,25000778,ESCOLA GASPAR DE PORTOLÀ,25040,250404,BALAGUER,25,6,31
2019/2020,25000730,ESCOLA FRANCESC FELIU,25038,250387,AITONA,22,5,27
2019/2020,25000717,ESCOLA DE TARTAREU - ZER MONTSEC,25037,250371,LES AVELLANES I SANTA LINYA,2,0,2
2019/2020,25000699,ESCOLA DE LES AVELLANES - ZER MONTSEC,25037,250371,LES AVELLANES I SANTA LINYA,2,1,3
2019/2020,25000675,ESCOLA MARE DE DÉU DE LA GUARDIOLA - ZER EL ROMANÍ,25035,250352,LA SENTIU DE SIÓ,3,0,3
2019/2020,25000638,ESCOLA ELS PLANELLS,25034,250349,ARTESA DE SEGRE,26,2,28
2019/2020,25000626,ESCOLA ELS TIL.LERS,25033,250334,ARTESA DE LLEIDA,15,1,16
2019/2020,25000602,ESCOLA ALBIRKA,25029,250292,ARBECA,13,2,15
2019/2020,25000584,ESCOLA SANTA CREU,25027,250273,ANGLESOLA,17,1,18
2019/2020,25000560,ESCOLA RUDA - ZER VAL D'ARAN,25025,250254,NAUT ARAN,7,0,7
2019/2020,25000559,ESCOLA SANT MARTÍ - ZER VAL D'ARAN,25025,250254,NAUT ARAN,2,0,2
2019/2020,25000535,ESCOLA LOSERON - ZER VAL D'ARAN,25025,250254,NAUT ARAN,5,0,5
2019/2020,25000511,ESCOLA INOCENCIO PARDOS - ZER PONENT,25912,259123,GIMENELLS I EL PLA DE LA FONT,3,0,3
2019/2020,25000481,ESCOLA SANT ISIDRE - ZER PONENT,25912,259123,GIMENELLS I EL PLA DE LA FONT,6,0,6
2019/2020,25000468,ESCOLA DOCTOR SERÉS,25023,250236,ALPICAT,28,5,33
2019/2020,25000341,ESCOLA ANTÒNIA SIMÓ ARNÓ,25019,250194,ALMACELLES,33,5,38
2019/2020,25000316,ESCOLA D'ALINS - ZER ALT PALLARS SOBIRÀ,25017,250175,ALINS,3,0,3
2019/2020,25000286,ESCOLA SANT BLAI - ZER SERRA LLARGA,25015,250156,ALGERRI,2,1,3
2019/2020,25000274,ESCOLA D'ALFÉS - ZER L'ERAL,25014,250143,ALFÉS,2,1,3
2019/2020,25000225,ESCOLA MARE DE DÉU DEL CARME,25012,250122,ALCOLETGE,22,6,28
2019/2020,25000195,ESCOLA COMTES DE TORREGROSSA,25011,250117,ALCARRÀS,32,7,39
2019/2020,25000183,ESCOLA LA DULA - ZER L'ERAL,25010,250100,ALCANÓ,3,0,3
2019/2020,25000171,ESCOLA ELS AUBIS - ZER RIU SET,25009,250096,L'ALBI,6,2,8
2019/2020,25000161,ESCOLA L'ÀLBER,25008,250083,ALBESA,13,2,15
2019/2020,25000158,ESCOLA SANT SALVADOR,25007,250077,ALBATÀRREC,14,2,16
2019/2020,25000146,ESCOLA MARE DE DÉU DE MONTSERRAT - ZER VALL DE L'ARANYÓ,25006,250061,L'ALBAGÉS,3,1,4
2019/2020,25000122,ESCOLA SANT ESTEVE - ZER URGELLET,25005,250058,ALÀS I CERC,3,0,3
2019/2020,25000110,ESCOLA ARRELS - ZER L'HORTA DE LLEIDA,25004,250045,ELS ALAMÚS,5,1,6
2019/2020,25000067,ESCOLA MACIÀ-COMPANYS,25003,250030,AGRAMUNT,26,3,29
2019/2020,25000031,ESCOLA ANDREU FARRAN - ZER MONTSEC,25002,250024,ÀGER,3,2,5
2019/2020,17010700,INSTITUT SANT QUIRZE,17095,170950,LLORET DE MAR,5,3,8
2019/2020,17010694,INSTITUT ESCOLA EL BRUEL-EMPURIABRAVA,17047,170470,CASTELLÓ D'EMPÚRIES,31,5,36
2019/2020,17010682,INSTITUT DE SARRIÀ DE TER,17186,171864,SARRIÀ DE TER,7,5,12
2019/2020,17010451,CFA TRAMUNTANA,17066,170669,FIGUERES,13,5,18
2019/2020,17010441,CFA NOU GIRONA,17079,170792,GIRONA,6,4,10
2019/2020,17010414,INSTITUT ERMESSENDA DE GIRONA,17079,170792,GIRONA,38,12,50
2019/2020,17010189,INSTITUT VALL DE LLÉMENA,17163,171637,SANT GREGORI,11,10,21
2019/2020,17010049,ESCOLA BALANDRAU,17079,170792,GIRONA,17,1,18
2019/2020,17010037,INSTITUT EL BRUC,17146,171463,RIELLS I VIABREA,14,5,19
2019/2020,17009898,INSTITUT ESCOLA LLORET DE MAR,17095,170950,LLORET DE MAR,55,10,65
2019/2020,17009850,ESCOLA LES ARRELS,17155,171557,SALT,32,5,37
2019/2020,17009813,INSTITUT ESCOLA MESTRE ANDREU,17167,171674,SANT JOAN DE LES ABADESSES,30,6,36
2019/2020,17009801,INSTITUT ESCOLA SALVADOR VILARRASA,17019,170195,BESALÚ,32,9,41
2019/2020,17009795,INSTITUT ESCOLA FRANCESC CAMBÓ I BATLLE,17211,172116,VERGES,35,8,43
2019/2020,17009783,INSTITUT LA MIQUELA,17020,170209,BESCANÓ,24,9,33
2019/2020,17009710,ESCOLA EMPORDANET,17022,170221,LA BISBAL D'EMPORDÀ,17,0,17
2019/2020,17009631,ZER CAP DE CREUS,17140,171404,EL PORT DE LA SELVA,3,2,5
2019/2020,17009473,ZER EMPORDANET-GAVARRES,17130,171306,LA PERA,4,0,4
2019/2020,17009345,ESCOLA CAMINS,17015,170157,BANYOLES,18,2,20
2019/2020,17009308,INSTITUT DE SILS,17193,171931,SILS,26,6,32
2019/2020,17009278,ESCOLA FANALS D'ARO,17048,170486,CASTELL-PLATJA D'ARO,13,2,15
2019/2020,17009242,ESCOLA NOU DE QUART,17142,171426,QUART,14,2,16
2019/2020,17009205,INSTITUT DE VILABLAREIX,17215,172155,VILABLAREIX,37,17,54
2019/2020,17009199,ESCOLA ELS ESTANYS,17193,171931,SILS,11,4,15
2019/2020,17009138,ESCOLA PUIG DE LES CADIRETES,17089,170890,LLAGOSTERA,29,3,32
2019/2020,17009126,ESCOLA EL BOSC DE LA PABORDIA,17079,170792,GIRONA,25,4,29
2019/2020,17008997,ESCOLA FORALLAC,17902,179026,FORALLAC,11,4,15
2019/2020,17008951,INSTITUT MAÇANET DE LA SELVA,17103,171030,MAÇANET DE LA SELVA,21,10,31
2019/2020,17008894,ESCOLA ALZINES BALLADORES,17159,171595,SANT FELIU DE BUIXALLEU,13,1,14
2019/2020,17008882,ESCOLA LA BÒBILA,17139,171390,LES PRESES,17,0,17
2019/2020,17008821,EOI DE BANYOLES,17015,170157,BANYOLES,4,1,5
2019/2020,17008808,ESCOLA CARME GUASCH I DARNÉ,17066,170669,FIGUERES,25,4,29
2019/2020,17008781,ESCOLA LA BENAULA,17033,170335,CALDES DE MALAVELLA,17,1,18
2019/2020,17008778,ESCOLA EL MORROT,17114,171143,OLOT,16,3,19
2019/2020,17008687,ESCOLA LES DEVESES,17155,171557,SALT,31,5,36
2019/2020,17008675,ESCOLA PERICOT,17079,170792,GIRONA,23,7,30
2019/2020,17008651,INSTITUT DE CALDES DE MALAVELLA,17033,170335,CALDES DE MALAVELLA,23,9,32
2019/2020,17008641,ESCOLA DE CABANES,17030,170307,CABANES,12,1,13
2019/2020,17008547,ESCOLA LES ARRELS,17103,171030,MAÇANET DE LA SELVA,20,3,23
2019/2020,17008523,ESCOLA PI VERD,17117,171175,PALAFRUGELL,31,7,38
2019/2020,17008501,ESCOLA ALDRIC,17044,170448,CASSÀ DE LA SELVA,27,2,29
2019/2020,17008493,ESCOLA VALL-LLOBREGA,17209,172095,VALL-LLOBREGA,14,0,14
2019/2020,17008481,ESCOLA L'ESCULAPI,17062,170622,L'ESCALA,15,3,18
2019/2020,17008471,ESCOLA LES FALGUERES,17049,170499,CELRÀ,29,0,29
2019/2020,17008468,ESCOLA LA SÍNIA,17034,170340,CALONGE I SANT ANTONI,14,1,15
2019/2020,17008444,ESCOLA PARC DE LES AIGÜES,17066,170669,FIGUERES,29,4,33
2019/2020,17008419,ESCOLA LLUMS DEL NORD,17141,171411,PUIGCERDÀ,14,2,16
2019/2020,17008407,INSTITUT SALVADOR SUNYER I AIMERIC,17155,171557,SALT,25,10,35
2019/2020,17008390,INSTITUT DE VILAFANT,17221,172214,VILAFANT,32,12,44
2019/2020,17008389,CFA LA SELVA,17180,171805,SANTA COLOMA DE FARNERS,5,2,7
2019/2020,17008377,CFA RIPOLLÈS,17147,171479,RIPOLL,2,1,3
2019/2020,17008365,CFA PLA DE L'ESTANY,17015,170157,BANYOLES,6,2,8
2019/2020,17008298,ESCOLA EL GEGANT DEL REC,17155,171557,SALT,30,6,36
2019/2020,17008286,ESCOLA DOMENY,17079,170792,GIRONA,28,3,31
2019/2020,17008274,ESCOLA SA FORCANERA,17023,170237,BLANES,23,2,25
2019/2020,17008249,ESCOLA CASTELL DE FARNERS,17180,171805,SANTA COLOMA DE FARNERS,27,4,31
2019/2020,17008237,ESCOLA MONTSERRAT VAYREDA,17152,171523,ROSES,24,3,27
2019/2020,17008146,CFA PALAFRUGELL,17117,171175,PALAFRUGELL,4,3,7
2019/2020,17008134,EOI DE FIGUERES,17066,170669,FIGUERES,7,2,9
2019/2020,17008122,EOI DE BLANES,17023,170237,BLANES,8,1,9
2019/2020,17008110,EOI DE SANT FELIU DE GUÍXOLS,17160,171609,SANT FELIU DE GUÍXOLS,5,2,7
2019/2020,17008080,ESCOLA ÀNGELS ALEMANY I BORIS,17095,170950,LLORET DE MAR,41,6,47
2019/2020,17008018,ESCOLA ARDENYA,17160,171609,SANT FELIU DE GUÍXOLS,26,4,30
2019/2020,17008006,ESCOLA AMISTAT,17066,170669,FIGUERES,25,5,30
2019/2020,17007981,EOI D'OLOT,17114,171143,OLOT,10,0,10
2019/2020,17007919,ESCOLA MAS MASÓ,17155,171557,SALT,34,4,38
2019/2020,17007907,ESCOLA JOANA D'EMPÚRIES,17047,170470,CASTELLÓ D'EMPÚRIES,25,3,28
2019/2020,17007828,ESCOLA PINYA DE ROSA,17023,170237,BLANES,26,5,31
2019/2020,17007695,ZER EMPORDÀ,17228,172288,VILANANT,2,2,4
2019/2020,17007671,CFA LA GARROTXA,17114,171143,OLOT,6,6,12
2019/2020,17007658,CFA SANT FELIU DE GUÍXOLS,17160,171609,SANT FELIU DE GUÍXOLS,6,3,9
2019/2020,17007609,INSTITUT OLIVAR GRAN,17066,170669,FIGUERES,43,30,73
2019/2020,17007531,ZER MONTGRÍ,17018,170182,BELLCAIRE D'EMPORDÀ,2,1,3
2019/2020,17007518,ZER LES SALINES,17001,170010,AGULLANA,4,0,4
2019/2020,17007488,ZER REQUESENS,17042,170427,CAPMANY,2,2,4
2019/2020,17007464,ZER COMTE ARNAU,17170,171707,VALLFOGONA DE RIPOLLÈS,4,0,4
2019/2020,17007452,ZER EL LLIERCA,17200,172001,TORTELLÀ,3,1,4
2019/2020,17007440,ZER VALL DE TER,17177,171772,SANT PAU DE SEGÚRIES,4,1,5
2019/2020,17007439,ZER CERDANYA,17094,170947,LLÍVIA,4,1,5
2019/2020,17007427,ZER TRAMUNTANA,17210,172109,VENTALLÓ,4,0,4
2019/2020,17007300,INSTITUT LA BISBAL,17022,170221,LA BISBAL D'EMPORDÀ,59,34,93
2019/2020,17007181,CFA GIRONA,17079,170792,GIRONA,12,4,16
2019/2020,17007178,CFA MARIA VERDAGUER,17066,170669,FIGUERES,6,3,9
2019/2020,17007129,CFA ES PITEUS,17023,170237,BLANES,6,7,13
2019/2020,17007014,CFA LLORET DE MAR,17095,170950,LLORET DE MAR,5,2,7
2019/2020,17006952,ESCOLA LA DRAGA,17015,170157,BANYOLES,28,2,30
2019/2020,17006940,ESCOLA DE LLIURONA,17003,170031,ALBANYÀ,2,1,3
2019/2020,17006939,INSTITUT SANTA EUGÈNIA,17079,170792,GIRONA,60,51,111
2019/2020,17006873,ESCOLA CASTELLUM,17169,171693,SANT JULIÀ DE RAMIS,22,1,23
2019/2020,17006851,INSTITUT ILLA DE RODES,17152,171523,ROSES,42,21,63
2019/2020,17006836,ESCOLA LES MÈLIES,17221,172214,VILAFANT,28,1,29
2019/2020,17006824,INSTITUT VIDRERES,17213,172137,VIDRERES,36,22,58
2019/2020,17006812,INSTITUT DE TOSSA DE MAR,17202,172023,TOSSA DE MAR,20,10,30
2019/2020,17006800,ESCOLA ELS GRECS,17152,171523,ROSES,23,4,27
2019/2020,17006794,INSTITUT JOAN TRIADÚ,17145,171450,RIBES DE FRESER,9,3,12
2019/2020,17006782,ESCOLA CARRILET,17117,171175,PALAFRUGELL,30,4,34
2019/2020,17006770,INSTITUT ROCAGROSSA,17095,170950,LLORET DE MAR,39,32,71
2019/2020,17006769,INSTITUT DE LLANÇÀ,17092,170926,LLANÇÀ,24,19,43
2019/2020,17006757,INSTITUT DE LLAGOSTERA,17089,170890,LLAGOSTERA,26,20,46
2019/2020,17006745,INSTITUT DE LA JONQUERA,17086,170865,LA JONQUERA,25,9,34
2019/2020,17006733,INSTITUT VESCOMTAT DE CABRERA,17083,170834,HOSTALRIC,51,20,71
2019/2020,17006721,ESCOLA MARTA MATA,17079,170792,GIRONA,28,3,31
2019/2020,17006711,ESCOLA M. ÀNGELS ANGLADA,17066,170669,FIGUERES,16,2,18
2019/2020,17006708,INSTITUT DE CELRÀ,17049,170499,CELRÀ,45,17,62
2019/2020,17006691,INSTITUT RIDAURA,17048,170486,CASTELL-PLATJA D'ARO,41,15,56
2019/2020,17006681,INSTITUT GERMANS VILA-RIERA,17039,170391,CAMPRODON,11,7,18
2019/2020,17006678,INSTITUT CAP DE CREUS,17032,170329,CADAQUÉS,10,4,14
2019/2020,17006666,INSTITUT PLA DE L'ESTANY,17015,170157,BANYOLES,49,23,72
2019/2020,17006605,INSTITUT MONTSORIU,17009,170097,ARBÚCIES,30,22,52
2019/2020,17006083,INSTITUT CASTELLÓ D'EMPÚRIES,17047,170470,CASTELLÓ D'EMPÚRIES,36,26,62
2019/2020,17005923,INSTITUT MONTGRÍ,17199,171997,TORROELLA DE MONTGRÍ,37,22,59
2019/2020,17005911,INSTITUT RAMON COLL I RODÉS,17095,170950,LLORET DE MAR,54,31,85
2019/2020,17005893,INSTITUT BOSC DE LA COMA,17114,171143,OLOT,55,28,83
2019/2020,17005741,INSTITUT PERE BORRELL,17141,171411,PUIGCERDÀ,61,19,80
2019/2020,17005731,INSTITUT S'AGULLA,17023,170237,BLANES,52,20,72
2019/2020,17005704,INSTITUT ABAT OLIBA,17147,171479,RIPOLL,46,31,77
2019/2020,17005662,INSTITUT SERRALLARGA,17023,170237,BLANES,65,37,102
2019/2020,17005650,INSTITUT DE CASSÀ DE LA SELVA,17044,170448,CASSÀ DE LA SELVA,45,13,58
2019/2020,17005649,INSTITUT CENDRASSOS,17066,170669,FIGUERES,54,35,89
2019/2020,17005522,ESCOLA VEÏNAT,17155,171557,SALT,20,3,23
2019/2020,17005388,INSTITUT VALLVERA,17155,171557,SALT,73,24,97
2019/2020,17005376,INSTITUT DE SANTA COLOMA DE FARNERS,17180,171805,SANTA COLOMA DE FARNERS,58,34,92
2019/2020,17005364,INSTITUT CAP NORFEU,17152,171523,ROSES,40,22,62
2019/2020,17005352,INSTITUT DE PALAMÓS,17118,171181,PALAMÓS,48,34,82
2019/2020,17005340,EA D'OLOT,17114,171143,OLOT,26,13,39
2019/2020,17005339,CFA LES BERNARDES,17155,171557,SALT,9,9,18
2019/2020,17005261,ESCOLA MONTPALAU - ZER EL LLIERCA,17010,170101,ARGELAGUER,4,1,5
2019/2020,17005251,INSTITUT EL PEDRÓ,17062,170622,L'ESCALA,29,23,52
2019/2020,17005248,ESCOLA MAS CLARÀ,17022,170221,LA BISBAL D'EMPORDÀ,22,6,28
2019/2020,17005182,ESCOLA CAN PUIG,17015,170157,BANYOLES,28,4,32
2019/2020,17005042,INSTITUT CARLES RAHOLA I LLORENS,17079,170792,GIRONA,44,14,58
2019/2020,17005029,ESCOLA L'ESQUIROL - ZER VALL DE TER,17112,171122,OGASSA,3,0,3
2019/2020,17005017,ESCOLA QUATRE VENTS,17023,170237,BLANES,23,8,31
2019/2020,17004955,ESCOLA POMPEU FABRA,17095,170950,LLORET DE MAR,35,7,42
2019/2020,17004943,ESCOLA MONTFALGARS,17079,170792,GIRONA,23,7,30
2019/2020,17004906,ESCOLA SALVADOR ESPRIU,17213,172137,VIDRERES,25,2,27
2019/2020,17004891,ESCOLA JOSEP PALLACH,17066,170669,FIGUERES,28,4,32
2019/2020,17004888,ESCOLA SANTA CECÍLIA - ZER CERDANYA,17024,170242,BOLVIR,4,0,4
2019/2020,17004876,ESCOLA L'OLIVAR VELL,17013,170139,BEGUR,9,2,11
2019/2020,17004864,ESCOLA EL PLA,17155,171557,SALT,27,11,38
2019/2020,17004852,EOI DE GIRONA,17079,170792,GIRONA,32,7,39
2019/2020,17004827,ESCOLA ALZINA RECLAMADORA,17071,170715,FONTCOBERTA,14,1,15
2019/2020,17004761,CEE DOCTOR RAMON SURIÑACH,17147,171479,RIPOLL,7,0,7
2019/2020,17004751,ESCOLA TOMÀS RAGUER,17147,171479,RIPOLL,15,2,17
2019/2020,17004748,CEE MARE DE DÉU DEL MONT,17221,172214,VILAFANT,24,3,27
2019/2020,17004736,CEE ELS ÀNGELS,17118,171181,PALAMÓS,22,2,24
2019/2020,17004724,CEE PALAU,17079,170792,GIRONA,16,1,17
2019/2020,17004712,CEE VENTIJOL,17023,170237,BLANES,23,3,26
2019/2020,17004694,ESCOLA CASSIÀ COSTAL,17079,170792,GIRONA,26,3,29
2019/2020,17004682,ESCOLA L'ESTACIÓ,17160,171609,SANT FELIU DE GUÍXOLS,27,5,32
2019/2020,17004657,ESCOLA ESTEVE CARLES,17095,170950,LLORET DE MAR,19,3,22
2019/2020,17004578,INSTITUT CASTELL D'ESTELA,17007,170078,AMER,21,11,32
2019/2020,17004566,ESCOLA NAPOLEÓ SOLIVA,17023,170237,BLANES,22,3,25
2019/2020,17004530,INSTITUT SANTIAGO SOBREQUÉS I VIDAL,17079,170792,GIRONA,42,23,65
2019/2020,17004529,ESCOLA MIGDIA,17079,170792,GIRONA,27,2,29
2019/2020,17004517,INSTITUT ANTON BUSQUETS I PUNSET,17164,171642,SANT HILARI SACALM,19,8,27
2019/2020,17004499,INSTITUT NARCÍS XIFRA I MASMITJÀ,17079,170792,GIRONA,96,47,143
2019/2020,17004487,INSTITUT RAFAEL CAMPALANS,17008,170084,ANGLÈS,31,22,53
2019/2020,17004463,ESCOLA ANICET DE PAGÈS I DE PUIG,17066,170669,FIGUERES,27,6,33
2019/2020,17004451,ESCOLA JAUME VICENS I VIVES,17152,171523,ROSES,23,6,29
2019/2020,17004438,INSTITUT ALEXANDRE DEULOFEU,17066,170669,FIGUERES,52,24,76
2019/2020,17004360,CEE LA MAÇANA,17155,171557,SALT,10,0,10
2019/2020,17004347,ESCOLA FONT DE LA PÓLVORA,17079,170792,GIRONA,12,1,13
2019/2020,17004335,ESCOLA SANTA EUGÈNIA,17079,170792,GIRONA,16,1,17
2019/2020,17004293,ESCOLA MANUEL DE PEDROLO - ZER LES SALINES,17234,172348,BIURE,2,1,3
2019/2020,17004281,ESCOLA JOSEP MADRENYS,17233,172333,VILOBÍ D'ONYAR,23,1,24
2019/2020,17004244,ESCOLA TRAMUNTANA - ZER EMPORDÀ,17228,172288,VILANANT,3,0,3
2019/2020,17004232,ESCOLA JOSEP DE RIBOT I OLIVAS,17226,172266,VILAMALLA,15,1,16
2019/2020,17004220,ESCOLA ELS VALENTINS - ZER TRAMUNTANA,17225,172253,VILAMACOLUM,3,2,5
2019/2020,17004219,ESCOLA LA DAINA - ZER VALL DE TER,17224,172240,VILALLONGA DE TER,3,0,3
2019/2020,17004207,ESCOLA SANTIAGO RATÉS,17223,172235,VILAJUÏGA,12,1,13
2019/2020,17004190,ESCOLA SOL I VENT,17221,172214,VILAFANT,14,1,15
2019/2020,17004189,ESCOLA ELS CASTANYERS - ZER GUILLERIES,17220,172207,VILADRAU,7,1,8
2019/2020,17004153,ESCOLA DE SANT ESTEVE DE GUIALBES,17218,172180,VILADEMULS,10,2,12
2019/2020,17004128,ESCOLA PUIG SEGALAR - ZER TRAMUNTANA,17217,172174,VILADAMAT,4,0,4
2019/2020,17004116,ESCOLA MADRENC,17215,172155,VILABLAREIX,22,3,25
2019/2020,17004098,ESCOLA TORRE D'EN REIG,17214,172142,VILABERTRAN,14,2,16
2019/2020,17004074,ESCOLA SANT ISCLE,17213,172137,VIDRERES,19,4,23
2019/2020,17004062,ESCOLA SANTA BÀRBARA - ZER ELS CASTELLS,17212,172121,VIDRÀ,2,0,2
2019/2020,17004049,ESCOLA OLIVERES MIL·LENÀRIES - ZER TRAMUNTANA,17210,172109,VENTALLÓ,8,0,8
2019/2020,17004001,ESCOLA VERNTALLAT,17207,172076,LA VALL D'EN BAS,20,3,23
2019/2020,17003951,PARVULARI DE SANT ESTEVE D'EN BAS,17207,172076,LA VALL D'EN BAS,4,0,4
2019/2020,17003941,ESCOLA L'ESTANY - ZER EMPORDANET-GAVARRES,17205,172057,ULLASTRET,4,0,4
2019/2020,17003938,ESCOLA PUIG RODÓ - ZER MONTGRÍ,17204,172044,ULLÀ,6,0,6
2019/2020,17003926,ESCOLA IGNASI MELÉ I FARRÉ,17202,172023,TOSSA DE MAR,28,5,33
2019/2020,17003902,ESCOLA JOAN ROURA I PARELLA - ZER EL LLIERCA,17200,172001,TORTELLÀ,5,3,8
2019/2020,17003872,ESCOLA GUILLEM DE MONTGRÍ,17199,171997,TORROELLA DE MONTGRÍ,37,6,43
2019/2020,17003860,ESCOLA PORTITXOL,17199,171997,TORROELLA DE MONTGRÍ,21,5,26
2019/2020,17003823,ESCOLA VERDAGUER,17193,171931,SILS,23,4,27
2019/2020,17003801,ESCOLA BORA GRAN,17190,171903,SERINYÀ,13,2,15
2019/2020,17003781,ESCOLA JUNCADELLA,17189,171899,LA CELLERA DE TER,13,3,16
2019/2020,17003768,ESCOLA ELS TERRAPRIMS,17187,171870,"SAUS, CAMALLERA I LLAMPAIES",14,1,15
2019/2020,17003756,ESCOLA MONTSERRAT,17186,171864,SARRIÀ DE TER,26,4,30
2019/2020,17003732,ESCOLA CASTANYER,17185,171851,SANT JOAN LES FONTS,17,3,20
2019/2020,17003719,ESCOLA JOAN MARAGALL,17184,171848,SANTA PAU,11,4,15
2019/2020,17003689,ESCOLA PEDRALTA,17181,171812,SANTA CRISTINA D'ARO,25,5,30
2019/2020,17003641,ESCOLA SANT SALVADOR D'HORTA,17180,171805,SANTA COLOMA DE FARNERS,33,2,35
2019/2020,17003631,ESCOLA LA PEDRA DRETA - ZER EMPORDANET-GAVARRES,17901,179011,"CRUÏLLES, MONELLS I SANT SADURNÍ L'HEURA",4,1,5
2019/2020,17003628,ESCOLA LLAGUT,17178,171788,SANT PERE PESCADOR,15,6,21
2019/2020,17003616,ESCOLA ELS PINETS - ZER VALL DE TER,17177,171772,SANT PAU DE SEGÚRIES,7,0,7
2019/2020,17003598,ESCOLA VALLGARRIGA,17175,171753,SANT MIQUEL DE FLUVIÀ,7,3,10
2019/2020,17003537,ESCOLA DE VALLFOGONA DE RIPOLLÈS - ZER COMTE ARNAU,17170,171707,VALLFOGONA DE RIPOLLÈS,1,0,1
2019/2020,17003471,ESCOLA SANT JORDI,17166,171668,SANT JORDI DESVALLS,9,1,10
2019/2020,17003461,ESCOLA LES ESCOMES,17165,171655,SANT JAUME DE LLIERCA,12,2,14
2019/2020,17003434,ESCOLA GUILLERIES,17164,171642,SANT HILARI SACALM,25,4,29
2019/2020,17003422,ESCOLA TAIALÀ,17079,170792,GIRONA,35,3,38
2019/2020,17003392,ESCOLA AGUSTÍ GIFRE,17163,171637,SANT GREGORI,31,5,36
2019/2020,17003343,ESCOLA ROCALBA,17161,171616,SANT FELIU DE PALLEROLS,14,1,15
2019/2020,17003321,ESCOLA MOSSÈN BALDIRI REIXACH,17160,171609,SANT FELIU DE GUÍXOLS,23,6,29
2019/2020,17003318,INSTITUT DE SANT FELIU DE GUÍXOLS,17160,171609,SANT FELIU DE GUÍXOLS,69,25,94
2019/2020,17003306,INSTITUT SANT ELM,17160,171609,SANT FELIU DE GUÍXOLS,30,14,44
2019/2020,17003264,ESCOLA GAZIEL,17160,171609,SANT FELIU DE GUÍXOLS,21,6,27
2019/2020,17003227,ESCOLA SANT SEBASTIÀ - ZER REQUESENS,17158,171582,SANT CLIMENT SESCEBES,6,0,6
2019/2020,17003215,ESCOLA LA FARGA,17155,171557,SALT,31,6,37
2019/2020,17003203,INSTITUT SALVADOR ESPRIU,17155,171557,SALT,52,22,74
2019/2020,17003151,ESCOLA SILVESTRE SANTALÓ,17155,171557,SALT,19,5,24
2019/2020,17003136,ESCOLA NARCÍS MONTURIOL,17152,171523,ROSES,15,3,18
2019/2020,17003094,ESCOLA DE RIUDELLOTS DE LA SELVA,17150,171501,RIUDELLOTS DE LA SELVA,13,3,16
2019/2020,17003082,ESCOLA LLUÍS CASTELLS,17149,171498,RIUDAURA,10,2,12
2019/2020,17003070,ESCOLA JOSEP BOADA,17148,171485,RIUDARENES,17,0,17
2019/2020,17002995,ESCOLA JOAN MARAGALL,17147,171479,RIPOLL,20,2,22
2019/2020,17002983,ESCOLA EL BRUC,17146,171463,RIELLS I VIABREA,15,3,18
2019/2020,17002958,ESCOLA MARE DE DÉU DE NÚRIA,17145,171450,RIBES DE FRESER,14,1,15
2019/2020,17002922,ESCOLA SANTA MARGARIDA,17142,171426,QUART,17,3,20
2019/2020,17002880,ESCOLA ALFONS I,17141,171411,PUIGCERDÀ,26,7,33
2019/2020,17002879,ESCOLA LES CLISQUES - ZER CAP DE CREUS,17140,171404,EL PORT DE LA SELVA,6,0,6
2019/2020,17002831,ESCOLA SANT JAUME,17138,171387,PORTBOU,7,0,7
2019/2020,17002818,ESCOLA FRIGOLET,17137,171371,PORQUERES,9,1,10
2019/2020,17002791,ESCOLA L'ENTORN,17137,171371,PORQUERES,28,3,31
2019/2020,17002776,ESCOLA TRAMUNTANA - ZER EMPORDÀ,17135,171352,PONT DE MOLINS,5,0,5
2019/2020,17002764,ESCOLA NÚRIA MORER I PI - ZER COMTE ARNAU,17134,171349,PLANOLES,4,0,4
2019/2020,17002752,ESCOLA SANT CRISTÒFOL,17133,171334,LES PLANES D'HOSTOLES,16,1,17
2019/2020,17002740,ESCOLA RAMON MUNTANER,17132,171328,PERALADA,14,2,16
2019/2020,17002715,ESCOLA PEDRA BLANCA - ZER EMPORDANET-GAVARRES,17130,171306,LA PERA,5,1,6
2019/2020,17002703,ESCOLA PAU,17128,171289,PAU,5,3,8
2019/2020,17002651,ESCOLA QUERMANY,17124,171241,PALS,16,2,18
2019/2020,17002624,ESCOLA MARTÍ INGLÈS,17120,171208,PALAU-SAVERDERA,13,2,15
2019/2020,17002612,ESCOLA VILA-ROMÀ,17118,171181,PALAMÓS,23,5,28
2019/2020,17002569,ESCOLA LA VILA,17118,171181,PALAMÓS,29,3,32
2019/2020,17002557,INSTITUT BAIX EMPORDÀ,17117,171175,PALAFRUGELL,57,50,107
2019/2020,17002545,INSTITUT FREDERIC MARTÍ I CARRERAS,17117,171175,PALAFRUGELL,46,28,74
2019/2020,17002491,ESCOLA JOSEP BARCELÓ I MATAS,17117,171175,PALAFRUGELL,25,11,36
2019/2020,17002481,ESCOLA TORRES JONAMA,17117,171175,PALAFRUGELL,33,3,36
2019/2020,17002442,ESCOLA LA VALL,17116,171169,OSOR,5,1,6
2019/2020,17002430,ESCOLA MARIA PAGÈS I TRAYTER,17115,171156,ORDIS,4,3,7
2019/2020,17002429,ESCOLA SANT ROC,17114,171143,OLOT,28,3,31
2019/2020,17002399,INSTITUT LA GARROTXA,17114,171143,OLOT,69,42,111
2019/2020,17002387,INSTITUT MONTSACOPA,17114,171143,OLOT,52,18,70
2019/2020,17002326,ESCOLA VOLCÀ BISAROQUES,17114,171143,OLOT,27,3,30
2019/2020,17002314,ESCOLA PLA DE DALT,17114,171143,OLOT,26,4,30
2019/2020,17002302,ESCOLA LLAR LLUÍS MARIA MESTRES I MARTÍ,17114,171143,OLOT,15,4,19
2019/2020,17002296,ESCOLA MALAGRIDA,17114,171143,OLOT,28,4,32
2019/2020,17002260,ESCOLA JOAQUIM VALLMAJÓ,17111,171117,NAVATA,13,2,15
2019/2020,17002259,ESCOLA TORRES JONAMA,17110,171100,MONT-RAS,11,5,16
2019/2020,17002247,ESCOLA MONT CÓS - ZER EL LLIERCA,17109,171096,MONTAGUT I OIX,7,0,7
2019/2020,17002201,ESCOLA FINESTRES,17105,171058,MIERES,6,0,6
2019/2020,17002193,ESCOLA SANTA FE,17169,171693,SANT JULIÀ DE RAMIS,9,3,12
2019/2020,17002181,ESCOLA SANT JORDI,17103,171030,MAÇANET DE LA SELVA,22,8,30
2019/2020,17002168,ESCOLA LES SALINES - ZER LES SALINES,17102,171024,MAÇANET DE CABRENYS,5,0,5
2019/2020,17002107,ESCOLA PERE TORRENT,17095,170950,LLORET DE MAR,37,5,42
2019/2020,17002090,ESCOLA JAUME I - ZER CERDANYA,17094,170947,LLÍVIA,9,1,10
2019/2020,17002089,ESCOLA DE LLERS,17093,170932,LLERS,11,4,15
2019/2020,17002077,ESCOLA POMPEU FABRA,17092,170926,LLANÇÀ,24,5,29
2019/2020,17002065,ESCOLA LES MORERES - ZER VALL DE TER,17091,170911,LLANARS,4,0,4
2019/2020,17002031,ESCOLA LACUSTÀRIA,17089,170890,LLAGOSTERA,30,3,33
2019/2020,17002028,ESCOLA MONTSERRAT VAYREDA I TRULLOL,17088,170887,LLADÓ,11,1,12
2019/2020,17002004,ESCOLA JOSEP PEÑUELAS DEL RIO,17086,170865,LA JONQUERA,22,9,31
2019/2020,17001981,ESCOLA MARE DE DÉU DELS SOCORS,17083,170834,HOSTALRIC,28,3,31
2019/2020,17001954,ESCOLA DE VILA-ROJA,17079,170792,GIRONA,13,0,13
2019/2020,17001930,ESCOLA JOSEP DALMAU I CARLES,17079,170792,GIRONA,24,6,30
2019/2020,17001887,ESCOLA CARME AUGUET,17079,170792,GIRONA,14,2,16
2019/2020,17001838,ESCOLA ÀGORA,17079,170792,GIRONA,15,2,17
2019/2020,17001759,INSTITUT ESCOLA D'HOSTALERIA I TURISME DE GIRONA,17079,170792,GIRONA,22,22,44
2019/2020,17001735,INSTITUT MONTILIVI,17079,170792,GIRONA,84,61,145
2019/2020,17001723,INSTITUT JAUME VICENS VIVES,17079,170792,GIRONA,49,25,74
2019/2020,17001693,CEE FONT DE L'ABELLA,17079,170792,GIRONA,36,7,43
2019/2020,17001516,ESCOLA PLA DE GIRONA,17079,170792,GIRONA,26,3,29
2019/2020,17001486,ESCOLA MONTJUÏC,17079,170792,GIRONA,15,2,17
2019/2020,17001462,ESCOLA VERD,17079,170792,GIRONA,15,2,17
2019/2020,17001450,ESCOLA JOAN BRUGUERA,17079,170792,GIRONA,13,3,16
2019/2020,17001449,ESCOLA ANNEXA - JOAN PUIGBERT,17079,170792,GIRONA,25,4,29
2019/2020,17001425,ESCOLA EIXIMENIS,17079,170792,GIRONA,17,0,17
2019/2020,17001395,ESCOLA SANTA COLOMA - ZER CERDANYA,17078,170789,GER,7,1,8
2019/2020,17001383,ESCOLA JOAQUIM GIFRE,17077,170773,GARRIGUELLA,11,4,15
2019/2020,17001371,ESCOLA DE GARRIGÀS - ZER EMPORDÀ,17075,170754,GARRIGÀS,4,0,4
2019/2020,17001361,ESCOLA TERESA DE PALLEJÀ,17074,170741,FORTIÀ,12,0,12
2019/2020,17001346,ESCOLA FORN D'ANELLS,17073,170736,FORNELLS DE LA SELVA,21,3,24
2019/2020,17001292,ESCOLA LES MORERES,17067,170675,FLAÇÀ,12,3,15
2019/2020,17001280,ESCOLA JOAQUIM CUSÍ I FURTUNET,17066,170669,FIGUERES,26,6,32
2019/2020,17001279,ESCOLA SANT PAU,17066,170669,FIGUERES,26,6,32
2019/2020,17001221,INSTITUT NARCÍS MONTURIOL,17066,170669,FIGUERES,51,32,83
2019/2020,17001218,INSTITUT RAMON MUNTANER,17066,170669,FIGUERES,47,19,66
2019/2020,17001115,ESCOLA JOSEP POUS I PAGÈS,17066,170669,FIGUERES,17,4,21
2019/2020,17001103,ESCOLA SALVADOR DALÍ,17066,170669,FIGUERES,27,4,31
2019/2020,17001097,ESCOLA CARLES DE FORTUNY,17065,170656,ESPONELLÀ,8,0,8
2019/2020,17001085,ESCOLA ANTONI BALMANYA - ZER REQUESENS,17064,170643,ESPOLLA,4,0,4
2019/2020,17001048,ESCOLA EMPÚRIES,17062,170622,L'ESCALA,35,4,39
2019/2020,17001036,ESCOLA MONT-ROIG - ZER REQUESENS,17060,170600,DARNIUS,3,1,4
2019/2020,17001024,ESCOLA LES GAVARRES - ZER EMPORDANET-GAVARRES,17901,179011,"CRUÏLLES, MONELLS I SANT SADURNÍ L'HEURA",5,1,6
2019/2020,17000998,ESCOLA EL RODONELL,17057,170577,CORÇÀ,14,2,16
2019/2020,17000986,ESCOLA LA VALL DEL TERRI,17056,170561,CORNELLÀ DEL TERRI,20,3,23
2019/2020,17000950,ESCOLA PUIG D'ESQUERS - ZER CAP DE CREUS,17054,170545,COLERA,3,0,3
2019/2020,17000937,ESCOLA MOSSÈN JOSEP MARIA ALBERT - ZER EMPORDÀ,17051,170519,CISTELLA,2,0,2
2019/2020,17000925,ESCOLA L'AIXART,17050,170502,CERVIÀ DE TER,12,1,13
2019/2020,17000913,ESCOLA L'AULET,17049,170499,CELRÀ,22,4,26
2019/2020,17000895,ESCOLA ELS ESTANYS,17048,170486,CASTELL-PLATJA D'ARO,27,4,31
2019/2020,17000883,ESCOLA VALL D'ARO,17048,170486,CASTELL-PLATJA D'ARO,14,2,16
2019/2020,17000871,ESCOLA RUIZ AMADO,17047,170470,CASTELLÓ D'EMPÚRIES,29,2,31
2019/2020,17000861,ESCOLA CASTELLROC,17046,170464,CASTELLFOLLIT DE LA ROCA,11,1,12
2019/2020,17000846,ESCOLA PUIG D'ARQUES,17044,170448,CASSÀ DE LA SELVA,25,5,30
2019/2020,17000822,ESCOLA ELS DÒLMENS - ZER REQUESENS,17042,170427,CAPMANY,2,2,4
2019/2020,17000779,ESCOLA DOCTOR ROBERT,17039,170391,CAMPRODON,19,2,21
2019/2020,17000731,ESCOLA PIRINEU,17036,170366,CAMPDEVÀNOL,21,0,21
2019/2020,17000718,ESCOLA LLEVANTÍ DE MAR,17034,170340,CALONGE I SANT ANTONI,14,2,16
2019/2020,17000706,INSTITUT PUIG CARGOL,17034,170340,CALONGE I SANT ANTONI,30,19,49
2019/2020,17000688,ESCOLA PERE ROSSELLÓ,17034,170340,CALONGE I SANT ANTONI,27,3,30
2019/2020,17000676,ESCOLA SANT ESTEVE,17033,170335,CALDES DE MALAVELLA,25,3,28
2019/2020,17000627,ESCOLA CARITAT SERINYANA,17032,170329,CADAQUÉS,15,3,18
2019/2020,17000603,ESCOLA SANTA CECÍLIA - ZER LES SALINES,17029,170293,BOADELLA I LES ESCAULES,3,0,3
2019/2020,17000585,ESCOLA MONTSENY,17027,170274,BREDA,24,4,28
2019/2020,17000573,ESCOLA SANT ANDREU DE BORRASSÀ,17026,170268,BORRASSÀ,10,0,10
2019/2020,17000561,ESCOLA DE BORDILS,17025,170255,BORDILS,13,4,17
2019/2020,17000551,INSTITUT SA PALOMERA,17023,170237,BLANES,47,30,77
2019/2020,17000548,ESCOLA MOSSÈN JOAN BATLLE,17023,170237,BLANES,19,8,27
2019/2020,17000470,ESCOLA CARLES FAUST,17023,170237,BLANES,9,6,15
2019/2020,17000469,ESCOLA JOAQUIM RUYRA,17023,170237,BLANES,16,2,18
2019/2020,17000411,ESCOLA JOAN DE MARGARIT,17022,170221,LA BISBAL D'EMPORDÀ,24,6,30
2019/2020,17000408,ESCOLA DOCTOR SOBREQUÉS,17020,170209,BESCANÓ,32,4,36
2019/2020,17000381,ESCOLA EL RAJARET - ZER MONTGRÍ,17018,170182,BELLCAIRE D'EMPORDÀ,7,0,7
2019/2020,17000354,ESCOLA JOAN REGLÀ,17016,170160,BÀSCARA,14,1,15
2019/2020,17000342,ESCOLA DE LA VILA BALDIRI REIXAC,17015,170157,BANYOLES,27,4,31
2019/2020,17000330,INSTITUT JOSEP BRUGULAT,17015,170157,BANYOLES,53,33,86
2019/2020,17000329,ESCOLA PLA DE L'AMETLLER,17015,170157,BANYOLES,29,2,31
2019/2020,17000305,INSTITUT PERE ALSIUS I TORRENT,17015,170157,BANYOLES,39,24,63
2019/2020,17000263,ESCOLA DOCTOR ARRUGA,17013,170139,BEGUR,12,4,16
2019/2020,17000251,ESCOLA GONÇAL COMELLAS,17012,170123,AVINYONET DE PUIGVENTÓS,13,2,15
2019/2020,17000241,ESCOLA FLUVIANETS,17011,170118,L'ARMENTERA,12,2,14
2019/2020,17000160,ESCOLA DOCTOR CARULLA,17009,170097,ARBÚCIES,31,4,35
2019/2020,17000135,ESCOLA POMPEU FABRA,17008,170084,ANGLÈS,25,5,30
2019/2020,17000123,ESCOLA SANT JORDI,17903,179032,SANT JULIÀ DEL LLOR I BONMATÍ,14,0,14
2019/2020,17000093,ESCOLA GASPAR DE QUERALT,17007,170078,AMER,15,3,18
2019/2020,17000071,ESCOLA BAC DE CERDANYA,17006,170062,ALP,15,1,16
2019/2020,17000068,ESCOLA DEL FAR D'EMPORDÀ,17005,170059,EL FAR D'EMPORDÀ,12,0,12
2019/2020,17000056,ESCOLA LA BRANCA - ZER MONTGRÍ,17004,170046,ALBONS,7,0,7
2019/2020,17000032,ESCOLA VILADEMANY,17002,170025,AIGUAVIVA,10,2,12
2019/2020,17000019,ESCOLA LLUÍS MARIÀ VIDAL - ZER LES SALINES,17001,170010,AGULLANA,7,1,8
2019/2020,08076650,CFA SANT ADRIÀ DE BESÒS,08194,081944,SANT ADRIÀ DE BESÒS,7,9,16
2019/2020,08076649,INSTITUT D'FP DE CASTELLAR DEL VALLÈS,08051,080517,CASTELLAR DEL VALLÈS,7,9,16
2019/2020,08076637,INSTITUT D'FP DE SANT CUGAT,08205,082055,SANT CUGAT DEL VALLÈS,20,17,37
2019/2020,08076613,INSTITUT ESCOLA BARNOLA,08012,080121,AVINYÓ,16,4,20
2019/2020,08076601,INSTITUT ESCOLA PERE VIVER,08279,082798,TERRASSA,33,5,38
2019/2020,08076595,INSTITUT ESCOLA TERESA ALTET,08184,081846,RUBÍ,27,9,36
2019/2020,08076583,INSTITUT ESCOLA ELS PINETONS,08180,081803,RIPOLLET,40,10,50
2019/2020,08076571,INSTITUT ESCOLA EL MARTINET,08180,081803,RIPOLLET,35,0,35
2019/2020,08076561,INSTITUT ESCOLA EL VIVER,08125,081252,MONTCADA I REIXAC,33,9,42
2019/2020,08076558,INSTITUT ESCOLA SANT ESTEVE,08051,080517,CASTELLAR DEL VALLÈS,30,4,34
2019/2020,08076546,INSTITUT ESCOLA CAN LLOBET,08252,082520,BARBERÀ DEL VALLÈS,29,7,36
2019/2020,08076534,INSTITUT ESCOLA MONTAGUT,08261,082613,SANTA SUSANNA,22,7,29
2019/2020,08076522,INSTITUT ESCOLA PALLEROLA,08202,082021,SANT CELONI,36,6,42
2019/2020,08076510,INSTITUT ESCOLA PLA DE L'AVELLÀ,08029,080291,CABRERA DE MAR,32,1,33
2019/2020,08076509,INSTITUT ESCOLA ARTS,08019,080193,BARCELONA,24,4,28
2019/2020,08076492,INSTITUT ESCOLA POMPEU FABRA,08182,081825,EL PONT DE VILOMARA I ROCAFORT,25,8,33
2019/2020,08076480,INSTITUT ESCOLA PALLARESA,08245,082457,SANTA COLOMA DE GRAMENET,28,10,38
2019/2020,08076479,INSTITUT ESCOLA SANT QUINTÍ DE MEDIONA,08236,082362,SANT QUINTÍ DE MEDIONA,28,11,39
2019/2020,08076467,INSTITUT ESCOLA PERE LLISCART,08101,081017,L'HOSPITALET DE LLOBREGAT,37,8,45
2019/2020,08076455,INSTITUT ESCOLA SANT JORDI,08015,080155,BADALONA,17,2,19
2019/2020,08076443,INSTITUT ESCOLA RAFAEL ALBERTI,08015,080155,BADALONA,30,6,36
2019/2020,08076431,INSTITUT ESCOLA BALDOMER SOLÀ,08015,080155,BADALONA,25,8,33
2019/2020,08076421,INSTITUT ESCOLA PEPA COLOMER,08169,081691,EL PRAT DE LLOBREGAT,39,6,45
2019/2020,08076406,INSTITUT NARCISA FREIXAS I CRUELLS,08187,081878,SABADELL,5,2,7
2019/2020,08076391,INSTITUT PEDRALBES,08019,080193,BARCELONA,75,58,133
2019/2020,08076194,INSTITUT TECNOLÒGIC DE BARCELONA,08019,080193,BARCELONA,9,19,28
2019/2020,08076169,INSTITUT ESCOLA GORNAL,08101,081017,L'HOSPITALET DE LLOBREGAT,17,8,25
2019/2020,08076157,INSTITUT ESCOLA ÀNGELA BRANSUELA,08121,081213,MATARÓ,26,8,34
2019/2020,08076145,INSTITUT ESCOLA MAR MEDITERRÀNIA,08121,081213,MATARÓ,33,11,44
2019/2020,08076111,INSTITUT JAUME BOTEY,08101,081017,L'HOSPITALET DE LLOBREGAT,24,8,32
2019/2020,08076108,INSTITUT JAUME CABRÉ,08279,082798,TERRASSA,8,3,11
2019/2020,08076091,INSTITUT CA N'ORIAC,08187,081878,SABADELL,8,4,12
2019/2020,08076078,ESCOLA AUDITORI,08019,080193,BARCELONA,7,0,7
2019/2020,08075724,ESCOLA NORAI,08126,081265,MONTGAT,5,0,5
2019/2020,08075712,INSTITUT LES CINC SÉNIES,08121,081213,MATARÓ,14,10,24
2019/2020,08075700,ESCOLA XIRINACS,08019,080193,BARCELONA,10,1,11
2019/2020,08075682,INSTITUT OLÍMPIA,08301,083015,VILADECANS,14,10,24
2019/2020,08075670,INSTITUT ESCOLA TRINITAT NOVA,08019,080193,BARCELONA,41,16,57
2019/2020,08075669,INSTITUT ESCOLA EL TIL·LER,08019,080193,BARCELONA,23,8,31
2019/2020,08075657,INSTITUT ESCOLA ANTAVIANA,08019,080193,BARCELONA,37,17,54
2019/2020,08075645,ESCOLA LA FLOR DE MAIG,08019,080193,BARCELONA,13,0,13
2019/2020,08075633,ESCOLA ANGLESOLA,08019,080193,BARCELONA,9,2,11
2019/2020,08075621,ESCOLA TEIXIDORES DE GRÀCIA,08019,080193,BARCELONA,11,0,11
2019/2020,08075611,ESCOLA GAIA,08019,080193,BARCELONA,14,1,15
2019/2020,08075608,ESCOLA 9 GRAONS,08019,080193,BARCELONA,7,4,11
2019/2020,08075384,INSTITUT ESCOLA LA MINA,08194,081944,SANT ADRIÀ DE BESÒS,45,26,71
2019/2020,08075293,INSTITUT ESCOLA GAVÀ MAR,08089,080898,GAVÀ,39,9,48
2019/2020,08075281,INSTITUT BITÀCOLA,08252,082520,BARBERÀ DEL VALLÈS,14,8,22
2019/2020,08075268,ESCOLA LA MIRADA,08205,082055,SANT CUGAT DEL VALLÈS,16,1,17
2019/2020,08075256,INSTITUT ESCOLA MARTA MATA,08285,082858,TORELLÓ,44,6,50
2019/2020,08075244,ESCOLA LES BASES,08113,081136,MANRESA,11,1,12
2019/2020,08075207,ESCOLA ENTENÇA,08019,080193,BARCELONA,14,1,15
2019/2020,08075074,INSTITUT DE SANTA COLOMA DE GRAMENET,08245,082457,SANTA COLOMA DE GRAMENET,4,7,11
2019/2020,08074847,INSTITUT DE NÀUTICA DE BARCELONA,08019,080193,BARCELONA,7,21,28
2019/2020,08074835,ESCOLA JAUME LLULL,08197,081976,SANT ANDREU DE LLAVANERES,26,5,31
2019/2020,08074823,ESCOLA ELS PICOTS,08107,081075,LLIÇÀ D'AMUNT,25,4,29
2019/2020,08074811,ESCOLA TURÓ DE CAN GILI,08096,080961,GRANOLLERS,21,8,29
2019/2020,08074801,INSTITUT MARTA ESTRADA,08096,080961,GRANOLLERS,16,6,22
2019/2020,08074641,ESCOLA 30 PASSOS,08019,080193,BARCELONA,15,1,16
2019/2020,08074631,INSTITUT LES SALINES,08169,081691,EL PRAT DE LLOBREGAT,44,43,87
2019/2020,08074628,INSTITUT EL PRAT DE LLOBREGAT,08169,081691,EL PRAT DE LLOBREGAT,2,6,8
2019/2020,08074410,INSTITUT LA SERRA,08187,081878,SABADELL,15,8,23
2019/2020,08074380,ESCOLA CASTELL DE DOSRIUS,08075,080752,DOSRIUS,22,8,30
2019/2020,08074070,EOI DE CALELLA,08035,080351,CALELLA,4,3,7
2019/2020,08073961,INSTITUT PLA DEL BOSC,08043,080431,CANYELLES,14,7,21
2019/2020,08073958,ESCOLA NOVA D'ARGENTONA,08009,080095,ARGENTONA,22,3,25
2019/2020,08073843,INSTITUT TORDÀRIA,08284,082845,TORDERA,16,7,23
2019/2020,08073651,INSTITUT PIC DEL VENT,08033,080333,CALDES DE MONTBUI,17,5,22
2019/2020,08073193,INSTITUT BADIA I MARGARIT,08102,081022,IGUALADA,16,12,28
2019/2020,08073171,INSTITUT LA RIERA,08015,080155,BADALONA,10,7,17
2019/2020,08073119,INSTITUT CAN PERIQUET,08156,081568,PALAU-SOLITÀ I PLEGAMANS,18,0,18
2019/2020,08073077,INSTITUT MARIA CANELA,08114,081141,MARTORELL,16,7,23
2019/2020,08073031,INSTITUT NEUS CATALÀ,08073,080734,CORNELLÀ DE LLOBREGAT,15,11,26
2019/2020,08073028,INSTITUT DE SANT POL DE MAR,08235,082359,SANT POL DE MAR,29,13,42
2019/2020,08072978,INSTITUT SUNSI MÓRA,08040,080403,CANET DE MAR,17,13,30
2019/2020,08072607,EOI DE CORNELLÀ DE LLOBREGAT,08073,080734,CORNELLÀ DE LLOBREGAT,6,4,10
2019/2020,08072590,EOI DE RUBÍ,08184,081846,RUBÍ,4,2,6
2019/2020,08072589,EOI GUINARDÓ,08019,080193,BARCELONA,8,2,10
2019/2020,08072401,INSTITUT TORRENT DELS ALOUS,08184,081846,RUBÍ,41,11,52
2019/2020,08072395,ESCOLA POLINYÀ,08167,081672,POLINYÀ,16,2,18
2019/2020,08072383,INSTITUT DOMUS D'OLIVET,08041,080410,CANOVELLES,18,8,26
2019/2020,08072292,INSTITUT ESCOLA TURÓ DE ROQUETES,08019,080193,BARCELONA,44,15,59
2019/2020,08072255,INSTITUT PREMIÀ DE MAR,08172,081727,PREMIÀ DE MAR,50,59,109
2019/2020,08072188,INSTITUT ESCOLA SANT JORDI,08141,081419,NAVÀS,39,11,50
2019/2020,08072176,INSTITUT DEL TER,08112,081120,MANLLEU,22,4,26
2019/2020,08071691,INSTITUT ESCOLA DEL PRAT,08169,081691,EL PRAT DE LLOBREGAT,22,8,30
2019/2020,08071573,ESC.SUP.DISSENY ESDAP - CATALUNYA,08019,080193,BARCELONA,2,1,3
2019/2020,08071421,ZER EL MOIANÈS LLEVANT,08055,080556,CASTELLCIR,2,2,4
2019/2020,08071238,INSTITUT ESCOLA JACINT VERDAGUER,08240,082401,SANT SADURNÍ D'ANOIA,39,16,55
2019/2020,08071226,INSTITUT ESCOLA COSTA I LLOBERA,08019,080193,BARCELONA,42,20,62
2019/2020,08071214,INSTITUT ESCOLA CASTELLTERÇOL,08064,080641,CASTELLTERÇOL,31,4,35
2019/2020,08071196,INSTITUT CAN ROCA,08279,082798,TERRASSA,37,20,57
2019/2020,08071172,ESCOLA VIROLET,08187,081878,SABADELL,23,7,30
2019/2020,08071147,ESCOLA ROSER CAPDEVILA,08217,082172,SANT JOAN DESPÍ,24,2,26
2019/2020,08071020,ESCOLA ENXANETA,08301,083015,VILADECANS,20,2,22
2019/2020,08070908,INSTITUT ESCOLA LA TORDERA,08259,082592,SANTA MARIA DE PALAUTORDERA,44,9,53
2019/2020,08070799,ESCOLA TIZIANA,08282,082824,TIANA,16,0,16
2019/2020,08070234,ESCOLA CAN FABRA,08019,080193,BARCELONA,26,1,27
2019/2020,08070143,ESCOLA RIERA ALTA,08245,082457,SANTA COLOMA DE GRAMENET,25,4,29
2019/2020,08070040,ESCOLA SALA I BADRINAS,08279,082798,TERRASSA,26,2,28
2019/2020,08069751,ESCOLA SANTA COLOMA,08245,082457,SANTA COLOMA DE GRAMENET,17,3,20
2019/2020,08069748,ESCOLA MONTIGALÀ,08015,080155,BADALONA,11,4,15
2019/2020,08069736,ESCOLA PACO CANDEL,08101,081017,L'HOSPITALET DE LLOBREGAT,28,2,30
2019/2020,08069581,CFA CARME KARR,08218,082188,SANT JOAN DE VILATORRADA,13,2,15
2019/2020,08069499,ESCOLA VIC-CENTRE,08298,082981,VIC,17,4,21
2019/2020,08068616,INSTITUT BAGES SUD,08053,080538,CASTELLBELL I EL VILAR,15,5,20
2019/2020,08068537,INSTITUT LES AIMERIGUES,08279,082798,TERRASSA,33,17,50
2019/2020,08068495,INSTITUT JOSEFINA CASTELLVÍ I PIULACHS,08301,083015,VILADECANS,27,19,46
2019/2020,08068410,ESCOLA PALAU D'AMETLLA,08136,081363,MONTORNÈS DEL VALLÈS,12,6,18
2019/2020,08068380,INSTITUT GURB,08100,081000,GURB,20,12,32
2019/2020,08068379,ESCOLA MAR NOVA,08172,081727,PREMIÀ DE MAR,11,2,13
2019/2020,08068343,ESCOLA LES CIÈNCIES,08015,080155,BADALONA,14,3,17
2019/2020,08068331,ESCOLA BADALONA PORT,08015,080155,BADALONA,14,2,16
2019/2020,08068197,ZER EL CARDENER,08229,082299,SANT MATEU DE BAGES,3,1,4
2019/2020,08068136,CFA VÍCTOR CATALÀ,08208,082080,SANT ESTEVE SESROVIRES,17,6,23
2019/2020,08067818,ESCOLA LA SÍNIA,08298,082981,VIC,32,5,37
2019/2020,08067764,ESCOLA LA MAQUINISTA,08019,080193,BARCELONA,29,1,30
2019/2020,08067752,INSTITUT SAGRERA SANT ANDREU,08019,080193,BARCELONA,5,4,9
2019/2020,08067661,ESCOLA JOAN COROMINES,08121,081213,MATARÓ,26,3,29
2019/2020,08067648,INSTITUT LES VINYES,08074,080749,CUBELLES,19,6,25
2019/2020,08067636,INSTITUT MANRESA SIS,08113,081136,MANRESA,11,5,16
2019/2020,08067600,ESCOLA VALLDAURA,08113,081136,MANRESA,16,2,18
2019/2020,08067594,INSTITUT ESCOLA LES VINYES,08054,080543,CASTELLBISBAL,31,15,46
2019/2020,08067582,ESCOLA MARTA MATA,08252,082520,BARBERÀ DEL VALLÈS,16,4,20
2019/2020,08067430,ESCOLA MONTSERRAT SOLÀ,08121,081213,MATARÓ,24,6,30
2019/2020,08067247,ESCOLA EL VAPOR,08279,082798,TERRASSA,27,4,31
2019/2020,08067235,ESCOLA ROC ALABERN,08279,082798,TERRASSA,25,5,30
2019/2020,08067211,INSTITUT SALAS I XANDRI,08238,082384,SANT QUIRZE DEL VALLÈS,16,6,22
2019/2020,08067201,ESCOLA LOLA ANGLADA,08238,082384,SANT QUIRZE DEL VALLÈS,24,4,28
2019/2020,08067193,ESCOLA DEL BOSC,08184,081846,RUBÍ,17,5,22
2019/2020,08067181,ESCOLA DE RELLINARS,08179,081799,RELLINARS,9,2,11
2019/2020,08067144,INSTITUT DE CERVELLÓ,08068,080689,CERVELLÓ,25,13,38
2019/2020,08067132,ESCOLA JOSEFINA IBÁÑEZ,08001,080018,ABRERA,17,1,18
2019/2020,08067120,ESCOLA SANTA AGNÈS DE MALANYANES,08181,081810,LA ROCA DEL VALLÈS,13,1,14
2019/2020,08067090,ESCOLA CAN MANENT,08046,080462,CARDEDEU,25,3,28
2019/2020,08067041,ESCOLA XORIGUER,08067,080673,CENTELLES,14,1,15
2019/2020,08067016,ESCOLA ERNEST LLUCH,08101,081017,L'HOSPITALET DE LLOBREGAT,16,4,20
2019/2020,08066905,INSTITUT VILADOMAT,08019,080193,BARCELONA,18,9,27
2019/2020,08066887,EOI DE VILADECANS,08301,083015,VILADECANS,6,4,10
2019/2020,08066851,EOI DE MOLLET DEL VALLÈS,08124,081249,MOLLET DEL VALLÈS,5,3,8
2019/2020,08066565,INSTITUT 22@,08019,080193,BARCELONA,11,6,17
2019/2020,08066541,INSTITUT MARIA ESPINALT,08019,080193,BARCELONA,25,18,43
2019/2020,08066531,ESCOLA FLUVIÀ,08019,080193,BARCELONA,26,3,29
2019/2020,08066528,INSTITUT MARTÍ POUS,08019,080193,BARCELONA,17,11,28
2019/2020,08066516,ESCOLA CONGRÉS-INDIANS,08019,080193,BARCELONA,27,2,29
2019/2020,08066504,ESCOLA L'UNIVERS,08019,080193,BARCELONA,21,2,23
2019/2020,08066462,ESCOLA DELS ENCANTS,08019,080193,BARCELONA,26,4,30
2019/2020,08066437,INSTITUT MONT PERDUT,08279,082798,TERRASSA,41,23,64
2019/2020,08066413,ESCOLA COLORS,08086,080863,LES FRANQUESES DEL VALLÈS,16,1,17
2019/2020,08066371,ESCOLA EL DESPUJOL,08117,081173,LES MASIES DE VOLTREGÀ,14,2,16
2019/2020,08066334,ESCOLA LA SERRETA,08192,081923,SANTPEDOR,13,3,16
2019/2020,08066322,INSTITUT CARDENER,08218,082188,SANT JOAN DE VILATORRADA,17,8,25
2019/2020,08066048,ESCOLA ROSER CAPDEVILA,08279,082798,TERRASSA,28,2,30
2019/2020,08065664,EOI DEL BERGUEDÀ,08022,080229,BERGA,4,1,5
2019/2020,08065652,EOI DE L'ALT PENEDÈS,08305,083054,VILAFRANCA DEL PENEDÈS,4,3,7
2019/2020,08065512,ESCOLA SERRA DE L'OBAC,08279,082798,TERRASSA,25,5,30
2019/2020,08065482,ESCOLA ELS VENTETS - ZER EL MOIANÈS LLEVANT,08070,080706,COLLSUSPINA,3,1,4
2019/2020,08065469,INSTITUT CAN RECORD,08207,082074,SANT ESTEVE DE PALAUTORDERA,20,3,23
2019/2020,08065433,INSTITUT LA SÍNIA,08159,081593,PARETS DEL VALLÈS,14,7,21
2019/2020,08065421,INSTITUT MARTA MATA,08136,081363,MONTORNÈS DEL VALLÈS,29,16,45
2019/2020,08065411,INSTITUT AIGUAVIVA,08124,081249,MOLLET DEL VALLÈS,32,13,45
2019/2020,08065408,INSTITUT HIPÀTIA D'ALEXANDRIA,08107,081075,LLIÇÀ D'AMUNT,16,6,22
2019/2020,08065391,INSTITUT EL TIL·LER,08086,080863,LES FRANQUESES DEL VALLÈS,31,17,48
2019/2020,08065366,INSTITUT DE PINEDA DE MAR,08163,081635,PINEDA DE MAR,28,11,39
2019/2020,08065354,INSTITUT BAIX A MAR,08307,083073,VILANOVA I LA GELTRÚ,31,18,49
2019/2020,08065342,INSTITUT XALOC,08231,082310,SANT PERE DE RIBES,16,7,23
2019/2020,08065330,INSTITUT CAL GRAVAT,08113,081136,MANRESA,43,14,57
2019/2020,08065329,INSTITUT DE L'ALT FOIX,08227,082270,SANT MARTÍ SARROCA,23,16,39
2019/2020,08065305,ESCOLA SOLER DE VILARDELL,08202,082021,SANT CELONI,20,0,20
2019/2020,08065299,ESCOLA EL CALDERÍ,08033,080333,CALDES DE MONTBUI,16,0,16
2019/2020,08065287,ESCOLA MARTA MATA,08121,081213,MATARÓ,29,0,29
2019/2020,08065275,ESCOLA VOLERANY,08307,083073,VILANOVA I LA GELTRÚ,23,5,28
2019/2020,08065263,ESCOLA PUIGSOLER,08262,082628,SANT VICENÇ DE CASTELLET,19,4,23
2019/2020,08065251,ESCOLA PLA DEL PUIG,08213,082135,SANT FRUITÓS DE BAGES,14,1,15
2019/2020,08065238,ESCOLA LA SAGRERA,08248,082482,SANTA EULÀLIA DE RONÇANA,24,5,29
2019/2020,08065019,INSTITUT DE VALLBONA D'ANOIA,08292,082922,VALLBONA D'ANOIA,18,5,23
2019/2020,08065007,ESCOLA POBLE NOU,08163,081635,PINEDA DE MAR,14,2,16
2019/2020,08064994,ESCOLA MARIA-MERCÈ MARÇAL,08121,081213,MATARÓ,25,5,30
2019/2020,08064982,ESCOLA DE SANT QUIRZE SAFAJA - ZER EL MOIANÈS LLEVANT,08239,082397,SANT QUIRZE SAFAJA,4,1,5
2019/2020,08064970,INSTITUT NOU DE VILAFRANCA DEL PENEDÈS,08305,083054,VILAFRANCA DEL PENEDÈS,28,13,41
2019/2020,08064945,ESCOLA MANSUET,08069,080692,COLLBATÓ,14,2,16
2019/2020,08064921,INSTITUT DE SANT ANDREU,08196,081960,SANT ANDREU DE LA BARCA,24,11,35
2019/2020,08064911,INSTITUT VALÈRIA HALINÉ,08056,080569,CASTELLDEFELS,24,11,35
2019/2020,08064908,INSTITUT BEGUES,08020,080207,BEGUES,19,5,24
2019/2020,08064881,ESCOLA CAMPDERRÓS,08295,082956,VALLIRANA,19,4,23
2019/2020,08064866,ESCOLA DOLORS MARTÍ I BADIA,08102,081022,IGUALADA,26,4,30
2019/2020,08064854,ESCOLA MARTINET,08073,080734,CORNELLÀ DE LLOBREGAT,24,5,29
2019/2020,08064830,INSTITUT SERRA DE NOET,08022,080229,BERGA,21,6,27
2019/2020,08064829,ESCOLA VALLDENEU,08224,082248,SANT MARTÍ DE CENTELLES,8,0,8
2019/2020,08064817,ESCOLA CAMINS,08086,080863,LES FRANQUESES DEL VALLÈS,29,3,32
2019/2020,08064805,ESCOLA ELS QUATRE VENTS,08041,080410,CANOVELLES,27,8,35
2019/2020,08064787,ESCOLA EMILI TEIXIDOR,08183,081831,RODA DE TER,18,0,18
2019/2020,08064751,ESCOLA MAR I CEL,08074,080749,CUBELLES,16,3,19
2019/2020,08064741,ESCOLA ÍTACA,08113,081136,MANRESA,23,7,30
2019/2020,08064738,ESCOLA DOLORS PIERA,08305,083054,VILAFRANCA DEL PENEDÈS,27,5,32
2019/2020,08064659,CFA SALVADOR DALÍ,08181,081810,LA ROCA DEL VALLÈS,17,6,23
2019/2020,08064647,CFA ARTUR MARTORELL,08208,082080,SANT ESTEVE SESROVIRES,18,5,23
2019/2020,08064635,CFA SANTIAGO RUSIÑOL,08181,081810,LA ROCA DEL VALLÈS,10,4,14
2019/2020,08064623,CFA CONCEPCIÓ ARENAL,08019,080193,BARCELONA,3,1,4
2019/2020,08064222,ESCOLA LA ROUREDA,08284,082845,TORDERA,26,2,28
2019/2020,08064179,ESCOLA LA LLACUNA DEL POBLENOU,08019,080193,BARCELONA,27,3,30
2019/2020,08064167,ESCOLA SANT MARTÍ,08019,080193,BARCELONA,28,1,29
2019/2020,08064155,INSTITUT QUATRE CANTONS,08019,080193,BARCELONA,31,15,46
2019/2020,08064143,ESCOLA LA NOVA ELECTRA,08279,082798,TERRASSA,35,7,42
2019/2020,08064131,ESCOLA ELS AIGÜEROLS,08260,082606,SANTA PERPÈTUA DE MOGODA,14,4,18
2019/2020,08064118,ESCOLA CIUTAT D'ALBA,08205,082055,SANT CUGAT DEL VALLÈS,25,5,30
2019/2020,08064088,ESCOLA MAS BOADELLA,08187,081878,SABADELL,26,2,28
2019/2020,08064076,ESCOLA RIVO RUBEO,08184,081846,RUBÍ,25,4,29
2019/2020,08064064,ESCOLA CAN PERIQUET,08156,081568,PALAU-SOLITÀ I PLEGAMANS,1,1,2
2019/2020,08064052,ESCOLA MAS RAMPINYO,08125,081252,MONTCADA I REIXAC,26,3,29
2019/2020,08064027,ESCOLA EL SOL I LA LLUNA,08051,080517,CASTELLAR DEL VALLÈS,20,4,24
2019/2020,08064003,INSTITUT CAN MARGARIT,08072,080728,CORBERA DE LLOBREGAT,25,11,36
2019/2020,08063965,ESCOLA CAU DE LA GUINEU,08072,080728,CORBERA DE LLOBREGAT,13,2,15
2019/2020,08063931,ESCOLA LES FALGUERES,08082,080826,FOGARS DE LA SELVA,14,1,15
2019/2020,08063928,ESCOLA MUNTANYOLA,08129,081290,MUNTANYOLA,6,0,6
2019/2020,08063916,ESCOLA VILA PARIETES,08159,081593,PARETS DEL VALLÈS,14,3,17
2019/2020,08063904,INSTITUT MONTGRÒS,08231,082310,SANT PERE DE RIBES,27,16,43
2019/2020,08063898,ESCOLA LA SÈQUIA,08113,081136,MANRESA,24,6,30
2019/2020,08063886,ESCOLA ARRELS,08251,082515,SANTA MARGARIDA I ELS MONJOS,15,1,16
2019/2020,08063874,ESCOLA ANTONIO MACHADO,08121,081213,MATARÓ,25,3,28
2019/2020,08063862,ESCOLA L'OLIVAR,08062,080620,CASTELLNOU DE BAGES,13,3,16
2019/2020,08063837,INSTITUT LES MARGUES,08037,080370,CALLDETENES,24,9,33
2019/2020,08063813,INSTITUT CREU DE SABA,08147,081477,OLESA DE MONTSERRAT,30,15,45
2019/2020,08063801,INSTITUT DE COLLBATÓ,08069,080692,COLLBATÓ,22,9,31
2019/2020,08063795,ESCOLA MARTA MATA,08302,083020,VILANOVA DEL CAMÍ,12,3,15
2019/2020,08063783,ESCOLA MEDITERRÀNIA,08301,083015,VILADECANS,15,2,17
2019/2020,08063771,ESCOLA PLA DE LES VINYES,08244,082444,SANTA COLOMA DE CERVELLÓ,23,3,26
2019/2020,08063761,ESCOLA VICENTE FERRER,08200,082009,SANT BOI DE LLOBREGAT,13,4,17
2019/2020,08063758,ESCOLA CAN SALVI,08196,081960,SANT ANDREU DE LA BARCA,28,3,31
2019/2020,08063746,INSTITUT SALVADOR CLARAMUNT,08161,081614,PIERA,18,7,25
2019/2020,08063734,ESCOLA PUIGVENTÓS,08147,081477,OLESA DE MONTSERRAT,25,5,30
2019/2020,08063710,ESCOLA ESCOLA NOVA,08068,080689,CERVELLÓ,18,0,18
2019/2020,08063643,CFA LA COOPERATIVA,08285,082858,TORELLÓ,1,2,3
2019/2020,08063621,CFA MARTÍ I POL,08112,081120,MANLLEU,3,2,5
2019/2020,08063618,CFA ESPARREGUERA,08076,080765,ESPARREGUERA,3,2,5
2019/2020,08063394,ESCOLA MIQUEL MARTÍ I POL,08211,082114,SANT FELIU DE LLOBREGAT,25,4,29
2019/2020,08063229,INSTITUT MONTPEDRÓS,08244,082444,SANTA COLOMA DE CERVELLÓ,30,22,52
2019/2020,08063072,ESCOLA FRUCTUÓS GELABERT,08019,080193,BARCELONA,27,2,29
2019/2020,08062948,ESCOLA MIQUEL MARTÍ I POL,08301,083015,VILADECANS,36,5,41
2019/2020,08062924,ESCOLA JOSEP GUINOVART,08056,080569,CASTELLDEFELS,15,4,19
2019/2020,08062870,INSTITUT LA PLANA,08298,082981,VIC,34,13,47
2019/2020,08062869,ESCOLA SERRA DE MIRALLES,08284,082845,TORDERA,16,3,19
2019/2020,08062857,INSTITUT TIANA,08282,082824,TIANA,21,9,30
2019/2020,08062833,ESCOLA AGNÈS DE SITGES,08270,082704,SITGES,14,1,15
2019/2020,08062811,ESCOLA MATAGALLS,08259,082592,SANTA MARIA DE PALAUTORDERA,14,2,16
2019/2020,08062808,INSTITUT ESTEVE ALBERT,08264,082649,SANT VICENÇ DE MONTALT,29,19,48
2019/2020,08062791,INSTITUT VILAMAJOR,08234,082346,SANT PERE DE VILAMAJOR,29,16,45
2019/2020,08062781,ESCOLA MEDITERRÀNIA,08231,082310,SANT PERE DE RIBES,24,3,27
2019/2020,08062778,ESCOLA AMETLLERS,08218,082188,SANT JOAN DE VILATORRADA,25,3,28
2019/2020,08062754,ESCOLA LES FONTS,08091,080919,GELIDA,22,7,29
2019/2020,08062742,ESCOLA BENVIURE,08054,080543,CASTELLBISBAL,16,2,18
2019/2020,08062730,INSTITUT ELS ROURES,08075,080752,DOSRIUS,18,5,23
2019/2020,08062729,INSTITUT PLA MARCELL,08046,080462,CARDEDEU,42,14,56
2019/2020,08062717,INSTITUT CABRILS,08030,080305,CABRILS,22,13,35
2019/2020,08062705,ESCOLA LA CABANA,08027,080272,LES CABANYES,11,2,13
2019/2020,08062687,ESCOLA PONENT,08279,082798,TERRASSA,27,2,29
2019/2020,08062675,ESCOLA PERE IV,08019,080193,BARCELONA,25,5,30
2019/2020,08062641,ESCOLA L'OLIVERA,08205,082055,SANT CUGAT DEL VALLÈS,25,5,30
2019/2020,08062638,ESCOLA LA TRAMA,08187,081878,SABADELL,22,2,24
2019/2020,08062626,ESCOLA COLLSEROLA,08266,082665,CERDANYOLA DEL VALLÈS,15,1,16
2019/2020,08062614,ESCOLA JOAN BLANQUER,08051,080517,CASTELLAR DEL VALLÈS,16,0,16
2019/2020,08062523,CFA MARINADA,08136,081363,MONTORNÈS DEL VALLÈS,3,1,4
2019/2020,08062511,CFA ALARONA,08121,081213,MATARÓ,4,2,6
2019/2020,08062493,CFA SANT RAMON,08101,081017,L'HOSPITALET DE LLOBREGAT,6,1,7
2019/2020,08062481,CFA SANT JOSEP,08101,081017,L'HOSPITALET DE LLOBREGAT,4,2,6
2019/2020,08062471,CFA GAVÀ,08089,080898,GAVÀ,3,3,6
2019/2020,08062468,CFA BELLAVISTA,08086,080863,LES FRANQUESES DEL VALLÈS,4,1,5
2019/2020,08062331,CFA PERE CALDERS,08019,080193,BARCELONA,6,3,9
2019/2020,08062262,CFA MONTSERRAT ROIG,08019,080193,BARCELONA,7,1,8
2019/2020,08062250,CFA TORRENT D'EN MELIS,08019,080193,BARCELONA,4,1,5
2019/2020,08062249,CFA EL CARMEL,08019,080193,BARCELONA,6,3,9
2019/2020,08062225,EOI GARRAF,08307,083073,VILANOVA I LA GELTRÚ,5,4,9
2019/2020,08062213,EOI VALLÈS ORIENTAL,08096,080961,GRANOLLERS,5,3,8
2019/2020,08062201,EOI BARCELONA V,08019,080193,BARCELONA,6,2,8
2019/2020,08062195,EOI BARCELONA IV,08019,080193,BARCELONA,8,5,13
2019/2020,08062183,EOI OSONA,08298,082981,VIC,5,2,7
2019/2020,08062171,EOI D'IGUALADA,08102,081022,IGUALADA,7,1,8
2019/2020,08062161,EOI DE SANT CUGAT DEL VALLÈS,08205,082055,SANT CUGAT DEL VALLÈS,6,3,9
2019/2020,08062158,EOI DE MARTORELL,08114,081141,MARTORELL,4,4,8
2019/2020,08062146,CFA LA VERNEDA,08019,080193,BARCELONA,4,4,8
2019/2020,08062122,CFA MARTORELL,08114,081141,MARTORELL,3,5,8
2019/2020,08062110,CFA SANFELIU,08101,081017,L'HOSPITALET DE LLOBREGAT,4,2,6
2019/2020,08062109,AFA CIUTAT MERIDIANA,08019,080193,BARCELONA,3,4,7
2019/2020,08062092,CFA VILAFRANCA DEL PENEDÈS,08305,083054,VILAFRANCA DEL PENEDÈS,5,4,9
2019/2020,08062080,CFA EGARA,08279,082798,TERRASSA,8,2,10
2019/2020,08062079,CFA RAMON LLULL,08279,082798,TERRASSA,4,1,5
2019/2020,08062055,CFA SANT JUST DESVERN,08221,082212,SANT JUST DESVERN,2,2,4
2019/2020,08062043,CFA PARETS DEL VALLÈS,08159,081593,PARETS DEL VALLÈS,2,2,4
2019/2020,08062031,CFA MARE DE DÉU DE MONTSERRAT,08147,081477,OLESA DE MONTSERRAT,4,0,4
2019/2020,08062021,CFA MONTCADA I REIXAC,08125,081252,MONTCADA I REIXAC,5,2,7
2019/2020,08062018,CFA ANOIA,08102,081022,IGUALADA,3,1,4
2019/2020,08061993,CFA EUGENI D'ORS,08077,080771,ESPLUGUES DE LLOBREGAT,8,2,10
2019/2020,08061971,CFA BERGUEDÀ,08022,080229,BERGA,5,0,5
2019/2020,08061968,CFA LES CORTS,08019,080193,BARCELONA,5,2,7
2019/2020,08061956,CFA PROSPERITAT,08019,080193,BARCELONA,3,2,5
2019/2020,08061944,CFA MADRID,08019,080193,BARCELONA,5,0,5
2019/2020,08061932,CFA BON PASTOR,08019,080193,BARCELONA,5,2,7
2019/2020,08061919,CFA RIUS I TAULET,08019,080193,BARCELONA,9,0,9
2019/2020,08061907,CFA BARCELONETA,08019,080193,BARCELONA,6,1,7
2019/2020,08061774,ESCOLA LES ARENES,08279,082798,TERRASSA,24,7,31
2019/2020,08061762,ESCOLA MAS MARIA,08030,080305,CABRILS,19,5,24
2019/2020,08061725,EOI BARCELONA III,08019,080193,BARCELONA,7,4,11
2019/2020,08061701,CFA MARIA RUBIES,08019,080193,BARCELONA,4,5,9
2019/2020,08061683,CFA PALAU DE MAR,08019,080193,BARCELONA,4,4,8
2019/2020,08061622,ESCOLA CAN COLL,08289,082896,TORRELLES DE LLOBREGAT,17,1,18
2019/2020,08061610,ESCOLA LA SÍNIA,08123,081234,MOLINS DE REI,22,6,28
2019/2020,08061609,ESCOLA MERCÈ RODOREDA,08114,081141,MARTORELL,36,1,37
2019/2020,08061580,AFA LLOREDA-LA PAU,08015,080155,BADALONA,4,2,6
2019/2020,08061555,CFA CAN FOLGUERA,08260,082606,SANTA PERPÈTUA DE MOGODA,5,2,7
2019/2020,08061543,ESCOLA ROSER CAPDEVILA,08167,081672,POLINYÀ,23,5,28
2019/2020,08061521,ESCOLA VALL DE NÉSPOLA - ZER EL MOIANÈS PONENT,08139,081398,MURA,5,1,6
2019/2020,08061361,INSTITUT TORRELLES DE LLOBREGAT,08289,082896,TORRELLES DE LLOBREGAT,10,12,22
2019/2020,08061348,ESCOLA BUFALÀ,08015,080155,BADALONA,28,2,30
2019/2020,08061221,CFA VALLÈS,08096,080961,GRANOLLERS,9,3,12
2019/2020,08061208,INSTITUT VACARISSES,08291,082917,VACARISSES,31,21,52
2019/2020,08061191,ESCOLA FONT DE L'ORPINA,08291,082917,VACARISSES,15,2,17
2019/2020,08061181,ESCOLA SANTIGA,08260,082606,SANTA PERPÈTUA DE MOGODA,16,3,19
2019/2020,08061178,ESCOLA TURÓ DE CAN MATES,08205,082055,SANT CUGAT DEL VALLÈS,27,2,29
2019/2020,08061166,ESCOLA DE CAN LLONG,08187,081878,SABADELL,22,6,28
2019/2020,08061154,ESCOLA CA N'ALZAMORA,08184,081846,RUBÍ,31,1,32
2019/2020,08061142,ESCOLA MIQUEL MARTÍ I POL,08252,082520,BARBERÀ DEL VALLÈS,29,1,30
2019/2020,08061129,INSTITUT MONTSERRAT COLOMER,08208,082080,SANT ESTEVE SESROVIRES,38,14,52
2019/2020,08061117,INSTITUT TURÓ D'EN BALDIRI,08281,082819,TEIÀ,16,5,21
2019/2020,08061105,ESCOLA SOT DEL CAMP,08264,082649,SANT VICENÇ DE MONTALT,21,0,21
2019/2020,08061099,INSTITUT FONT DEL FERRO,08155,081555,PALAFOLLS,42,15,57
2019/2020,08061087,ESCOLA MARINA,08126,081265,MONTGAT,27,3,30
2019/2020,08061063,ESCOLA LA SERRETA,08003,080039,ALELLA,16,1,17
2019/2020,08061051,ESCOLA ÍTACA,08307,083073,VILANOVA I LA GELTRÚ,23,2,25
2019/2020,08061041,ESCOLA SANT JORDI,08307,083073,VILANOVA I LA GELTRÚ,28,5,33
2019/2020,08061038,INSTITUT DE VILANOVA DEL VALLÈS,08902,089024,VILANOVA DEL VALLÈS,29,24,53
2019/2020,08061026,ESCOLA LA FALGUERA,08902,089024,VILANOVA DEL VALLÈS,14,6,20
2019/2020,08061014,INSTITUT VINYET,08270,082704,SITGES,33,15,48
2019/2020,08061002,ESCOLA LES PARELLADES,08231,082310,SANT PERE DE RIBES,14,5,19
2019/2020,08060991,ESCOLA MOGENT,08181,081810,LA ROCA DEL VALLÈS,26,2,28
2019/2020,08060988,ESCOLA CAL MÚSIC,08124,081249,MOLLET DEL VALLÈS,20,6,26
2019/2020,08060976,INSTITUT DEL VOLTREGANÈS,08117,081173,LES MASIES DE VOLTREGÀ,28,8,36
2019/2020,08060964,ESCOLA QUATRE VENTS,08112,081120,MANLLEU,37,6,43
2019/2020,08060952,ESCOLA ELS VINYALS,08108,081081,LLIÇÀ DE VALL,13,2,15
2019/2020,08060940,ESCOLA ROSA ORIOL ANGUERA,08107,081075,LLIÇÀ D'AMUNT,22,3,25
2019/2020,08060939,ESCOLA GUERAU DE LIOST,08086,080863,LES FRANQUESES DEL VALLÈS,25,4,29
2019/2020,08060927,ESCOLA VORA DEL MAR,08074,080749,CUBELLES,29,2,31
2019/2020,08060915,INSTITUT MARIA DE BELL-LLOC,08023,080235,BIGUES I RIELLS,33,17,50
2019/2020,08060903,ESCOLA EL COLOMER,08023,080235,BIGUES I RIELLS,24,4,28
2019/2020,08060873,ESCOLA EULÀLIA BOTA,08019,080193,BARCELONA,28,2,30
2019/2020,08060851,ESCOLA L'OLIVERA,08295,082956,VALLIRANA,20,7,27
2019/2020,08060848,ESCOLA DE SANT ANDREU DE LA BARCA,08196,081960,SANT ANDREU DE LA BARCA,24,6,30
2019/2020,08060836,ESCOLA TURÓ DEL DRAC,08040,080403,CANET DE MAR,30,3,33
2019/2020,08060757,ESCOLA JOAN TORREDEMER CANELA,08120,081206,MATADEPERA,28,1,29
2019/2020,08060629,ESCOLA EL CORB,08072,080728,CORBERA DE LLOBREGAT,15,3,18
2019/2020,08060605,ESCOLA FONT DEL ROURE,08119,081192,MASQUEFA,27,3,30
2019/2020,08060599,ESCOLA GARIGOT,08056,080569,CASTELLDEFELS,26,4,30
2019/2020,08060538,EOI DEL PRAT DE LLOBREGAT,08169,081691,EL PRAT DE LLOBREGAT,9,2,11
2019/2020,08060526,ESCOLA CREIXÀ,08161,081614,PIERA,11,2,13
2019/2020,08060514,INSTITUT DE MASQUEFA,08119,081192,MASQUEFA,36,24,60
2019/2020,08060484,ESCOLA TAULA RODONA,08238,082384,SANT QUIRZE DEL VALLÈS,23,5,28
2019/2020,08060423,ESCOLA MAS PRATS,08155,081555,PALAFOLLS,28,1,29
2019/2020,08060411,CFA SANTS-SANT RAIMON DE PENYAFORT,08019,080193,BARCELONA,2,4,6
2019/2020,08060319,ESCOLA LES FONTS,08009,080095,ARGENTONA,23,2,25
2019/2020,08060290,CFA SINGUERLÍN,08245,082457,SANTA COLOMA DE GRAMENET,6,4,10
2019/2020,08060289,CFA FONDO,08245,082457,SANTA COLOMA DE GRAMENET,6,7,13
2019/2020,08060277,CFA PAU CASALS,08184,081846,RUBÍ,7,4,11
2019/2020,08060265,CFA PREMIÀ DE MAR,08172,081727,PREMIÀ DE MAR,3,4,7
2019/2020,08060253,CFA CAN MARFÀ,08121,081213,MATARÓ,10,2,12
2019/2020,08060231,CFA PEGASO,08019,080193,BARCELONA,8,3,11
2019/2020,08060228,CFA EL CLOT,08019,080193,BARCELONA,6,5,11
2019/2020,08060216,CFA MORERA POMAR,08015,080155,BADALONA,8,3,11
2019/2020,08060204,CFA GRAN SOL,08015,080155,BADALONA,6,6,12
2019/2020,08060137,CFA EDÈLIA HERNÁNDEZ,08301,083015,VILADECANS,8,3,11
2019/2020,08060113,CFA JACINT CARRIÓ I VILASECA,08113,081136,MANRESA,8,5,13
2019/2020,08060095,CFA MONTSENY,08298,082981,VIC,9,2,11
2019/2020,08060009,INSTITUT MANUEL CARRASCO I FORMIGUERA,08210,082107,SANT FELIU DE CODINES,14,8,22
2019/2020,08059998,ESCOLA LA PAU,08240,082401,SANT SADURNÍ D'ANOIA,28,2,30
2019/2020,08059871,ESCOLA GERBERT D'ORLHAC,08205,082055,SANT CUGAT DEL VALLÈS,27,3,30
2019/2020,08059822,ESCOLA ERNEST LLUCH,08001,080018,ABRERA,26,4,30
2019/2020,08059810,ESCOLA VINYA DEL SASTRET,08208,082080,SANT ESTEVE SESROVIRES,15,2,17
2019/2020,08059809,ESCOLA EL ROURE,08209,082093,SANT FOST DE CAMPSENTELLES,17,0,17
2019/2020,08059792,ESCOLA MOGENT,08136,081363,MONTORNÈS DEL VALLÈS,25,5,30
2019/2020,08059780,ESCOLA BELLAVISTA-JOAN CAMPS I GIRÓ,08086,080863,LES FRANQUESES DEL VALLÈS,22,7,29
2019/2020,08059767,ESCOLA TANIT,08245,082457,SANTA COLOMA DE GRAMENET,18,3,21
2019/2020,08059755,ESCOLA LA FONT,08113,081136,MANRESA,29,4,33
2019/2020,08059731,CFA ARQUITECTE JUJOL,08217,082172,SANT JOAN DESPÍ,9,4,13
2019/2020,08059721,ESCOLA MARTA MATA,08301,083015,VILADECANS,33,3,36
2019/2020,08059706,CFA SALVADOR ESPRIU,08279,082798,TERRASSA,6,0,6
2019/2020,08059691,CFA ANNA MURIÀ,08279,082798,TERRASSA,9,3,12
2019/2020,08059688,INSTITUT MARIA AURÈLIA CAPMANY,08073,080734,CORNELLÀ DE LLOBREGAT,38,15,53
2019/2020,08059639,ESCOLA PROGRÉS,08015,080155,BADALONA,28,2,30
2019/2020,08059551,EOI DE MANRESA,08113,081136,MANRESA,10,3,13
2019/2020,08059524,INSTITUT DE NAVARCLES,08140,081402,NAVARCLES,12,10,22
2019/2020,08059354,ESCOLA LES ROQUES BLAVES,08076,080765,ESPARREGUERA,21,2,23
2019/2020,08059329,INSTITUT CAN PEIXAUET,08245,082457,SANTA COLOMA DE GRAMENET,31,26,57
2019/2020,08059287,ZER GUILLERIES,17220,172207,VILADRAU,2,2,4
2019/2020,08059093,ESCOLA D'HORTSAVINYÀ,08284,082845,TORDERA,3,3,6
2019/2020,08059044,CFA LA LLAGOSTA,08105,081056,LA LLAGOSTA,8,2,10
2019/2020,08058969,INSTITUT EL VERN,08108,081081,LLIÇÀ DE VALL,27,7,34
2019/2020,08058957,ESCOLA ELS COSTERETS,08231,082310,SANT PERE DE RIBES,24,2,26
2019/2020,08058817,ZER TRES BRANQUES,08063,080636,CASTELLOLÍ,2,1,3
2019/2020,08058775,INSTITUT FRONT MARÍTIM,08019,080193,BARCELONA,28,18,46
2019/2020,08058520,INSTITUT PUIG DE LA CREU,08051,080517,CASTELLAR DEL VALLÈS,36,14,50
2019/2020,08058519,ESCOLA SINERA,08006,080060,ARENYS DE MAR,24,6,30
2019/2020,08058465,ESCOLA ENXANETA,08279,082798,TERRASSA,37,5,42
2019/2020,08058441,ESCOLA GIROI,08088,080885,LA GARRIGA,21,3,24
2019/2020,08058428,INSTITUT BISAURA,08237,082378,SANT QUIRZE DE BESORA,14,8,22
2019/2020,08058416,ESCOLA L'ARENAL DE LLEVANT,08019,080193,BARCELONA,25,4,29
2019/2020,08058404,INSTITUT CIRVIÀNUM DE TORELLÓ,08285,082858,TORELLÓ,38,21,59
2019/2020,08058374,ESCOLA ELS ALOCS,08219,082191,VILASSAR DE MAR,14,2,16
2019/2020,08058362,ESCOLA RIERA DE RIBES,08231,082310,SANT PERE DE RIBES,27,2,29
2019/2020,08058210,CFA BADIA DEL VALLÈS,08904,089045,BADIA DEL VALLÈS,2,0,2
2019/2020,08058209,CFA SANT BOI,08200,082009,SANT BOI DE LLOBREGAT,8,4,12
2019/2020,08058091,ZER BAIX BERGUEDÀ,08144,081445,OLVAN,4,0,4
2019/2020,08058088,ZER BERGUEDÀ CENTRE,08299,082994,VILADA,3,0,3
2019/2020,08058076,ZER ELS CASTELLS,08131,081311,MONTESQUIU,3,1,4
2019/2020,08057965,CFA CAN SERRA,08101,081017,L'HOSPITALET DE LLOBREGAT,8,3,11
2019/2020,08057874,CFA CATALÒNIA,08101,081017,L'HOSPITALET DE LLOBREGAT,7,2,9
2019/2020,08057746,INSTITUT BAETULO,08015,080155,BADALONA,18,10,28
2019/2020,08057734,ESCOLA ANTONI GAUDÍ,08250,082508,SANTA MARGARIDA DE MONTBUI,29,5,34
2019/2020,08057679,CFA BELLVITGE-GORNAL,08101,081017,L'HOSPITALET DE LLOBREGAT,9,2,11
2019/2020,08057667,CFA TRINITAT VELLA,08019,080193,BARCELONA,3,2,5
2019/2020,08057540,INSTITUT JOAN BROSSA,08019,080193,BARCELONA,48,27,75
2019/2020,08057281,ZER CEP DE SIS,08249,082495,SANTA FE DEL PENEDÈS,3,1,4
2019/2020,08057266,ESCOLA ELS CINGLES,08005,080057,L'AMETLLA DEL VALLÈS,21,2,23
2019/2020,08057254,INSTITUT PERE RIBOT,08219,082191,VILASSAR DE MAR,29,17,46
2019/2020,08057242,ESCOLA SERENA VALL,08197,081976,SANT ANDREU DE LLAVANERES,26,3,29
2019/2020,08057230,INSTITUT CUBELLES,08074,080749,CUBELLES,38,13,51
2019/2020,08057229,ESCOLA ELS ARENYS,08054,080543,CASTELLBISBAL,19,3,22
2019/2020,08057163,CFA TERESA MAÑÉ,08307,083073,VILANOVA I LA GELTRÚ,7,7,14
2019/2020,08057102,ESCOLA ANDERSEN,08298,082981,VIC,33,4,37
2019/2020,08057096,ESCOLA GUILLEM DE MONT-RODON,08298,082981,VIC,32,4,36
2019/2020,08057011,CFA CAN RULL,08187,081878,SABADELL,6,3,9
2019/2020,08057001,CFA LA CREU DE BARBERÀ,08187,081878,SABADELL,7,2,9
2019/2020,08056997,CFA LA CONCÒRDIA,08187,081878,SABADELL,12,4,16
2019/2020,08056985,INSTITUT RAMON BERENGUER IV,08245,082457,SANTA COLOMA DE GRAMENET,41,25,66
2019/2020,08056857,ZER GAVARRESA,08212,082129,SANT FELIU SASSERRA,4,0,4
2019/2020,08056833,ZER BAIX MONTSENY,08259,082592,SANTA MARIA DE PALAUTORDERA,2,1,3
2019/2020,08056811,ZER ALT BERGUEDÀ,08293,082938,VALLCEBRE,2,2,4
2019/2020,08056791,ZER VENT D'AVALL,08170,081705,ELS PRATS DE REI,3,1,4
2019/2020,08056781,ZER SERRA D'ANCOSA,08104,081043,LA LLACUNA,2,2,4
2019/2020,08056766,ZER SUBIRATS,08273,082732,SUBIRATS,2,1,3
2019/2020,08056742,ZER ALT LLUÇANÈS,08201,082016,SANT BOI DE LLUÇANÈS,2,1,3
2019/2020,08056729,ZER EL MOIANÈS PONENT,08034,080348,CALDERS,3,1,4
2019/2020,08056614,ESCOLA CIRERA,08121,081213,MATARÓ,23,3,26
2019/2020,08056584,CFA L'ALZINA DE CERDANYOLA,08266,082665,CERDANYOLA DEL VALLÈS,6,4,10
2019/2020,08056572,CFA TERRA BAIXA,08169,081691,EL PRAT DE LLOBREGAT,4,8,12
2019/2020,08056560,CFA BARBERÀ,08252,082520,BARBERÀ DEL VALLÈS,6,3,9
2019/2020,08056122,ESCOLA LES FLANDES,08161,081614,PIERA,22,9,31
2019/2020,08056109,INSTITUT CAN VILUMARA,08101,081017,L'HOSPITALET DE LLOBREGAT,66,22,88
2019/2020,08055944,INSTITUT RUBIÓ I ORS,08101,081017,L'HOSPITALET DE LLOBREGAT,26,13,39
2019/2020,08055932,ESCOLA TORRENT DE CAN CARABASSA,08019,080193,BARCELONA,26,5,31
2019/2020,08055907,ESCOLA MIQUEL MARTÍ I POL,08107,081075,LLIÇÀ D'AMUNT,13,6,19
2019/2020,08055890,ESCOLA SOBIRANS,08007,080076,ARENYS DE MUNT,21,3,24
2019/2020,08055889,ESCOLA MIQUEL MARTÍ I POL,08187,081878,SABADELL,27,2,29
2019/2020,08055713,CFA SANT CUGAT DEL VALLÈS,08205,082055,SANT CUGAT DEL VALLÈS,7,0,7
2019/2020,08055695,CFA RAFAEL FARRÉ,08123,081234,MOLINS DE REI,1,5,6
2019/2020,08055683,CFA MANUEL SACRISTÁN,08019,080193,BARCELONA,6,6,12
2019/2020,08055440,CFA GARROSA,08263,082634,SANT VICENÇ DELS HORTS,8,2,10
2019/2020,08055439,CFA MESTRE ESTEVE,08211,082114,SANT FELIU DE LLOBREGAT,5,3,8
2019/2020,08055403,CFA SANT ROC,08015,080155,BADALONA,4,4,8
2019/2020,08055397,CFA JAUME TUSET,08180,081803,RIPOLLET,6,5,11
2019/2020,08055385,CFA MOLLET DEL VALLÈS,08124,081249,MOLLET DEL VALLÈS,6,3,9
2019/2020,08055105,ESCOLA ARRAONA,08187,081878,SABADELL,24,5,29
2019/2020,08055075,CFA TORRE ROMEU,08187,081878,SABADELL,3,2,5
2019/2020,08055063,CFA CANYELLES,08019,080193,BARCELONA,4,2,6
2019/2020,08055051,CFA CASTELLDEFELS,08056,080569,CASTELLDEFELS,3,5,8
2019/2020,08055041,CFA CANOVELLES,08041,080410,CANOVELLES,5,4,9
2019/2020,08055002,CFA BARRI GÒTIC,08019,080193,BARCELONA,5,3,8
2019/2020,08054903,ESCOLA MEDITERRÀNIA,08019,080193,BARCELONA,17,5,22
2019/2020,08054873,INSTITUT JOAQUIMA PLA I FARRERAS,08205,082055,SANT CUGAT DEL VALLÈS,41,19,60
2019/2020,08054836,ESCOLA ONZE DE SETEMBRE,08238,082384,SANT QUIRZE DEL VALLÈS,17,5,22
2019/2020,08054824,ESCOLA MESTRE PLA,08051,080517,CASTELLAR DEL VALLÈS,15,1,16
2019/2020,08054411,ESCOLA VALLGORGUINA,08294,082943,VALLGORGUINA,12,3,15
2019/2020,08054401,INSTITUT EL SUI,08046,080462,CARDEDEU,37,16,53
2019/2020,08054368,CEE CA N'ORIOL,08184,081846,RUBÍ,20,1,21
2019/2020,08054344,EOI ESPLUGUES,08077,080771,ESPLUGUES DE LLOBREGAT,11,4,15
2019/2020,08054277,INSTITUT DE TONA,08283,082830,TONA,45,23,68
2019/2020,08054241,INSTITUT EUGENI XAMMAR,08005,080057,L'AMETLLA DEL VALLÈS,28,18,46
2019/2020,08054228,INSTITUT JOAN FUSTER,08019,080193,BARCELONA,33,10,43
2019/2020,08054198,INSTITUT ESTANY DE LA RICARDA,08169,081691,EL PRAT DE LLOBREGAT,28,17,45
2019/2020,08054186,INSTITUT CAN MAS,08180,081803,RIPOLLET,38,17,55
2019/2020,08054174,INSTITUT LA RIBERA,08125,081252,MONTCADA I REIXAC,30,14,44
2019/2020,08054113,ESCOLA ANXANETA,08121,081213,MATARÓ,28,4,32
2019/2020,08054061,ESCOLA MONTBAIG,08200,082009,SANT BOI DE LLOBREGAT,16,4,20
2019/2020,08054058,ESCOLA TORRE DE LA MIRANDA,08073,080734,CORNELLÀ DE LLOBREGAT,31,6,37
2019/2020,08054034,INSTITUT GALLECS,08124,081249,MOLLET DEL VALLÈS,76,39,115
2019/2020,08054022,ESCOLA MARINADA,08019,080193,BARCELONA,16,1,17
2019/2020,08053650,ESCOLA TURÓ DE GUIERA,08266,082665,CERDANYOLA DEL VALLÈS,23,7,30
2019/2020,08053601,ESCOLA LOLA ANGLADA,08114,081141,MARTORELL,30,2,32
2019/2020,08053583,ESCOLA MARIA OSSÓ,08270,082704,SITGES,29,2,31
2019/2020,08053571,INST-ESC ART. ORIOL MARTORELL,08019,080193,BARCELONA,80,46,126
2019/2020,08053522,ESCOLA LA GINESTA,08295,082956,VALLIRANA,14,2,16
2019/2020,08053510,ESCOLA PUIG D'AGULLES,08072,080728,CORBERA DE LLOBREGAT,19,3,22
2019/2020,08053492,ESCOLA TERESA CLARAMUNT,08187,081878,SABADELL,26,3,29
2019/2020,08053467,ESCOLA PALAU,08156,081568,PALAU-SOLITÀ I PLEGAMANS,24,4,28
2019/2020,08053455,ESCOLA LES AIGÜES,08046,080462,CARDEDEU,25,4,29
2019/2020,08053443,EOI SANTA COLOMA,08245,082457,SANTA COLOMA DE GRAMENET,7,6,13
2019/2020,08053431,ESCOLA EL ROURE,08168,081688,PONTONS,3,1,4
2019/2020,08053421,ESCOLA ALOC,08163,081635,PINEDA DE MAR,20,4,24
2019/2020,08053418,ESCOLA EL MORSELL,08148,081483,OLIVELLA,18,4,22
2019/2020,08053406,ESCOLA CAN BESORA,08124,081249,MOLLET DEL VALLÈS,26,2,28
2019/2020,08053391,ESCOLA LLEDONER,08096,080961,GRANOLLERS,26,6,32
2019/2020,08053364,INSTITUT JOSEP MESTRES I BUSQUETS,08301,083015,VILADECANS,36,18,54
2019/2020,08053352,INSTITUT MONTBUI,08250,082508,SANTA MARGARIDA DE MONTBUI,38,16,54
2019/2020,08053340,INSTITUT GABRIELA MISTRAL,08263,082634,SANT VICENÇ DELS HORTS,54,29,83
2019/2020,08053315,INSTITUT MONTSERRAT ROIG,08196,081960,SANT ANDREU DE LA BARCA,34,23,57
2019/2020,08053297,INSTITUT DE PALLEJÀ,08157,081574,PALLEJÀ,33,20,53
2019/2020,08053285,INSTITUT EL CASTELL,08076,080765,ESPARREGUERA,39,27,66
2019/2020,08053261,INSTITUT DE VILADECAVALLS,08300,083008,VILADECAVALLS,39,23,62
2019/2020,08053251,INSTITUT CAVALL BERNAT,08279,082798,TERRASSA,48,30,78
2019/2020,08053248,INSTITUT DE SENTMENAT,08267,082671,SENTMENAT,32,13,45
2019/2020,08053236,INSTITUT ROVIRA-FORNS,08260,082606,SANTA PERPÈTUA DE MOGODA,40,20,60
2019/2020,08053224,INSTITUT LES TERMES,08187,081878,SABADELL,35,13,48
2019/2020,08053212,INSTITUT JONQUERES,08187,081878,SABADELL,38,17,55
2019/2020,08053200,INSTITUT MIQUEL CRUSAFONT I PAIRÓ,08187,081878,SABADELL,27,17,44
2019/2020,08053194,EOI DE TERRASSA,08279,082798,TERRASSA,17,8,25
2019/2020,08053182,INSTITUT LA SERRETA,08184,081846,RUBÍ,60,29,89
2019/2020,08053170,INSTITUT POLINYÀ,08167,081672,POLINYÀ,29,20,49
2019/2020,08053169,INSTITUT MATADEPERA,08120,081206,MATADEPERA,39,19,58
2019/2020,08053157,INSTITUT GORGS,08266,082665,CERDANYOLA DEL VALLÈS,30,19,49
2019/2020,08053145,INSTITUT CASTELLBISBAL,08054,080543,CASTELLBISBAL,39,24,63
2019/2020,08053121,INSTITUT TARADELL,08278,082785,TARADELL,30,19,49
2019/2020,08053111,INSTITUT D'AURO,08192,081923,SANTPEDOR,36,13,49
2019/2020,08053108,INSTITUT REGUISSOL,08259,082592,SANTA MARIA DE PALAUTORDERA,32,13,45
2019/2020,08053091,INSTITUT EL FOIX,08251,082515,SANTA MARGARIDA I ELS MONJOS,42,14,56
2019/2020,08053078,INSTITUT NUMÀNCIA,08245,082457,SANTA COLOMA DE GRAMENET,42,14,56
2019/2020,08053054,INSTITUT GERBERT D'AURILLAC,08213,082135,SANT FRUITÓS DE BAGES,34,12,46
2019/2020,08053042,INSTITUT MIQUEL MARTÍ I POL,08183,081831,RODA DE TER,32,10,42
2019/2020,08053030,INSTITUT DE LA ROCA DEL VALLÈS,08181,081810,LA ROCA DEL VALLÈS,31,19,50
2019/2020,08053029,EOI BADALONA,08015,080155,BADALONA,8,3,11
2019/2020,08053017,INSTITUT VALERIÀ PUJOL I BOSCH,08230,082303,PREMIÀ DE DALT,27,23,50
2019/2020,08053005,INSTITUT CASTELL DE QUER,08171,081712,PRATS DE LLUÇANÈS,19,11,30
2019/2020,08052992,INSTITUT EUCLIDES,08163,081635,PINEDA DE MAR,36,21,57
2019/2020,08052980,INSTITUT MONTMELÓ,08135,081350,MONTMELÓ,39,16,55
2019/2020,08052979,INSTITUT JOSEP PUIG I CADAFALCH,08121,081213,MATARÓ,55,23,78
2019/2020,08052955,INSTITUT DE LLIÇÀ,08107,081075,LLIÇÀ D'AMUNT,36,25,61
2019/2020,08052931,EOI DEL MARESME,08121,081213,MATARÓ,11,2,13
2019/2020,08052921,INSTITUT EUGENI D'ORS,08101,081017,L'HOSPITALET DE LLOBREGAT,32,13,45
2019/2020,08052918,INSTITUT BISBE BERENGUER,08101,081017,L'HOSPITALET DE LLOBREGAT,30,19,49
2019/2020,08052906,INSTITUT LAURO,08086,080863,LES FRANQUESES DEL VALLÈS,49,21,70
2019/2020,08052891,INSTITUT L'ALT BERGUEDÀ,08016,080168,BAGÀ,21,14,35
2019/2020,08052888,INSTITUT JÚLIA MINGUELL,08015,080155,BADALONA,29,24,53
2019/2020,08052876,INSTITUT D'ARGENTONA,08009,080095,ARGENTONA,45,24,69
2019/2020,08052839,INSTITUT CONSELL DE CENT,08019,080193,BARCELONA,30,16,46
2019/2020,08052827,INSTITUT LLUÍS DOMÈNECH I MONTANER,08019,080193,BARCELONA,28,19,47
2019/2020,08052797,INSTITUT SALVADOR ESPRIU,08019,080193,BARCELONA,32,30,62
2019/2020,08052785,ESCOLA VILA OLÍMPICA,08019,080193,BARCELONA,27,3,30
2019/2020,08052761,INSTITUT JOSEP COMAS I SOLÀ,08019,080193,BARCELONA,14,10,24
2019/2020,08052724,INSTITUT FRANCISCO DE GOYA,08019,080193,BARCELONA,25,18,43
2019/2020,08052700,INSTITUT VALL D'HEBRON,08019,080193,BARCELONA,84,45,129
2019/2020,08052670,ESCOLA AURÓ,08019,080193,BARCELONA,32,2,34
2019/2020,08052669,ESCOLA FERRAN SUNYER,08019,080193,BARCELONA,29,7,36
2019/2020,08052657,ESCOLA FORT PIENC,08019,080193,BARCELONA,28,2,30
2019/2020,08052621,ESCOLA PAU ROMEVA,08019,080193,BARCELONA,28,2,30
2019/2020,08052608,INSTITUT PAU CLARIS,08019,080193,BARCELONA,28,10,38
2019/2020,08052581,INSTITUT MIQUEL TARRADELL,08019,080193,BARCELONA,47,14,61
2019/2020,08052207,INSTITUT DE PUIG-REIG,08175,081751,PUIG-REIG,16,17,33
2019/2020,08052165,ESCOLA OCTAVIO PAZ,08019,080193,BARCELONA,14,3,17
2019/2020,08051471,ESCOLA JOSEP MARIA FOLCH I TORRES,08101,081017,L'HOSPITALET DE LLOBREGAT,27,5,32
2019/2020,08051318,ESCOLA SANT LLORENÇ DEL MUNT,08279,082798,TERRASSA,28,3,31
2019/2020,08051306,ESCOLA ABAT MARCET,08279,082798,TERRASSA,27,2,29
2019/2020,08051264,INSTITUT EDUARD FONTSERÈ,08101,081017,L'HOSPITALET DE LLOBREGAT,34,17,51
2019/2020,08051240,ESCOLA MEDITERRÀNIA,08073,080734,CORNELLÀ DE LLOBREGAT,28,2,30
2019/2020,08047832,INSTITUT JOAN COROMINES,08163,081635,PINEDA DE MAR,49,23,72
2019/2020,08047820,INSTITUT GUINOVARDA,08161,081614,PIERA,53,21,74
2019/2020,08047583,INSTITUT SANT QUIRZE DEL VALLÈS,08238,082384,SANT QUIRZE DEL VALLÈS,50,31,81
2019/2020,08047509,INSTITUT ÍTACA,08200,082009,SANT BOI DE LLOBREGAT,25,22,47
2019/2020,08047492,INSTITUT RIBERA BAIXA,08169,081691,EL PRAT DE LLOBREGAT,38,19,57
2019/2020,08047480,INSTITUT MEDITERRÀNIA,08056,080569,CASTELLDEFELS,61,32,93
2019/2020,08047479,INSTITUT ALBA DEL VALLÈS,08209,082093,SANT FOST DE CAMPSENTELLES,39,17,56
2019/2020,08047467,INSTITUT ALEXANDRE GALÍ,08231,082310,SANT PERE DE RIBES,41,18,59
2019/2020,08047431,INSTITUT XXV OLIMPÍADA,08019,080193,BARCELONA,37,19,56
2019/2020,08047421,INSTITUT MONTSERRAT ROIG,08019,080193,BARCELONA,26,18,44
2019/2020,08047376,INSTITUT LLOBREGAT,08191,081918,SALLENT,22,18,40
2019/2020,08047364,INSTITUT JOAN MERCADER,08102,081022,IGUALADA,43,24,67
2019/2020,08046876,INSTITUT MIQUEL BOSCH I JOVER,08010,080109,ARTÉS,30,12,42
2019/2020,08046864,INSTITUT BELLULLA,08041,080410,CANOVELLES,38,17,55
2019/2020,08046852,INSTITUT LLAVANERES,08197,081976,SANT ANDREU DE LLAVANERES,35,20,55
2019/2020,08046840,INSTITUT CASTELLET,08262,082628,SANT VICENÇ DE CASTELLET,40,36,76
2019/2020,08046803,INSTITUT VILATZARA,08219,082191,VILASSAR DE MAR,42,30,72
2019/2020,08046797,INSTITUT LAIA L'ARQUERA,08121,081213,MATARÓ,32,25,57
2019/2020,08046785,INSTITUT D'ALELLA,08003,080039,ALELLA,29,15,44
2019/2020,08046761,INSTITUT GUILLEM CATÀ,08113,081136,MANRESA,61,33,94
2019/2020,08046751,INSTITUT VENTURA GASSOL,08015,080155,BADALONA,30,18,48
2019/2020,08046748,INSTITUT THOS I CODINA,08121,081213,MATARÓ,62,36,98
2019/2020,08046736,INSTITUT MILÀ I FONTANALS,08305,083054,VILAFRANCA DEL PENEDÈS,41,28,69
2019/2020,08046724,INSTITUT MONTSERRAT ROIG,08279,082798,TERRASSA,67,37,104
2019/2020,08046694,INSTITUT CENTRE D'ALT RENDIMENT ESPORTIU,08205,082055,SANT CUGAT DEL VALLÈS,22,29,51
2019/2020,08046682,INSTITUT DE CASTELLAR,08051,080517,CASTELLAR DEL VALLÈS,48,35,83
2019/2020,08046670,INSTITUT ANGELETA FERRER I SENSAT,08205,082055,SANT CUGAT DEL VALLÈS,43,26,69
2019/2020,08046669,INSTITUT RIBOT I SERRA,08187,081878,SABADELL,55,17,72
2019/2020,08046657,INSTITUT JOAQUIM BLUME,08077,080771,ESPLUGUES DE LLOBREGAT,14,12,26
2019/2020,08046645,INSTITUT MOLÍ DE LA VILA,08044,080446,CAPELLADES,35,16,51
2019/2020,08046608,INSTITUT PRÍNCEP DE VIANA,08019,080193,BARCELONA,27,19,46
2019/2020,08046581,INSTITUT LLUÍS VIVES,08019,080193,BARCELONA,22,14,36
2019/2020,08046293,ESCOLA CAVALL BERNAT,08019,080193,BARCELONA,14,4,18
2019/2020,08046281,ESCOLA ESTEL-GUINARDÓ,08019,080193,BARCELONA,11,5,16
2019/2020,08045860,INSTITUT MIRAMAR,08301,083015,VILADECANS,30,25,55
2019/2020,08045859,INSTITUT DE CORBERA DE LLOBREGAT,08072,080728,CORBERA DE LLOBREGAT,28,21,49
2019/2020,08045689,INSTITUT VOLTRERA,08001,080018,ABRERA,39,26,65
2019/2020,08045677,INSTITUT THALASSA,08126,081265,MONTGAT,30,17,47
2019/2020,08045665,INSTITUT RAMON TURRÓ I DARDER,08110,081108,MALGRAT DE MAR,43,25,68
2019/2020,08045653,INSTITUT DOLORS MALLAFRÈ I ROS,08307,083073,VILANOVA I LA GELTRÚ,39,17,56
2019/2020,08045641,INSTITUT LLUÍS DOMÈNECH I MONTANER,08040,080403,CANET DE MAR,44,22,66
2019/2020,08045628,INSTITUT CELESTÍ BELLERA,08096,080961,GRANOLLERS,41,17,58
2019/2020,08045604,INSTITUT ENRIC BORRÀS,08015,080155,BADALONA,47,24,71
2019/2020,08045598,ESCOLA MIL·LENARI,08046,080462,CARDEDEU,27,2,29
2019/2020,08045586,ESCOLA LES PRUNERES,08115,081154,MARTORELLES,14,0,14
2019/2020,08045574,ESCOLA SERRA DE MARINA,08245,082457,SANTA COLOMA DE GRAMENET,23,8,31
2019/2020,08045562,INSTITUT CAN PLANAS,08252,082520,BARBERÀ DEL VALLÈS,36,22,58
2019/2020,08045549,INSTITUT BANÚS,08266,082665,CERDANYOLA DEL VALLÈS,33,21,54
2019/2020,08045537,INSTITUT JOSEP LLUÍS SERT,08056,080569,CASTELLDEFELS,41,21,62
2019/2020,08045525,INSTITUT MANUEL CARRASCO I FORMIGUERA,08019,080193,BARCELONA,25,10,35
2019/2020,08045513,INSTITUT FLOS I CALCAT,08019,080193,BARCELONA,24,11,35
2019/2020,08045483,INSTITUT VILA DE GRÀCIA,08019,080193,BARCELONA,23,10,33
2019/2020,08045471,INSTITUT POMPEU FABRA,08015,080155,BADALONA,33,59,92
2019/2020,08045306,INSTITUT RAMON CASAS I CARBÓ,08156,081568,PALAU-SOLITÀ I PLEGAMANS,42,26,68
2019/2020,08045227,CEE LES AIGÜES,08121,081213,MATARÓ,43,2,45
2019/2020,08045203,INSTITUT OBERT DE CATALUNYA,08019,080193,BARCELONA,73,58,131
2019/2020,08045070,INSTITUT EUROPA,08101,081017,L'HOSPITALET DE LLOBREGAT,23,11,34
2019/2020,08045057,ESCOLA EL SAGRER,08019,080193,BARCELONA,28,2,30
2019/2020,08045045,ESCOLA MEDITERRÀNIA,08163,081635,PINEDA DE MAR,16,2,18
2019/2020,08045033,ESCOLA MONTPALAU,08163,081635,PINEDA DE MAR,12,4,16
2019/2020,08045021,INSTITUT ESTELA IBÈRICA,08260,082606,SANTA PERPÈTUA DE MOGODA,44,26,70
2019/2020,08045011,INSTITUT TORRE DEL PALAU,08279,082798,TERRASSA,44,23,67
2019/2020,08044995,INSTITUT BARRES I ONES,08015,080155,BADALONA,40,21,61
2019/2020,08044983,INSTITUT LLUÍS COMPANYS,08284,082845,TORDERA,29,22,51
2019/2020,08044971,INSTITUT PERE FONTDEVILA,08092,080924,GIRONELLA,21,13,34
2019/2020,08044961,ESCRBC DE CATALUNYA,08019,080193,BARCELONA,15,8,23
2019/2020,08044958,INSTITUT JOSEP PLA,08019,080193,BARCELONA,27,18,45
2019/2020,08044934,INSTITUT ESCOLA D'HOTELERIA I TURISME DE BARCELONA,08019,080193,BARCELONA,53,34,87
2019/2020,08044922,INSTITUT DR. PUIGVERT,08019,080193,BARCELONA,37,27,64
2019/2020,08044910,ESCOLA EL TURONET,08238,082384,SANT QUIRZE DEL VALLÈS,15,1,16
2019/2020,08044715,INSTITUT JAUME MIMÓ,08266,082665,CERDANYOLA DEL VALLÈS,47,30,77
2019/2020,08044648,ESCOLA LA RODA,08279,082798,TERRASSA,27,3,30
2019/2020,08044636,EOI DE SABADELL,08187,081878,SABADELL,17,7,24
2019/2020,08044624,INSTITUT SABADELL,08187,081878,SABADELL,45,34,79
2019/2020,08044612,INSTITUT TORRE DE MALLA,08159,081593,PARETS DEL VALLÈS,40,32,72
2019/2020,08044600,INSTITUT MOIANÈS,08138,081385,MOIÀ,22,22,44
2019/2020,08044594,INSTITUT GIOLA,08106,081069,LLINARS DEL VALLÈS,38,21,59
2019/2020,08044582,EOI DE L'HOSPITALET DE LLOBREGAT,08101,081017,L'HOSPITALET DE LLOBREGAT,20,7,27
2019/2020,08044570,INSTITUT VALL D'ARÚS,08295,082956,VALLIRANA,46,23,69
2019/2020,08044569,INSTITUT PERE BARNILS,08067,080673,CENTELLES,36,20,56
2019/2020,08044545,ESCOLA COLLBAIX,08218,082188,SANT JOAN DE VILATORRADA,12,3,15
2019/2020,08044533,INSTITUT LA FERRERIA,08125,081252,MONTCADA I REIXAC,56,38,94
2019/2020,08044521,ESCOLA ELS PINETONS,08088,080885,LA GARRIGA,26,3,29
2019/2020,08044511,EOI BARCELONA-VALL D'HEBRON,08019,080193,BARCELONA,33,6,39
2019/2020,08044508,ESCOLA ÍTACA,08015,080155,BADALONA,19,1,20
2019/2020,08044454,ESCOLA PILARÍN BAYÉS,08238,082384,SANT QUIRZE DEL VALLÈS,28,2,30
2019/2020,08044442,ESCOLA SANTA ANNA,08230,082303,PREMIÀ DE DALT,28,1,29
2019/2020,08044430,ESCOLA LA GARALDA,08157,081574,PALLEJÀ,29,2,31
2019/2020,08044314,ESCOLA ANDREU CASTELLS,08187,081878,SABADELL,27,4,31
2019/2020,08044302,ESCOLA JOAN ABELLÓ,08124,081249,MOLLET DEL VALLÈS,30,1,31
2019/2020,08044296,ESCOLA SALVADOR ESPRIU,08015,080155,BADALONA,24,4,28
2019/2020,08044247,ESCOLA ESTEL,08123,081234,MOLINS DE REI,15,0,15
2019/2020,08044223,CEE L'ESTEL- CAN BORI,08101,081017,L'HOSPITALET DE LLOBREGAT,24,6,30
2019/2020,08044201,ESCOLA DOVELLA,08019,080193,BARCELONA,15,0,15
2019/2020,08044168,INSTITUT PLA DE LES MORERES,08302,083020,VILANOVA DEL CAMÍ,42,21,63
2019/2020,08044156,EA DEIÀ,08019,080193,BARCELONA,20,21,41
2019/2020,08044120,CFA FREIRE,08019,080193,BARCELONA,6,5,11
2019/2020,08044077,EA JOSEP SERRA I ABELLA,08101,081017,L'HOSPITALET DE LLOBREGAT,29,14,43
2019/2020,08044065,INSTITUT GALILEO GALILEI,08019,080193,BARCELONA,30,18,48
2019/2020,08044053,INSTITUT SALVADOR SEGUÍ,08019,080193,BARCELONA,96,27,123
2019/2020,08044028,CEE HORITZÓ,08163,081635,PINEDA DE MAR,21,6,27
2019/2020,08044016,ESCOLA FLAMA,08213,082135,SANT FRUITÓS DE BAGES,28,2,30
2019/2020,08043981,INSTITUT JOAN RAMON BENAPRÈS,08270,082704,SITGES,44,39,83
2019/2020,08043978,INSTITUT DANIEL BLANXART I PEDRALS,08147,081477,OLESA DE MONTSERRAT,47,43,90
2019/2020,08043966,ESCOLA HEURA,08019,080193,BARCELONA,14,1,15
2019/2020,08043954,ESCOLA RIBATALLADA,08187,081878,SABADELL,12,3,15
2019/2020,08043942,ESCOLA MONTBUI,08033,080333,CALDES DE MONTBUI,27,2,29
2019/2020,08043930,ESCOLA MARINADA,08118,081189,EL MASNOU,12,3,15
2019/2020,08043929,ESCOLA LLEBETX,08307,083073,VILANOVA I LA GELTRÚ,17,4,21
2019/2020,08043917,ESCOLA COSSETÀNIA,08307,083073,VILANOVA I LA GELTRÚ,12,3,15
2019/2020,08043905,ESCOLA EL DOFÍ,08172,081727,PREMIÀ DE MAR,13,2,15
2019/2020,08043899,ESCOLA TÀBER,08019,080193,BARCELONA,30,1,31
2019/2020,08043887,ESCOLA SAGRADA FAMÍLIA,08019,080193,BARCELONA,26,3,29
2019/2020,08043875,ESCOLA PIT-ROIG,08019,080193,BARCELONA,13,2,15
2019/2020,08043863,ESCOLA ORLANDAI,08019,080193,BARCELONA,14,1,15
2019/2020,08043851,ESCOLA NABÍ,08019,080193,BARCELONA,13,2,15
2019/2020,08043841,ESCOLA LAVÍNIA,08019,080193,BARCELONA,13,2,15
2019/2020,08043838,ESCOLA TURÓ DEL CARGOL,08019,080193,BARCELONA,16,0,16
2019/2020,08043814,ESCOLA CARLIT,08019,080193,BARCELONA,14,3,17
2019/2020,08043796,ESCOLA BARRUFET,08019,080193,BARCELONA,24,5,29
2019/2020,08043784,ESCOLA ÀNGELS GARRIGA,08019,080193,BARCELONA,11,4,15
2019/2020,08043760,ESCOLA COLÒNIA GÜELL,08244,082444,SANTA COLOMA DE CERVELLÓ,30,4,34
2019/2020,08043747,ESCOLA BALOO,08019,080193,BARCELONA,10,5,15
2019/2020,08043693,INSTITUT JOAQUIM MIR,08307,083073,VILANOVA I LA GELTRÚ,57,44,101
2019/2020,08043681,INSTITUT MARIANAO,08200,082009,SANT BOI DE LLOBREGAT,47,40,87
2019/2020,08043671,INSTITUT EL PALAU,08196,081960,SANT ANDREU DE LA BARCA,52,49,101
2019/2020,08043668,INSTITUT L'ESTATUT,08184,081846,RUBÍ,43,25,68
2019/2020,08043656,INSTITUT MARINA,08105,081056,LA LLAGOSTA,42,39,81
2019/2020,08043644,INSTITUT CARLES VALLBONA,08096,080961,GRANOLLERS,48,42,90
2019/2020,08043589,INSTITUT SALVADOR DALÍ,08169,081691,EL PRAT DE LLOBREGAT,43,18,61
2019/2020,08043516,INSTITUT SANTA EULÀLIA,08279,082798,TERRASSA,44,56,100
2019/2020,08043504,INSTITUT PERE CALDERS,08266,082665,CERDANYOLA DEL VALLÈS,27,13,40
2019/2020,08043486,INSTITUT MANOLO HUGUÉ,08033,080333,CALDES DE MONTBUI,35,30,65
2019/2020,08043474,ESCOLA L'ESTEL,08019,080193,BARCELONA,14,2,16
2019/2020,08043462,INSTITUT ERNEST LLUCH,08019,080193,BARCELONA,42,19,61
2019/2020,08043437,ESCOLA FONT DE L'ALBA,08279,082798,TERRASSA,23,5,28
2019/2020,08043401,ESCOLA BARRUFET,08200,082009,SANT BOI DE LLOBREGAT,19,4,23
2019/2020,08043395,INSTITUT ALEXANDRE DE RIQUER,08031,080312,CALAF,19,15,34
2019/2020,08043383,ESCOLA NOSTRA LLAR,08187,081878,SABADELL,28,2,30
2019/2020,08043371,ESCOLA LA LIÓ,08172,081727,PREMIÀ DE MAR,13,2,15
2019/2020,08043361,ESCOLA EL TURÓ,08125,081252,MONTCADA I REIXAC,14,3,17
2019/2020,08043346,ESCOLA MONTSERRAT,08076,080765,ESPARREGUERA,14,2,16
2019/2020,08043334,ESCOLA ALEXANDRE GALÍ,08073,080734,CORNELLÀ DE LLOBREGAT,13,3,16
2019/2020,08043310,ESCOLA EDUMAR,08056,080569,CASTELLDEFELS,25,6,31
2019/2020,08043292,ESCOLA TABOR,08019,080193,BARCELONA,25,6,31
2019/2020,08043279,ESCOLA POMPEU FABRA,08019,080193,BARCELONA,11,5,16
2019/2020,08043267,ESCOLA PAU CASALS-GRÀCIA,08019,080193,BARCELONA,25,4,29
2019/2020,08043255,ESCOLA ÍTACA,08019,080193,BARCELONA,25,4,29
2019/2020,08043115,ESCOLA PROVENÇALS,08019,080193,BARCELONA,24,6,30
2019/2020,08043103,ESCOLA ANTONI BALMANYA,08019,080193,BARCELONA,25,4,29
2019/2020,08042895,ESCOLA SCHOLA,08184,081846,RUBÍ,15,0,15
2019/2020,08042883,ESCOLA SANT JOSEP - EL PI,08101,081017,L'HOSPITALET DE LLOBREGAT,11,4,15
2019/2020,08042871,ESCOLA PATUFET SANT JORDI-FRANCESC BATALLÉ I ARA,08101,081017,L'HOSPITALET DE LLOBREGAT,28,2,30
2019/2020,08042861,ESCOLA LOLA ANGLADA,08077,080771,ESPLUGUES DE LLOBREGAT,12,3,15
2019/2020,08042858,CFA ELS TARONGERS,08121,081213,MATARÓ,7,4,11
2019/2020,08042846,CFA CORNELLÀ DE LLOBREGAT,08073,080734,CORNELLÀ DE LLOBREGAT,13,1,14
2019/2020,08042834,ESCOLA CAN PALMER,08301,083015,VILADECANS,23,3,26
2019/2020,08042810,ESCOLA CHARLES DARWIN,08169,081691,EL PRAT DE LLOBREGAT,28,4,32
2019/2020,08042809,ESCOLA GALILEO GALILEI,08169,081691,EL PRAT DE LLOBREGAT,26,3,29
2019/2020,08042792,ESCOLA DAMIÀ MATEU,08106,081069,LLINARS DEL VALLÈS,16,1,17
2019/2020,08042780,ESCOLA JOSEP MARIA JUJOL,08019,080193,BARCELONA,26,6,32
2019/2020,08042342,INSTITUT DE BADIA DEL VALLÈS,08904,089045,BADIA DEL VALLÈS,39,36,75
2019/2020,08042330,INSTITUT SANT RAMON,08047,080478,CARDONA,10,8,18
2019/2020,08042329,ESCOLA ELS XIPRERS,08019,080193,BARCELONA,10,5,15
2019/2020,08042305,ESCOLA JOAN MIRÓ,08019,080193,BARCELONA,27,3,30
2019/2020,08042299,ESCOLA SANT MIQUEL,08073,080734,CORNELLÀ DE LLOBREGAT,25,4,29
2019/2020,08042287,ESCOLA SALVADOR ESPRIU,08096,080961,GRANOLLERS,28,3,31
2019/2020,08042101,INSTITUT MANUEL VÁZQUEZ MONTALBÁN,08194,081944,SANT ADRIÀ DE BESÒS,38,18,56
2019/2020,08042093,INSTITUT VINYES VELLES,08136,081363,MONTORNÈS DEL VALLÈS,37,19,56
2019/2020,08042056,INSTITUT CAN PUIG,08231,082310,SANT PERE DE RIBES,38,30,68
2019/2020,08042044,INSTITUT MIG-MÓN,08274,082747,SÚRIA,30,18,48
2019/2020,08042020,INSTITUT VALLÈS,08187,081878,SABADELL,35,21,56
2019/2020,08042019,INSTITUT BADALONA VII,08015,080155,BADALONA,36,32,68
2019/2020,08041866,INSTITUT EL CALAMOT,08089,080898,GAVÀ,58,48,106
2019/2020,08041751,ESCOLA LA CAIXA,08019,080193,BARCELONA,20,4,24
2019/2020,08041726,ESCOLA ROC BLANC,08300,083008,VILADECAVALLS,19,2,21
2019/2020,08041714,ESCOLA LES BASSEROLES,08269,082690,SEVA,13,2,15
2019/2020,08041696,ESCOLA VAIXELL BURRIAC,08219,082191,VILASSAR DE MAR,26,3,29
2019/2020,08041684,ESCOLA ESPAI 3,08217,082172,SANT JOAN DESPÍ,29,0,29
2019/2020,08041672,ESCOLA CREU ALTA,08187,081878,SABADELL,12,3,15
2019/2020,08041660,ESCOLA PONT DE LA CADENA,08123,081234,MOLINS DE REI,14,2,16
2019/2020,08041659,ESCOLA MESTRES MONTAÑA,08096,080961,GRANOLLERS,25,4,29
2019/2020,08041647,ESCOLA PONENT,08096,080961,GRANOLLERS,28,7,35
2019/2020,08041611,ESCOLA JOANOT ALISANDA,08187,081878,SABADELL,29,1,30
2019/2020,08041601,ESCOLA TORRE DE LA LLEBRE,08184,081846,RUBÍ,14,2,16
2019/2020,08041581,ESCOLA GITANJALI,08015,080155,BADALONA,14,1,15
2019/2020,08041571,ESCOLA ARTUR MARTORELL,08015,080155,BADALONA,16,1,17
2019/2020,08041568,ESCOLA JUNGFRAU,08015,080155,BADALONA,25,6,31
2019/2020,08041556,ESCOLA MONTSENY,08221,082212,SANT JUST DESVERN,17,0,17
2019/2020,08041519,INSTITUT MARTÍ DOT,08211,082114,SANT FELIU DE LLOBREGAT,50,40,90
2019/2020,08041374,INSTITUT LA MALLOLA,08077,080771,ESPLUGUES DE LLOBREGAT,27,16,43
2019/2020,08041246,ESCOLA FRANCESC ALDEA I PÉREZ,08279,082798,TERRASSA,14,1,15
2019/2020,08041234,ESCOLA COLLSEROLA,08205,082055,SANT CUGAT DEL VALLÈS,27,2,29
2019/2020,08041222,ESCOLA CAN CLADELLAS,08156,081568,PALAU-SOLITÀ I PLEGAMANS,27,1,28
2019/2020,08041210,ESCOLA DEL BOSC,08252,082520,BARBERÀ DEL VALLÈS,29,1,30
2019/2020,08041180,ESCOLA ROSSELLÓ PÒRCEL,08245,082457,SANTA COLOMA DE GRAMENET,15,1,16
2019/2020,08041179,ESCOLA MESTRE ENRIC GIBERT I CAMINS,08019,080193,BARCELONA,30,3,33
2019/2020,08041167,ESCOLA JOSEP CARNER,08015,080155,BADALONA,31,3,34
2019/2020,08041131,ESCOLA SANT ANTONI,08263,082634,SANT VICENÇ DELS HORTS,16,1,17
2019/2020,08040849,INSTITUT FORT PIUS,08019,080193,BARCELONA,31,14,45
2019/2020,08040618,ESCOLA CAN VIDALET,08077,080771,ESPLUGUES DE LLOBREGAT,12,4,16
2019/2020,08040564,INSTITUT JAUME ALMERA,08214,082140,VILASSAR DE DALT,29,14,43
2019/2020,08040552,INSTITUT ANTONI POUS I ARGILA,08112,081120,MANLLEU,53,23,76
2019/2020,08040540,INSTITUT EL CAIRAT,08076,080765,ESPARREGUERA,45,20,65
2019/2020,08040539,INSTITUT LES MARINES,08056,080569,CASTELLDEFELS,39,11,50
2019/2020,08040527,INSTITUT LA LLAUNA,08015,080155,BADALONA,28,25,53
2019/2020,08040412,ESCOLA EL MARGALLÓ,08307,083073,VILANOVA I LA GELTRÚ,17,5,22
2019/2020,08040400,ESCOLA AMADEU VIVES,08187,081878,SABADELL,24,7,31
2019/2020,08040382,ESCOLA MERCÈ RODOREDA,08245,082457,SANTA COLOMA DE GRAMENET,31,6,37
2019/2020,08040357,CEE FOLCH I CAMARASA,08019,080193,BARCELONA,8,0,8
2019/2020,08040345,ESCOLA MERCÈ RODOREDA,08015,080155,BADALONA,14,1,15
2019/2020,08040333,ESCOLA BERNAT METGE,08169,081691,EL PRAT DE LLOBREGAT,15,1,16
2019/2020,08040141,INSTITUT ICÀRIA,08019,080193,BARCELONA,39,22,61
2019/2020,08040138,INSTITUT LA SEDETA,08019,080193,BARCELONA,21,14,35
2019/2020,08040060,ESCOLA DEL MAR,08219,082191,VILASSAR DE MAR,28,4,32
2019/2020,08040059,ESCOLA JOAN SALVAT I PAPASSEIT,08245,082457,SANTA COLOMA DE GRAMENET,30,2,32
2019/2020,08040047,CEE JOSEP SOL I RODRÍGUEZ,08245,082457,SANTA COLOMA DE GRAMENET,30,6,36
2019/2020,08039896,ESCOLA BELLATERRA,08266,082665,CERDANYOLA DEL VALLÈS,30,1,31
2019/2020,08039835,ESCOLA DE LES AIGÜES,08019,080193,BARCELONA,26,6,32
2019/2020,08039744,ESCOLA DEL PONT TRENCAT - ZER BAIX MONTSENY,08259,082592,SANTA MARIA DE PALAUTORDERA,6,0,6
2019/2020,08039719,ESCOLA LES PLANES,08105,081056,LA LLAGOSTA,25,4,29
2019/2020,08039707,ESCOLA TAGAMANENT,08088,080885,LA GARRIGA,12,3,15
2019/2020,08039690,ESCOLA GERMANS CORBELLA,08046,080462,CARDEDEU,24,3,27
2019/2020,08039677,ESCOLA CONGOST,08041,080410,CANOVELLES,32,7,39
2019/2020,08039665,ESCOLA LANASPA-GIRALT,08279,082798,TERRASSA,15,2,17
2019/2020,08039653,ESCOLA AGUSTÍ BARTRA,08279,082798,TERRASSA,29,5,34
2019/2020,08039641,ESCOLA PABLO PICASSO,08252,082520,BARBERÀ DEL VALLÈS,25,2,27
2019/2020,08039631,ESCOLA L'AGULLOLA,08901,089019,RUPIT I PRUIT,5,0,5
2019/2020,08039628,ESCOLA POMPEU FABRA,08112,081120,MANLLEU,34,4,38
2019/2020,08039616,ESCOLA CAMÍ DEL CROS,08121,081213,MATARÓ,28,2,30
2019/2020,08039604,ESCOLA FRANCESC FERRER I GUÀRDIA,08118,081189,EL MASNOU,13,3,16
2019/2020,08039598,ESCOLA SANT MIQUEL DEL CROS,08009,080095,ARGENTONA,14,2,16
2019/2020,08039586,ESCOLA L'ARJAU,08307,083073,VILANOVA I LA GELTRÚ,27,4,31
2019/2020,08039574,ESCOLA PAU SANS,08101,081017,L'HOSPITALET DE LLOBREGAT,13,2,15
2019/2020,08039562,ESCOLA PRAT DE LA MANTA,08101,081017,L'HOSPITALET DE LLOBREGAT,15,2,17
2019/2020,08039537,ESCOLA TORRENT D'EN MELIS,08019,080193,BARCELONA,23,6,29
2019/2020,08039525,ESCOLA LA SEDETA,08019,080193,BARCELONA,10,5,15
2019/2020,08039513,ESCOLA TAXONERA,08019,080193,BARCELONA,30,6,36
2019/2020,08039495,ESCOLA LA PALMERA,08019,080193,BARCELONA,23,6,29
2019/2020,08039483,ESCOLA ELS HORTS,08019,080193,BARCELONA,17,0,17
2019/2020,08039471,ESCOLA MERCÈ RODOREDA,08019,080193,BARCELONA,25,4,29
2019/2020,08039434,ESCOLA DOCTOR FERRAN I CLUA,08019,080193,BARCELONA,28,4,32
2019/2020,08039380,ESCOLA GERMANS AMAT I TARGA,08301,083015,VILADECANS,27,3,30
2019/2020,08039379,ESCOLA RAFAEL CASANOVA,08200,082009,SANT BOI DE LLOBREGAT,22,8,30
2019/2020,08039367,ESCOLA JOSEP PLA,08196,081960,SANT ANDREU DE LA BARCA,26,3,29
2019/2020,08039355,ESCOLA RAMON LLULL,08169,081691,EL PRAT DE LLOBREGAT,26,3,29
2019/2020,08039343,ESCOLA JOSEP FERRÀ I ESTEVA,08147,081477,OLESA DE MONTSERRAT,26,4,30
2019/2020,08039318,ESCOLA PUIGBERENGUER,08113,081136,MANRESA,27,3,30
2019/2020,08039306,ESCOLA ELS PINS - ZER MOIANÈS PONENT,08191,081918,SALLENT,4,1,5
2019/2020,08039291,ESCOLA CRISTÒFOR MESTRE,08305,083054,VILAFRANCA DEL PENEDÈS,23,8,31
2019/2020,08039288,ESCOLA RENAIXENÇA,08122,081228,MEDIONA,4,4,8
2019/2020,08039264,ESCOLA MESTRES MUNGUET-CORTÉS,08902,089024,VILANOVA DEL VALLÈS,27,1,28
2019/2020,08039203,INSTITUT AGUSTÍ SERRA I FONTANET,08187,081878,SABADELL,68,52,120
2019/2020,08039069,INSTITUT MARGARIDA XIRGU,08101,081017,L'HOSPITALET DE LLOBREGAT,41,14,55
2019/2020,08039057,INSTITUT L'ALZINA,08019,080193,BARCELONA,32,14,46
2019/2020,08038582,ESCOLA CATALUNYA,08187,081878,SABADELL,31,1,32
2019/2020,08038570,EOI DE BARCELONA,08019,080193,BARCELONA,78,21,99
2019/2020,08038351,ESCOLA XARAU,08266,082665,CERDANYOLA DEL VALLÈS,15,4,19
2019/2020,08038326,ESCOLA EL VALLÈS,08279,082798,TERRASSA,24,2,26
2019/2020,08038314,ESCOLA MARE DE DÉU DE MONTSERRAT,08279,082798,TERRASSA,18,1,19
2019/2020,08038284,ESCOLA LA GUÀRDIA,08263,082634,SANT VICENÇ DELS HORTS,15,2,17
2019/2020,08038272,ESCOLA GARCÍA LORCA,08250,082508,SANTA MARGARIDA DE MONTBUI,28,5,33
2019/2020,08038260,ESCOLA JOAN MARAGALL,08205,082055,SANT CUGAT DEL VALLÈS,26,3,29
2019/2020,08038259,ESCOLA ANTONI TÀPIES,08200,082009,SANT BOI DE LLOBREGAT,25,3,28
2019/2020,08038247,ESCOLA POMPEU FABRA,08302,083020,VILANOVA DEL CAMÍ,21,4,25
2019/2020,08038223,ESCOLA BENVIURE,08200,082009,SANT BOI DE LLOBREGAT,23,6,29
2019/2020,08038211,ESCOLA JOSÉ JUAN ORTIZ,08196,081960,SANT ANDREU DE LA BARCA,23,8,31
2019/2020,08038201,ESCOLA LA BAUMETA - ZER ELS CASTELLS,08253,082536,SANTA MARIA DE BESORA,2,0,2
2019/2020,08038181,ESCOLA SERRA I HÚNTER,08113,081136,MANRESA,29,7,36
2019/2020,08038171,ESCOLA MONTESSORI,08184,081846,RUBÍ,26,5,31
2019/2020,08038168,ESCOLA LA TORRETA,08181,081810,LA ROCA DEL VALLÈS,14,3,17
2019/2020,08038156,ESCOLA ESCURSELL I BARTALOT,08180,081803,RIPOLLET,28,2,30
2019/2020,08038090,ESCOLA SANT JAUME,08169,081691,EL PRAT DE LLOBREGAT,26,5,31
2019/2020,08038089,ESCOLA SANT ESTEVE - ZER EL CARDENER,08229,082299,SANT MATEU DE BAGES,4,1,5
2019/2020,08038077,ESCOLA CAN PARERA,08136,081363,MONTORNÈS DEL VALLÈS,24,3,27
2019/2020,08038065,ESCOLA MONTSENY,08124,081249,MOLLET DEL VALLÈS,25,3,28
2019/2020,08038041,ESCOLA FEDERICO GARCÍA LORCA,08124,081249,MOLLET DEL VALLÈS,7,4,11
2019/2020,08038031,ESCOLA ROSA SENSAT,08118,081189,EL MASNOU,13,3,16
2019/2020,08038004,ESCOLA JOSEP JANÉS,08101,081017,L'HOSPITALET DE LLOBREGAT,27,6,33
2019/2020,08037991,ESCOLA MARCEL·LÍ MORAGAS,08089,080898,GAVÀ,25,3,28
2019/2020,08037981,ESCOLA DE L'ESTANY - ZER EL MOIANÈS LLEVANT,08079,080790,L'ESTANY,2,3,5
2019/2020,08037978,ESCOLA SURIS,08073,080734,CORNELLÀ DE LLOBREGAT,28,4,32
2019/2020,08037966,ESCOLA IGNASI IGLÉSIAS,08073,080734,CORNELLÀ DE LLOBREGAT,28,2,30
2019/2020,08037930,ESCOLA MARGALLÓ,08056,080569,CASTELLDEFELS,25,3,28
2019/2020,08037929,ESCOLA TORRE BARONA,08056,080569,CASTELLDEFELS,24,6,30
2019/2020,08037917,ESCOLA JOAN MIRÓ,08041,080410,CANOVELLES,13,4,17
2019/2020,08037899,ESCOLA FOLCH I TORRES,08015,080155,BADALONA,16,4,20
2019/2020,08037887,ESCOLA BALDIRI REIXAC,08015,080155,BADALONA,17,8,25
2019/2020,08037875,ESCOLA RAFAEL CASANOVA,08015,080155,BADALONA,29,3,32
2019/2020,08037863,ESCOLA SEAT,08019,080193,BARCELONA,28,1,29
2019/2020,08037841,ESCOLA SPLAI,08019,080193,BARCELONA,14,1,15
2019/2020,08037814,ESCOLA ALEXANDRE GALÍ,08019,080193,BARCELONA,23,2,25
2019/2020,08037802,ESCOLA LES CORTS,08019,080193,BARCELONA,28,2,30
2019/2020,08037528,ESCOLA SANT DOMÈNEC,08251,082515,SANTA MARGARIDA I ELS MONJOS,15,1,16
2019/2020,08037504,ESCOLA MONTNEGRE,08202,082021,SANT CELONI,12,2,14
2019/2020,08037292,CEE CENTRE DE FORMACIÓ I TREBALL FLOR DE MAIG,08266,082665,CERDANYOLA DEL VALLÈS,15,7,22
2019/2020,08037206,INSTITUT LLUÍS COMPANYS,08180,081803,RIPOLLET,42,27,69
2019/2020,08037176,INSTITUT LA BASTIDA,08245,082457,SANTA COLOMA DE GRAMENET,55,31,86
2019/2020,08037152,INSTITUT JOAN ORÓ,08114,081141,MARTORELL,73,49,122
2019/2020,08036411,ESCOLA SALTELLS,08266,082665,CERDANYOLA DEL VALLÈS,23,4,27
2019/2020,08036391,INSTITUT ARQUITECTE MANUEL RASPALL,08046,080462,CARDEDEU,38,14,52
2019/2020,08036378,ESCOLA CHARLIE RIVEL,08101,081017,L'HOSPITALET DE LLOBREGAT,15,5,20
2019/2020,08036366,ESCOLA LOLA ANGLADA,08101,081017,L'HOSPITALET DE LLOBREGAT,18,3,21
2019/2020,08036342,ESCOLA JOAN LLONGUERAS,08015,080155,BADALONA,15,3,18
2019/2020,08036330,INSTITUT J.V. FOIX,08184,081846,RUBÍ,26,22,48
2019/2020,08036147,ESCOLA PAU PICASSO,08015,080155,BADALONA,19,8,27
2019/2020,08036135,ESCOLA JOAN CORET,08015,080155,BADALONA,24,5,29
2019/2020,08036111,ESCOLA MAS I PERERA,08305,083054,VILAFRANCA DEL PENEDÈS,26,5,31
2019/2020,08036101,ESCOLA SAGRADA FAMÍLIA,08245,082457,SANTA COLOMA DE GRAMENET,26,2,28
2019/2020,08036056,ESCOLA FOLCH I TORRES,08077,080771,ESPLUGUES DE LLOBREGAT,28,2,30
2019/2020,08036044,ESCOLA PAU VILA,08076,080765,ESPARREGUERA,23,6,29
2019/2020,08036007,ESCOLA PAU VILA,08211,082114,SANT FELIU DE LLOBREGAT,17,2,19
2019/2020,08035994,ESCOLA SALVADOR ESPRIU,08211,082114,SANT FELIU DE LLOBREGAT,23,5,28
2019/2020,08035969,ESCOLA JOAQUIM BLUME,08187,081878,SABADELL,23,3,26
2019/2020,08035957,ESCOLA CAN DEU,08187,081878,SABADELL,12,4,16
2019/2020,08035945,ESCOLA LA CARPA,08101,081017,L'HOSPITALET DE LLOBREGAT,44,4,48
2019/2020,08035881,ESCOLA L'ARENY,08073,080734,CORNELLÀ DE LLOBREGAT,27,3,30
2019/2020,08035878,ESCOLA PERE DE TERA,08015,080155,BADALONA,24,5,29
2019/2020,08035854,ESCOLA LLORENS I ARTIGAS,08015,080155,BADALONA,27,1,28
2019/2020,08035696,ESCOLA SANT JULIÀ,08187,081878,SABADELL,20,3,23
2019/2020,08035684,ESCOLA MARIÀ MANENT,08230,082303,PREMIÀ DE DALT,26,4,30
2019/2020,08035623,CEE JERONI DE MORAGAS,08266,082665,CERDANYOLA DEL VALLÈS,17,2,19
2019/2020,08035544,CEE JOSEP PLA,08019,080193,BARCELONA,10,2,12
2019/2020,08035519,ESCOLA ANTONI GAUDÍ,08245,082457,SANTA COLOMA DE GRAMENET,31,5,36
2019/2020,08035477,ESCOLA SANTIAGO RUSIÑOL,08019,080193,BARCELONA,26,4,30
2019/2020,08035465,ESCOLA MARE NOSTRUM,08019,080193,BARCELONA,25,1,26
2019/2020,08035453,ESCOLA TOMÀS MORO,08019,080193,BARCELONA,16,2,18
2019/2020,08035441,ESCOLA CATALÒNIA,08019,080193,BARCELONA,23,6,29
2019/2020,08035431,ESCOLA BOGATELL,08019,080193,BARCELONA,26,2,28
2019/2020,08035428,ESCOLA LA FARIGOLA DEL CLOT,08019,080193,BARCELONA,26,5,31
2019/2020,08035416,ESCOLA JOSEP BOADA,08015,080155,BADALONA,33,4,37
2019/2020,08000013,ESCOLA FRANCESC PLATÓN I SARTÍ,08001,080018,ABRERA,30,6,36
2019/2020,08035404,ESCOLA JOAN MIRÓ,08015,080155,BADALONA,16,3,19
2019/2020,08035398,ESCOLA MIGUEL HERNÁNDEZ,08015,080155,BADALONA,14,5,19
2019/2020,08035362,INSTITUT ALT PENEDÈS,08305,083054,VILAFRANCA DEL PENEDÈS,46,39,85
2019/2020,08035349,INSTITUT LA ROMÀNICA,08252,082520,BARBERÀ DEL VALLÈS,65,29,94
2019/2020,08035325,INSTITUT TORRENT DE LES BRUIXES,08245,082457,SANTA COLOMA DE GRAMENET,32,19,51
2019/2020,08035313,INSTITUT QUERCUS,08218,082188,SANT JOAN DE VILATORRADA,47,23,70
2019/2020,08035301,INSTITUT DUC DE MONTBLANC,08184,081846,RUBÍ,44,25,69
2019/2020,08035295,INSTITUT PALAU AUSIT,08180,081803,RIPOLLET,47,44,91
2019/2020,08035283,ESCOLA REIXAC,08125,081252,MONTCADA I REIXAC,31,1,32
2019/2020,08035258,INSTITUT APEL·LES MESTRES,08101,081017,L'HOSPITALET DE LLOBREGAT,22,20,42
2019/2020,08035246,INSTITUT GELIDA,08091,080919,GELIDA,19,23,42
2019/2020,08035234,INSTITUT VIL·LA ROMANA,08088,080885,LA GARRIGA,35,16,51
2019/2020,08035222,INSTITUT MANUEL BLANCAFORT,08088,080885,LA GARRIGA,33,13,46
2019/2020,08035209,INSTITUT PABLO R. PICASSO,08019,080193,BARCELONA,27,22,49
2019/2020,08035167,INSTITUT BARCELONA-CONGRÉS,08019,080193,BARCELONA,34,15,49
2019/2020,08035155,INSTITUT ELS TRES TURONS,08006,080060,ARENYS DE MAR,47,12,59
2019/2020,08035143,INSTITUT MIQUEL MARTÍ I POL,08073,080734,CORNELLÀ DE LLOBREGAT,65,38,103
2019/2020,08035003,EA DE VIC,08298,082981,VIC,19,25,44
2019/2020,08034990,ESCOLA PARELLADA,08200,082009,SANT BOI DE LLOBREGAT,21,7,28
2019/2020,08034989,ESCOLA CATALUNYA,08194,081944,SANT ADRIÀ DE BESÒS,27,3,30
2019/2020,08034965,ESCOLA MARGARIDA XIRGU,08015,080155,BADALONA,33,1,34
2019/2020,08034953,ESCOLA LLIBERTAT,08015,080155,BADALONA,16,1,17
2019/2020,08034904,ESCOLA EMILI CARLES I TOLRÀ,08051,080517,CASTELLAR DEL VALLÈS,10,5,15
2019/2020,08034862,ESCOLA AUSIÀS MARCH,08101,081017,L'HOSPITALET DE LLOBREGAT,15,4,19
2019/2020,08034850,ESCOLA PAU CASALS,08101,081017,L'HOSPITALET DE LLOBREGAT,30,3,33
2019/2020,08034837,ESCOLA BERNAT DESCLOT,08101,081017,L'HOSPITALET DE LLOBREGAT,14,3,17
2019/2020,08034795,ESCOLA HEUROM - ZER ALT LLUÇANÈS,08160,081607,PERAFITA,3,1,4
2019/2020,08034783,ESCOLA ELVIRA CUYÀS,08125,081252,MONTCADA I REIXAC,26,4,30
2019/2020,08034746,ESCOLA ROCAFONDA,08121,081213,MATARÓ,34,1,35
2019/2020,08034734,ESCOLA CAMÍ DEL MIG,08121,081213,MATARÓ,30,4,34
2019/2020,08034692,ESCOLA CATALUNYA,08205,082055,SANT CUGAT DEL VALLÈS,26,4,30
2019/2020,08034667,ESCOLA ESTEVE BARRACHINA,08270,082704,SITGES,29,3,32
2019/2020,08034643,INSTITUT LES VINYES,08245,082457,SANTA COLOMA DE GRAMENET,56,32,88
2019/2020,08034621,INSTITUT DE SALES,08301,083015,VILADECANS,56,26,82
2019/2020,08034606,INSTITUT BAIX MONTSENY,08202,082021,SANT CELONI,42,35,77
2019/2020,08034591,INSTITUT JOAN OLIVER,08187,081878,SABADELL,34,15,49
2019/2020,08034576,INSTITUT JOAN SALVAT I PAPASSEIT,08019,080193,BARCELONA,16,11,27
2019/2020,08034564,INSTITUT LES CORTS,08019,080193,BARCELONA,43,16,59
2019/2020,08034527,ESCOLA RAMON MUNTANER,08101,081017,L'HOSPITALET DE LLOBREGAT,14,2,16
2019/2020,08034497,ESCOLA L'ARAGAI,08307,083073,VILANOVA I LA GELTRÚ,21,2,23
2019/2020,08034485,ESCOLA JOAN MARQUÈS I CASALS,08279,082798,TERRASSA,28,4,32
2019/2020,08034461,ESCOLA BERNAT DE MOGODA,08260,082606,SANTA PERPÈTUA DE MOGODA,23,4,27
2019/2020,08034448,ESCOLA SANTA EULÀLIA,08231,082310,SANT PERE DE RIBES,23,6,29
2019/2020,08034412,ESCOLA CAN MASSALLERA,08200,082009,SANT BOI DE LLOBREGAT,14,3,17
2019/2020,08034400,ESCOLA ANTONI GAUDÍ,08200,082009,SANT BOI DE LLOBREGAT,18,1,19
2019/2020,08034382,ESCOLA RAMON LLULL,08184,081846,RUBÍ,24,5,29
2019/2020,08034357,ESCOLA VISTA ALEGRE,08121,081213,MATARÓ,13,2,15
2019/2020,08034333,ESCOLA LA LLÀNTIA,08121,081213,MATARÓ,28,4,32
2019/2020,08034321,ESCOLA TORRE LLAUDER,08121,081213,MATARÓ,21,4,25
2019/2020,08034278,ESCOLA VICENTE ALEIXANDRE,08114,081141,MARTORELL,24,3,27
2019/2020,08034266,ESCOLA JOAN MARAGALL,08101,081017,L'HOSPITALET DE LLOBREGAT,15,1,16
2019/2020,08034242,ESCOLA PABLO NERUDA,08101,081017,L'HOSPITALET DE LLOBREGAT,15,3,18
2019/2020,08034229,ESCOLA BONAVISTA,08051,080517,CASTELLAR DEL VALLÈS,13,3,16
2019/2020,08034217,INSTITUT BERNAT EL FERRER,08123,081234,MOLINS DE REI,50,48,98
2019/2020,08034205,INSTITUT LA GUINEUETA,08019,080193,BARCELONA,63,62,125
2019/2020,08034187,INSTITUT DOMÈNEC PERRAMON,08007,080076,ARENYS DE MUNT,24,17,41
2019/2020,08034138,INSTITUT POBLENOU,08019,080193,BARCELONA,30,29,59
2019/2020,08034126,ESCOLA PAU BOADA,08305,083054,VILAFRANCA DEL PENEDÈS,19,6,25
2019/2020,08034102,ESCOLA JOSEP MARIA MADORELL,08123,081234,MOLINS DE REI,20,2,22
2019/2020,08034096,ESCOLA ANTONI GAUDÍ,08056,080569,CASTELLDEFELS,25,5,30
2019/2020,08034084,ESCOLA CAN ROCA,08056,080569,CASTELLDEFELS,26,3,29
2019/2020,08034060,ESCOLA MOSSÈN CINTO VERDAGUER,08184,081846,RUBÍ,25,7,32
2019/2020,08034059,INSTITUT NICOLAU COPÈRNIC,08279,082798,TERRASSA,30,42,72
2019/2020,08034035,INSTITUT FEDERICA MONTSENY,08904,089045,BADIA DEL VALLÈS,27,16,43
2019/2020,08034011,INSTITUT FREDERIC MOMPOU,08263,082634,SANT VICENÇ DELS HORTS,40,15,55
2019/2020,08034001,INSTITUT TERRA ROJA,08245,082457,SANTA COLOMA DE GRAMENET,44,14,58
2019/2020,08033997,ESCOLA PRIMAVERA,08245,082457,SANTA COLOMA DE GRAMENET,15,2,17
2019/2020,08033985,INSTITUT DE SANT JUST DESVERN,08221,082212,SANT JUST DESVERN,34,18,52
2019/2020,08033973,INSTITUT JAUME SALVADOR I PEDROL,08217,082172,SANT JOAN DESPÍ,36,30,66
2019/2020,08033961,INSTITUT RAFAEL CASANOVA,08200,082009,SANT BOI DE LLOBREGAT,45,21,66
2019/2020,08033948,ESCOLA ENRIC TATCHÉ I POL,08180,081803,RIPOLLET,26,6,32
2019/2020,08033924,INSTITUT PIUS FONT I QUER,08113,081136,MANRESA,30,29,59
2019/2020,08033912,INSTITUT MERCÈ RODOREDA,08101,081017,L'HOSPITALET DE LLOBREGAT,35,24,59
2019/2020,08033900,INSTITUT JOAN MIRÓ,08073,080734,CORNELLÀ DE LLOBREGAT,34,14,48
2019/2020,08033894,INSTITUT TERESA PÀMIES,08019,080193,BARCELONA,22,24,46
2019/2020,08033882,INSTITUT JOAN COROMINES,08019,080193,BARCELONA,22,20,42
2019/2020,08033869,INSTITUT PAU CASALS,08015,080155,BADALONA,29,23,52
2019/2020,08033602,ESCOLA CAN SERRA,08252,082520,BARBERÀ DEL VALLÈS,26,3,29
2019/2020,08033560,ESCOLA MÀRIUS TORRES,08101,081017,L'HOSPITALET DE LLOBREGAT,35,5,40
2019/2020,08033535,ESCOLA JOAN MARAGALL,08077,080771,ESPLUGUES DE LLOBREGAT,30,1,31
2019/2020,08033523,ESCOLA LA MUNTANYETA,08019,080193,BARCELONA,12,4,16
2019/2020,08033501,ESCOLA ANTONI BRUSI,08019,080193,BARCELONA,24,6,30
2019/2020,08033468,ESCOLA LA SALUT,08069,080692,COLLBATÓ,19,4,23
2019/2020,08033407,ESCOLA PURIFICACIÓ SALAS I XANDRI,08238,082384,SANT QUIRZE DEL VALLÈS,16,1,17
2019/2020,08033341,ESCOLA BANÚS,08245,082457,SANTA COLOMA DE GRAMENET,13,4,17
2019/2020,08032762,ESCOLA DOCTOR TRUETA,08301,083015,VILADECANS,25,3,28
2019/2020,08032750,ESCOLA PAU CASALS,08301,083015,VILADECANS,29,3,32
2019/2020,08032737,ESCOLA CAN RULL,08187,081878,SABADELL,22,5,27
2019/2020,08032725,ESCOLA HONORABLE JOSEP TARRADELLAS,08169,081691,EL PRAT DE LLOBREGAT,30,4,34
2019/2020,08032713,ESCOLA SANT JORDI,08124,081249,MOLLET DEL VALLÈS,24,4,28
2019/2020,08032701,ESCOLA LLUÍS MILLET,08118,081189,EL MASNOU,29,1,30
2019/2020,08032658,ESCOLA L'ERAMPRUNYÀ,08089,080898,GAVÀ,27,3,30
2019/2020,08032634,ESCOLA FERRER I GUÀRDIA,08019,080193,BARCELONA,31,6,37
2019/2020,08032592,ESCOLA SANT JORDI,08264,082649,SANT VICENÇ DE MONTALT,15,1,16
2019/2020,08032580,ESCOLA CANIGÓ,08221,082212,SANT JUST DESVERN,26,3,29
2019/2020,08032521,ESCOLA VALL DE PALAU,08196,081960,SANT ANDREU DE LA BARCA,29,1,30
2019/2020,08032491,ESCOLA SANT VICENÇ,08124,081249,MOLLET DEL VALLÈS,24,6,30
2019/2020,08032488,ESCOLA PUIG I GAIRALT,08101,081017,L'HOSPITALET DE LLOBREGAT,30,9,39
2019/2020,08032476,ESCOLA PRAT DE LA RIBA,08077,080771,ESPLUGUES DE LLOBREGAT,14,2,16
2019/2020,08032351,ESCOLA PAU CASALS,08184,081846,RUBÍ,28,3,31
2019/2020,08032348,ESCOLA 25 DE SETEMBRE,08184,081846,RUBÍ,39,6,45
2019/2020,08032312,ESCOLA MIGUEL DE UNAMUNO,08245,082457,SANTA COLOMA DE GRAMENET,30,4,34
2019/2020,08032300,ESCOLA FRAY LUIS DE LEÓN,08245,082457,SANTA COLOMA DE GRAMENET,29,3,32
2019/2020,08031873,INSTITUT ARNAU CADELL,08205,082055,SANT CUGAT DEL VALLÈS,33,28,61
2019/2020,08031861,INSTITUT LEONARDO DA VINCI,08205,082055,SANT CUGAT DEL VALLÈS,45,18,63
2019/2020,08031836,INSTITUT ILLA DELS BANYOLS,08169,081691,EL PRAT DE LLOBREGAT,8,44,52
2019/2020,08031812,INSTITUT VALLDEMOSSA,08019,080193,BARCELONA,29,16,45
2019/2020,08031800,ESCOLA PAU CASALS,08019,080193,BARCELONA,13,4,17
2019/2020,08031794,ESCOLA PALMA DE MALLORCA,08019,080193,BARCELONA,20,0,20
2019/2020,08031770,INSTITUT CAN JOFRESA,08279,082798,TERRASSA,36,17,53
2019/2020,08031757,INSTITUT FORAT DEL VENT,08266,082665,CERDANYOLA DEL VALLÈS,40,20,60
2019/2020,08031711,INSTITUT MANUEL DE CABANYES,08307,083073,VILANOVA I LA GELTRÚ,50,27,77
2019/2020,08031681,INSTITUT FRANCESC XAVIER LLUCH I RAFECAS,08307,083073,VILANOVA I LA GELTRÚ,44,43,87
2019/2020,08031666,ESCOLA CANIGÓ,08307,083073,VILANOVA I LA GELTRÚ,24,4,28
2019/2020,08031484,ESCOLA GINESTA,08307,083073,VILANOVA I LA GELTRÚ,26,7,33
2019/2020,08031472,ESCOLA POMPEU FABRA,08307,083073,VILANOVA I LA GELTRÚ,25,4,29
2019/2020,08031460,ESCOLA TRENTAPASSES,08306,083067,VILALBA SASSERRA,13,2,15
2019/2020,08031459,INSTITUT EUGENI D'ORS,08305,083054,VILAFRANCA DEL PENEDÈS,52,47,99
2019/2020,08031332,ESCOLA JOSEP BALTÀ I ELIAS,08305,083054,VILAFRANCA DEL PENEDÈS,27,5,32
2019/2020,08031320,ESCOLA ESTALELLA I GRAELLS,08305,083054,VILAFRANCA DEL PENEDÈS,27,4,31
2019/2020,08031319,ESCOLA LLEBEIG,08304,083041,VILOBÍ DEL PENEDÈS,12,3,15
2019/2020,08031290,ESCOLA LES ROQUES,08303,083036,VILANOVA DE SAU,5,0,5
2019/2020,08031277,ESCOLA JOAN MARAGALL,08302,083020,VILANOVA DEL CAMÍ,32,3,35
2019/2020,08031228,INSTITUT TORRE ROJA,08301,083015,VILADECANS,56,36,92
2019/2020,08031204,ESCOLA EL GARROFER,08301,083015,VILADECANS,26,3,29
2019/2020,08031101,ESCOLA MONTSERRATINA,08301,083015,VILADECANS,24,6,30
2019/2020,08031083,ESCOLA ÀNGELA ROCA,08301,083015,VILADECANS,24,1,25
2019/2020,08031061,ESCOLA ROSELLA,08300,083008,VILADECAVALLS,28,3,31
2019/2020,08031046,ESCOLA SERRA DE PICAMILL - ZER BERGUEDÀ CENTRE,08299,082994,VILADA,3,0,3
2019/2020,08031034,INSTITUT JAUME CALLÍS,08298,082981,VIC,45,17,62
2019/2020,08031022,INSTITUT DE VIC,08298,082981,VIC,73,62,135
2019/2020,08031009,ESCOLA DOCTOR JOAQUIM SALARICH,08298,082981,VIC,32,5,37
2019/2020,08030819,ESCOLA SENTFORES,08298,082981,VIC,15,2,17
2019/2020,08030807,ESCOLA ELS TRES PINS,08296,082969,VALLROMANES,17,2,19
2019/2020,08030789,ESCOLA POMPEU FABRA,08295,082956,VALLIRANA,18,2,20
2019/2020,08030728,ESCOLA SERRAT VOLTOR - ZER ALT BERGUEDÀ,08293,082938,VALLCEBRE,2,0,2
2019/2020,08030698,ESCOLA JOSEP MASCLANS,08292,082922,VALLBONA D'ANOIA,11,4,15
2019/2020,08030686,ESCOLA PAU CASALS,08291,082917,VACARISSES,23,3,26
2019/2020,08030662,ESCOLA SERRALAVELLA,08290,082900,ULLASTRELL,17,5,22
2019/2020,08030649,ESCOLA SANT MARTÍ,08289,082896,TORRELLES DE LLOBREGAT,23,3,26
2019/2020,08030637,ESCOLA GUERAU DE PEGUERA,08288,082883,TORRELLES DE FOIX,13,3,16
2019/2020,08030613,ESCOLA J.J. RÀFOLS,08287,082877,TORRELAVIT,11,3,14
2019/2020,08030595,ESCOLA TORRESCASANA,08286,082861,LA TORRE DE CLARAMUNT,13,2,15
2019/2020,08030583,ESCOLA LA TORRE,08286,082861,LA TORRE DE CLARAMUNT,14,1,15
2019/2020,08030522,ESCOLA VALL DEL GES,08285,082858,TORELLÓ,15,1,16
2019/2020,08030510,ESCOLA DOCTOR FORTIÀ I SOLÀ,08285,082858,TORELLÓ,27,4,31
2019/2020,08030467,ESCOLA IGNASI IGLESIAS,08284,082845,TORDERA,24,6,30
2019/2020,08030421,ESCOLA L'ERA DE DALT,08283,082830,TONA,27,5,32
2019/2020,08030388,ESCOLA LOLA ANGLADA,08282,082824,TIANA,25,4,29
2019/2020,08030364,ESCOLA EL CIM,08281,082819,TEIÀ,23,8,31
2019/2020,08030340,INSTITUT INVESTIGADOR BLANXART,08279,082798,TERRASSA,51,29,80
2019/2020,08030339,INSTITUT DE TERRASSA,08279,082798,TERRASSA,90,52,142
2019/2020,08030315,ESCOLA JOAN XXIII,08279,082798,TERRASSA,26,4,30
2019/2020,08030297,ESCOLA SALVADOR VINYALS I GALÍ,08279,082798,TERRASSA,18,4,22
2019/2020,08030285,ESCOLA AURÓ,08279,082798,TERRASSA,22,5,27
2019/2020,08030248,ESCOLA PAU VILA I DINARÈS,08279,082798,TERRASSA,33,5,38
2019/2020,08030224,ESCOLA ANTONI UBACH I SOLER,08279,082798,TERRASSA,30,3,33
2019/2020,08030212,ESCOLA JOSEP VENTALLÓ I VINTRÓ,08279,082798,TERRASSA,21,2,23
2019/2020,08030200,ESCOLA MARIÀ GALÍ GUIX,08279,082798,TERRASSA,20,4,24
2019/2020,08029507,ESCOLA ISAAC PERAL,08279,082798,TERRASSA,17,0,17
2019/2020,08029386,ESCOLA RAMÓN Y CAJAL,08279,082798,TERRASSA,24,6,30
2019/2020,08029374,ESCOLA BISBAT D'EGARA,08279,082798,TERRASSA,42,3,45
2019/2020,08029350,ESCOLA FRANÇA,08279,082798,TERRASSA,25,6,31
2019/2020,08029301,ESCOLA LES PINEDIQUES,08278,082785,TARADELL,25,4,29
2019/2020,08029283,ESCOLA EL GURRI - ZER GUILLERIES,08278,082785,TARADELL,4,0,4
2019/2020,08029222,ESCOLA FRANCESC MACIÀ,08274,082747,SÚRIA,16,0,16
2019/2020,08029209,ESCOLA MARE DE DÉU DE MONTSERRAT,08274,082747,SÚRIA,11,3,14
2019/2020,08029192,ESCOLA SANT JORDI,08273,082732,SUBIRATS,13,1,14
2019/2020,08029155,ESCOLA EL MONTCAU - ZER SUBIRATS,08273,082732,SUBIRATS,7,1,8
2019/2020,08029143,ESCOLA SUBIRATS - ZER SUBIRATS,08273,082732,SUBIRATS,10,0,10
2019/2020,08029088,ESCOLA MIQUEL UTRILLO,08270,082704,SITGES,22,9,31
2019/2020,08029027,ESCOLA FARIGOLA,08269,082690,SEVA,14,1,15
2019/2020,08029015,ESCOLA SANT SALVADOR,08268,082687,CERCS,8,2,10
2019/2020,08028990,ESCOLA CAN SORTS,08267,082671,SENTMENAT,36,8,44
2019/2020,08028941,ESCOLA LA SARDANA,08904,089045,BADIA DEL VALLÈS,25,3,28
2019/2020,08028928,ESCOLA LA JOTA,08904,089045,BADIA DEL VALLÈS,27,7,34
2019/2020,08028916,ESCOLA LAS SEGUIDILLAS,08904,089045,BADIA DEL VALLÈS,32,3,35
2019/2020,08028904,ESCOLA CARLES BUÏGAS,08266,082665,CERDANYOLA DEL VALLÈS,19,1,20
2019/2020,08028783,ESCOLA SERRAPARERA,08266,082665,CERDANYOLA DEL VALLÈS,25,3,28
2019/2020,08028758,ESCOLA LES FONTETES,08266,082665,CERDANYOLA DEL VALLÈS,10,6,16
2019/2020,08028746,ESCOLA SANT MARTÍ,08266,082665,CERDANYOLA DEL VALLÈS,16,3,19
2019/2020,08028709,ESCOLA LLORIANA,08265,082652,SANT VICENÇ DE TORELLÓ,12,2,14
2019/2020,08028667,ESCOLA JOAN JUNCADELLA,08263,082634,SANT VICENÇ DELS HORTS,27,1,28
2019/2020,08028591,ESCOLA LA VINYALA,08263,082634,SANT VICENÇ DELS HORTS,22,3,25
2019/2020,08028588,ESCOLA SANT JORDI,08263,082634,SANT VICENÇ DELS HORTS,16,1,17
2019/2020,08028576,ESCOLA SANT VICENÇ,08262,082628,SANT VICENÇ DE CASTELLET,29,5,34
2019/2020,08028515,ESCOLA SANTA SUSANNA,08261,082613,SANTA SUSANNA,13,4,17
2019/2020,08028497,ESCOLA SANTA PERPÈTUA,08260,082606,SANTA PERPÈTUA DE MOGODA,21,5,26
2019/2020,08028436,ESCOLA LA FLORIDA,08260,082606,SANTA PERPÈTUA DE MOGODA,26,2,28
2019/2020,08028424,ESCOLA FONTMARTINA,08259,082592,SANTA MARIA DE PALAUTORDERA,24,2,26
2019/2020,08028382,ESCOLA SESMON D'OLÓ,08258,082589,SANTA MARIA D'OLÓ,10,1,11
2019/2020,08028345,ESCOLA LES MIMOSES,08256,082567,SANTA MARIA DE MARTORELLES,11,3,14
2019/2020,08028333,ESCOLA EL CABRERÈS,08254,082541,L'ESQUIROL,14,2,16
2019/2020,08028229,ESCOLA ELISA BADIA,08252,082520,BARBERÀ DEL VALLÈS,26,3,29
2019/2020,08028217,ESCOLA DOCTOR SAMARANCH I FINA,08251,082515,SANTA MARGARIDA I ELS MONJOS,25,3,28
2019/2020,08028163,ESCOLA MONTBOU,08250,082508,SANTA MARGARIDA DE MONTBUI,12,4,16
2019/2020,08028151,ESCOLA LES MORERES - ZER CEP DE SIS,08249,082495,SANTA FE DEL PENEDÈS,5,0,5
2019/2020,08028102,ESCOLA RONÇANA,08248,082482,SANTA EULÀLIA DE RONÇANA,22,1,23
2019/2020,08028072,ESCOLA EL ROURE GROS,08247,082476,SANTA EULÀLIA DE RIUPRIMER,11,3,14
2019/2020,08028059,ESCOLA JACINT VERDAGUER,08246,082460,SANTA EUGÈNIA DE BERGA,13,3,16
2019/2020,08028047,INSTITUT PUIG CASTELLAR,08245,082457,SANTA COLOMA DE GRAMENET,50,35,85
2019/2020,08028035,ESCOLA AUSIÀS MARCH,08245,082457,SANTA COLOMA DE GRAMENET,14,4,18
2019/2020,08027985,ESCOLA JAUME SALVATELLA,08245,082457,SANTA COLOMA DE GRAMENET,27,5,32
2019/2020,08027973,ESCOLA BEETHOVEN,08245,082457,SANTA COLOMA DE GRAMENET,20,2,22
2019/2020,08027936,ESCOLA LLUÍS MILLET,08245,082457,SANTA COLOMA DE GRAMENET,13,3,16
2019/2020,08027870,ESCOLA LES PALMERES,08245,082457,SANTA COLOMA DE GRAMENET,24,5,29
2019/2020,08027511,ESCOLA TORRE BALLDOVINA,08245,082457,SANTA COLOMA DE GRAMENET,26,7,33
2019/2020,08027471,ESCOLA SANT JUST,08245,082457,SANTA COLOMA DE GRAMENET,25,4,29
2019/2020,08027456,ESCOLA FERRAN DE SAGARRA,08245,082457,SANTA COLOMA DE GRAMENET,36,4,40
2019/2020,08027432,ESCOLA WAGNER,08245,082457,SANTA COLOMA DE GRAMENET,17,4,21
2019/2020,08027249,ESCOLA SEGIMON COMAS,08237,082378,SANT QUIRZE DE BESORA,14,2,16
2019/2020,08027225,ESCOLA SANT PAU,08235,082359,SANT POL DE MAR,28,4,32
2019/2020,08027183,ESCOLA TORRE ROJA,08234,082346,SANT PERE DE VILAMAJOR,23,7,30
2019/2020,08027171,ESCOLA JOSEP MARIA XANDRI,08233,082331,SANT PERE DE TORELLÓ,13,3,16
2019/2020,08027146,ESCOLA SANT JERONI,08232,082325,SANT PERE DE RIUDEBITLLES,15,2,17
2019/2020,08027134,ESCOLA LES ROQUETES,08231,082310,SANT PERE DE RIBES,18,6,24
2019/2020,08027110,ESCOLA EL PI,08231,082310,SANT PERE DE RIBES,14,1,15
2019/2020,08027021,ESCOLA FONT DE L'ANOIA - ZER VENT D'AVALL,08228,082286,SANT MARTÍ SESGUEIOLES,3,0,3
2019/2020,08027018,ESCOLA JAUME BALMES,08227,082270,SANT MARTÍ SARROCA,20,4,24
2019/2020,08026956,ESCOLA CÉRVOLA BLANCA,08226,082264,SANT MARTÍ DE TOUS,14,2,16
2019/2020,08026919,ESCOLA JOSEP GRAS,08223,082233,SANT LLORENÇ SAVALL,13,1,14
2019/2020,08026907,ESCOLA PAU CASALS,08222,082227,SANT LLORENÇ D'HORTONS,13,2,15
2019/2020,08026889,ESCOLA VINYES VERDES,08119,081192,MASQUEFA,11,3,14
2019/2020,08026816,ESCOLA MONTSERRAT,08221,082212,SANT JUST DESVERN,24,3,27
2019/2020,08026786,ESCOLA BELLPUIG,08220,082205,SANT JULIÀ DE VILATORTA,14,2,16
2019/2020,08026749,ESCOLA PÉREZ SALA,08219,082191,VILASSAR DE MAR,19,7,26
2019/2020,08026725,ESCOLA JONCADELLA,08218,082188,SANT JOAN DE VILATORRADA,26,2,28
2019/2020,08026683,INSTITUT FRANCESC FERRER I GUÀRDIA,08217,082172,SANT JOAN DESPÍ,56,27,83
2019/2020,08026671,ESCOLA JOAN PERICH I VALLS,08217,082172,SANT JOAN DESPÍ,17,2,19
2019/2020,08026661,ESCOLA PAU CASALS,08217,082172,SANT JOAN DESPÍ,26,2,28
2019/2020,08026567,ESCOLA SANT FRANCESC D'ASSÍS,08217,082172,SANT JOAN DESPÍ,27,3,30
2019/2020,08026521,ESCOLA ABAT OLIBA,08215,082153,SANT HIPÒLIT DE VOLTREGÀ,15,0,15
2019/2020,08026476,ESCOLA FRANCESC MACIÀ,08214,082140,VILASSAR DE DALT,24,7,31
2019/2020,08026464,ESCOLA MONSENYOR GIBERT,08213,082135,SANT FRUITÓS DE BAGES,23,4,27
2019/2020,08026415,ESCOLA ELS ROURES - ZER GAVARRESA,08212,082129,SANT FELIU SASSERRA,6,1,7
2019/2020,08026397,INSTITUT OLORDA,08211,082114,SANT FELIU DE LLOBREGAT,45,16,61
2019/2020,08026385,ESCOLA ARQUITECTE GAUDÍ,08211,082114,SANT FELIU DE LLOBREGAT,17,2,19
2019/2020,08026373,ESCOLA JOSEP MONMANY AMAT,08211,082114,SANT FELIU DE LLOBREGAT,20,4,24
2019/2020,08026221,ESCOLA FALGUERA,08211,082114,SANT FELIU DE LLOBREGAT,12,5,17
2019/2020,08026211,ESCOLA NADAL,08211,082114,SANT FELIU DE LLOBREGAT,26,3,29
2019/2020,08026208,ESCOLA JAUME BALMES,08210,082107,SANT FELIU DE CODINES,20,6,26
2019/2020,08026154,ESCOLA JOAQUIM ABRIL,08209,082093,SANT FOST DE CAMPSENTELLES,25,1,26
2019/2020,08026130,ESCOLA LA ROUREDA,08208,082080,SANT ESTEVE SESROVIRES,24,3,27
2019/2020,08026117,ESCOLA VALLMANYA,08207,082074,SANT ESTEVE DE PALAUTORDERA,27,1,28
2019/2020,08026099,ESCOLA LES VINYES,08206,082068,SANT CUGAT SESGARRIGUES,14,0,14
2019/2020,08026087,ESCOLA JAUME FERRAN I CLUA,08205,082055,SANT CUGAT DEL VALLÈS,27,2,29
2019/2020,08026026,ESCOLA PINS DEL VALLÈS,08205,082055,SANT CUGAT DEL VALLÈS,27,3,30
2019/2020,08025927,ESCOLA PI D'EN XANDRI,08205,082055,SANT CUGAT DEL VALLÈS,25,4,29
2019/2020,08025824,ESCOLA LA FLORESTA,08205,082055,SANT CUGAT DEL VALLÈS,15,2,17
2019/2020,08025812,ESCOLA SANT CLIMENT,08204,082042,SANT CLIMENT DE LLOBREGAT,28,3,31
2019/2020,08025800,ESCOLA EL PI GROS,08203,082037,SANT CEBRIÀ DE VALLALTA,19,3,22
2019/2020,08025666,ESCOLA AURORA - ZER ALT LLUÇANÈS,08201,082016,SANT BOI DE LLUÇANÈS,4,1,5
2019/2020,08025654,INSTITUT JOAQUIM RUBIÓ I ORS,08200,082009,SANT BOI DE LLOBREGAT,36,27,63
2019/2020,08025642,ESCOLA JOSEP MARIA CIURANA,08200,082009,SANT BOI DE LLOBREGAT,29,1,30
2019/2020,08025605,INSTITUT CAMPS BLANCS,08200,082009,SANT BOI DE LLOBREGAT,78,45,123
2019/2020,08025599,ESCOLA MARIANAO,08200,082009,SANT BOI DE LLOBREGAT,16,1,17
2019/2020,08025587,ESCOLA CASABLANCA,08200,082009,SANT BOI DE LLOBREGAT,28,4,32
2019/2020,08025526,ESCOLA CIUTAT COOPERATIVA,08200,082009,SANT BOI DE LLOBREGAT,15,3,18
2019/2020,08025344,ESCOLA AMAT VERDÚ,08200,082009,SANT BOI DE LLOBREGAT,21,3,24
2019/2020,08025320,ESCOLA LA MONJOIA,08199,081995,SANT BARTOMEU DEL GRAU,9,1,10
2019/2020,08025319,ESCOLA JOAN CASAS,08198,081982,SANT ANTONI DE VILAMAJOR,24,3,27
2019/2020,08025265,ESCOLA ÀNGEL GUIMERÀ,08196,081960,SANT ANDREU DE LA BARCA,26,5,31
2019/2020,08025241,ESCOLA JOAN MARAGALL,08196,081960,SANT ANDREU DE LA BARCA,14,2,16
2019/2020,08025083,ESCOLA POMPEU FABRA,08194,081944,SANT ADRIÀ DE BESÒS,26,9,35
2019/2020,08025071,ESCOLA DONES D'AIGUA,08193,081939,SANT ISCLE DE VALLALTA,11,3,14
2019/2020,08025058,ESCOLA RIU D'OR,08192,081923,SANTPEDOR,24,4,28
2019/2020,08024972,ESCOLA TORRES AMAT,08191,081918,SALLENT,25,4,29
2019/2020,08024893,INSTITUT CASTELLARNAU,08187,081878,SABADELL,49,49,98
2019/2020,08024881,INSTITUT FERRAN CASABLANCAS,08187,081878,SABADELL,43,47,90
2019/2020,08024871,INSTITUT PAU VILA,08187,081878,SABADELL,45,29,74
2019/2020,08024856,ESCOLA FONT ROSELLA,08187,081878,SABADELL,22,5,27
2019/2020,08024844,ESCOLA TORREGUITART,08187,081878,SABADELL,14,3,17
2019/2020,08024832,ESCOLA FLORESTA,08187,081878,SABADELL,14,4,18
2019/2020,08024820,ESCOLA PAU CASALS,08187,081878,SABADELL,23,7,30
2019/2020,08024819,ESCOLA CALVET D'ESTRELLA,08187,081878,SABADELL,14,3,17
2019/2020,08024807,ESCOLA AGNÈS ARMENGOL,08187,081878,SABADELL,17,3,20
2019/2020,08024790,ESCOLA ROUREDA,08187,081878,SABADELL,25,4,29
2019/2020,08024789,CEE FRANCESC BELLAPART,08187,081878,SABADELL,36,3,39
2019/2020,08024777,INSTITUT EGARA,08279,082798,TERRASSA,26,19,45
2019/2020,08024765,INSTITUT ARRAONA,08187,081878,SABADELL,30,20,50
2019/2020,08024741,INSTITUT ESCOLA INDUSTRIAL,08187,081878,SABADELL,49,63,112
2019/2020,08024066,ESCOLA TARLATANA,08187,081878,SABADELL,16,2,18
2019/2020,08024042,ESCOLA LA ROMÀNICA,08187,081878,SABADELL,24,7,31
2019/2020,08024030,ESCOLA SAMUNTADA,08187,081878,SABADELL,17,3,20
2019/2020,08024017,ESCOLA MIQUEL CARRERAS,08187,081878,SABADELL,15,6,21
2019/2020,08024005,ESCOLA JOAN MARAGALL,08187,081878,SABADELL,24,1,25
2019/2020,08023992,ESCOLA JOAN SALLARÈS I PLA,08187,081878,SABADELL,22,6,28
2019/2020,08023980,ESCOLA JUAN RAMÓN JIMÉNEZ,08187,081878,SABADELL,14,3,17
2019/2020,08023979,ESCOLA JOAN MONTLLOR,08187,081878,SABADELL,13,6,19
2019/2020,08023955,ESCOLA CIFUENTES,08187,081878,SABADELL,26,5,31
2019/2020,08023943,ESCOLA GAUDÍ,08187,081878,SABADELL,18,0,18
2019/2020,08023931,ESCOLA ENRIC CASASSAS,08187,081878,SABADELL,12,3,15
2019/2020,08023921,ESCOLA ESPRONCEDA,08187,081878,SABADELL,28,4,32
2019/2020,08023918,ESCOLA CONCÒRDIA,08187,081878,SABADELL,28,1,29
2019/2020,08023852,ESCOLA JOAN MARAGALL,08184,081846,RUBÍ,21,1,22
2019/2020,08023669,ESCOLA MARE DE DÉU DEL SÒL DEL PONT,08183,081831,RODA DE TER,24,4,28
2019/2020,08023591,ESCOLA PILAR MESTRES-JAUME TORRENS,08181,081810,LA ROCA DEL VALLÈS,14,3,17
2019/2020,08023566,ESCOLA ANSELM CLAVÉ,08180,081803,RIPOLLET,27,2,29
2019/2020,08023554,ESCOLA JOSEP MARIA GINESTA,08180,081803,RIPOLLET,28,1,29
2019/2020,08023542,ESCOLA TIANA DE LA RIBA,08180,081803,RIPOLLET,15,4,19
2019/2020,08023426,ESCOLA GASSÓ I VIDAL,08180,081803,RIPOLLET,14,1,15
2019/2020,08023372,ESCOLA ALFRED MATA,08175,081751,PUIG-REIG,14,2,16
2019/2020,08023359,ESCOLA VIROLAI - ZER CEP DE SIS,08174,081748,PUIGDÀLBER,5,0,5
2019/2020,08023335,ESCOLA MONTSERRAT,08172,081727,PREMIÀ DE MAR,19,6,25
2019/2020,08023232,ESCOLA SANT CRISTÒFOL,08172,081727,PREMIÀ DE MAR,23,3,26
2019/2020,08023207,ESCOLA LLUÇANÈS,08171,081712,PRATS DE LLUÇANÈS,14,2,16
2019/2020,08023141,ESCOLA MARE DE DÉU DEL PORTAL - ZER VENT D'AVALL,08170,081705,ELS PRATS DE REI,6,1,7
2019/2020,08023131,INSTITUT BALDIRI GUILERA,08169,081691,EL PRAT DE LLOBREGAT,38,21,59
2019/2020,08022938,ESCOLA JACINT VERDAGUER,08169,081691,EL PRAT DE LLOBREGAT,28,3,31
2019/2020,08022926,CEE CAN RIGOL,08169,081691,EL PRAT DE LLOBREGAT,27,4,31
2019/2020,08022914,ESCOLA JAUME BALMES,08169,081691,EL PRAT DE LLOBREGAT,30,3,33
2019/2020,08022902,ESCOLA DEL PARC,08169,081691,EL PRAT DE LLOBREGAT,29,2,31
2019/2020,08022884,ESCOLA JOAN MARAGALL,08169,081691,EL PRAT DE LLOBREGAT,16,2,18
2019/2020,08022872,ESCOLA PERE CALDERS,08167,081672,POLINYÀ,19,7,26
2019/2020,08022860,ESCOLA LILLET A GÜELL,08166,081666,LA POBLA DE LILLET,6,3,9
2019/2020,08022859,ESCOLA MARIA BORÉS,08165,081653,LA POBLA DE CLARAMUNT,14,2,16
2019/2020,08022847,ESCOLA SANTS ABDÓ I SENÉN,08164,081640,EL PLA DEL PENEDÈS,9,5,14
2019/2020,08022835,ESCOLA JAUME I,08163,081635,PINEDA DE MAR,23,3,26
2019/2020,08022801,ESCOLA ANTONI DOLTRA,08163,081635,PINEDA DE MAR,16,2,18
2019/2020,08022793,ESCOLA RENAIXENÇA,08162,081629,ELS HOSTALETS DE PIEROLA,24,2,26
2019/2020,08022768,ESCOLA HEROIS DEL BRUC,08161,081614,PIERA,28,5,33
2019/2020,08022707,ESCOLA POMPEU FABRA,08159,081593,PARETS DEL VALLÈS,15,2,17
2019/2020,08022690,ESCOLA LLUÍS PIQUER,08159,081593,PARETS DEL VALLÈS,28,2,30
2019/2020,08022689,ESCOLA PAU VILA,08158,081580,EL PAPIOL,27,2,29
2019/2020,08022677,ESCOLA JACINT VERDAGUER,08157,081574,PALLEJÀ,16,1,17
2019/2020,08022665,ESCOLA ÀNGEL GUIMERÀ,08157,081574,PALLEJÀ,16,4,20
2019/2020,08022616,ESCOLA JOSEP MARIA FOLCH I TORRES,08156,081568,PALAU-SOLITÀ I PLEGAMANS,18,2,20
2019/2020,08022598,ESCOLA LES FERRERIES DE PALAFOLLS,08155,081555,PALAFOLLS,27,4,31
2019/2020,08022586,ESCOLA EL DRAC,08154,081542,PACS DEL PENEDÈS,9,3,12
2019/2020,08022574,ESCOLA FRANCESC MACIÀ,08153,081537,ÒRRIUS,11,2,13
2019/2020,08022549,ESCOLA LLEVANT - ZER GAVARRESA,08151,081516,ORISTÀ,3,0,3
2019/2020,08022495,ESCOLA TERRA NOSTRA,08149,081496,OLOST,11,1,12
2019/2020,08022461,ESCOLA SANT BERNAT,08147,081477,OLESA DE MONTSERRAT,25,4,29
2019/2020,08022380,ESCOLA MARE DE DÉU DE MONTSERRAT,08147,081477,OLESA DE MONTSERRAT,24,1,25
2019/2020,08022379,ESCOLA PONT DE L'ARCADA,08146,081461,OLESA DE BONESVALLS,10,2,12
2019/2020,08022367,ESCOLA ROSSEND MONTANÉ,08145,081458,OLÈRDOLA,14,3,17
2019/2020,08022343,ESCOLA CIRCELL,08145,081458,OLÈRDOLA,14,4,18
2019/2020,08022331,ESCOLA D'OLVAN - ZER BAIX BERGUEDÀ,08144,081445,OLVAN,6,0,6
2019/2020,08022321,ESCOLA CASTELL D'ÒDENA,08143,081430,ÒDENA,21,5,26
2019/2020,08022197,ESCOLA CATALUNYA,08140,081402,NAVARCLES,26,7,33
2019/2020,08022094,ESCOLA JOSEP ORRIOLS I ROCA,08138,081385,MOIÀ,25,3,28
2019/2020,08022082,ESCOLA PUIG DRAU - ZER BAIX MONTSENY,08137,081379,MONTSENY,4,0,4
2019/2020,08022070,ESCOLA MARINADA,08136,081363,MONTORNÈS DEL VALLÈS,28,5,33
2019/2020,08022057,ESCOLA SANT SADURNÍ,08136,081363,MONTORNÈS DEL VALLÈS,12,3,15
2019/2020,08022045,ESCOLA SANT JORDI,08135,081350,MONTMELÓ,25,4,29
2019/2020,08022011,ESCOLA PAU CASALS,08135,081350,MONTMELÓ,22,1,23
2019/2020,08022008,ESCOLA MONTMANY,08134,081347,FIGARÓ-MONTMANY,9,1,10
2019/2020,08021983,ESCOLA GIRA-SOL - ZER BAIX BERGUEDÀ,08132,081326,MONTMAJOR,7,0,7
2019/2020,08021961,ESCOLA EL ROCAL - ZER ELS CASTELLS,08131,081311,MONTESQUIU,9,1,10
2019/2020,08021934,ESCOLA L'ESQUEIX - ZER EL MOIANÈS PONENT,08128,081287,MONISTROL DE CALDERS,3,1,4
2019/2020,08021892,ESCOLA SANT PERE,08127,081271,MONISTROL DE MONTSERRAT,16,1,17
2019/2020,08021880,ESCOLA SALVADOR ESPRIU,08126,081265,MONTGAT,28,1,29
2019/2020,08021788,INSTITUT MONTSERRAT MIRÓ I VILA,08125,081252,MONTCADA I REIXAC,36,18,54
2019/2020,08021764,ESCOLA MITJA COSTA,08125,081252,MONTCADA I REIXAC,12,4,16
2019/2020,08021685,ESCOLA FONT FREDA,08125,081252,MONTCADA I REIXAC,16,2,18
2019/2020,08021600,INSTITUT VICENÇ PLANTADA,08124,081249,MOLLET DEL VALLÈS,44,27,71
2019/2020,08021594,INSTITUT DE MOLLET DEL VALLÈS,08124,081249,MOLLET DEL VALLÈS,35,70,105
2019/2020,08021582,ESCOLA JOAN SALVAT PAPASSEIT,08124,081249,MOLLET DEL VALLÈS,12,4,16
2019/2020,08021570,ESCOLA DEL BOSC,08124,081249,MOLLET DEL VALLÈS,12,4,16
2019/2020,08021466,ESCOLA COL·LEGIS NOUS,08124,081249,MOLLET DEL VALLÈS,23,2,25
2019/2020,08021442,ESCOLA CASTELL CIURÓ,08123,081234,MOLINS DE REI,20,6,26
2019/2020,08021430,INSTITUT LLUÍS DE REQUESENS,08123,081234,MOLINS DE REI,47,21,68
2019/2020,08021363,ESCOLA L'ALZINA,08123,081234,MOLINS DE REI,14,2,16
2019/2020,08021351,ESCOLA EL PALAU,08123,081234,MOLINS DE REI,14,2,16
2019/2020,08021326,ESCOLA LA FASSINA,08122,081228,MEDIONA,8,1,9
2019/2020,08021302,INSTITUT DAMIÀ CAMPENY,08121,081213,MATARÓ,35,18,53
2019/2020,08021260,INSTITUT ALEXANDRE SATORRAS,08121,081213,MATARÓ,59,32,91
2019/2020,08021041,ESCOLA JOSEP MONTSERRAT,08121,081213,MATARÓ,15,3,18
2019/2020,08020929,ESCOLA GERMANES BERTOMEU,08121,081213,MATARÓ,31,3,34
2019/2020,08020917,ESCOLA JOSEP MANUEL PERAMÀS,08121,081213,MATARÓ,28,3,31
2019/2020,08020905,ESCOLA ANGELETA FERRER,08121,081213,MATARÓ,20,2,22
2019/2020,08020863,ESCOLA GINESTA,08120,081206,MATADEPERA,24,2,26
2019/2020,08020841,ESCOLA EL TURÓ,08119,081192,MASQUEFA,24,6,30
2019/2020,08020838,INSTITUT MEDITERRÀNIA,08118,081189,EL MASNOU,17,20,37
2019/2020,08020826,INSTITUT MAREMAR,08118,081189,EL MASNOU,37,21,58
2019/2020,08020723,ESCOLA OCATA,08118,081189,EL MASNOU,16,1,17
2019/2020,08020701,ESCOLA COMTES DE LACAMBRA,08117,081173,LES MASIES DE VOLTREGÀ,10,3,13
2019/2020,08020656,ESCOLA SIMEÓ RABASA,08115,081154,MARTORELLES,14,2,16
2019/2020,08020620,INSTITUT POMPEU FABRA,08114,081141,MARTORELL,47,32,79
2019/2020,08020619,ESCOLA JOSÉ ECHEGARAY,08114,081141,MARTORELL,28,4,32
2019/2020,08020607,ESCOLA JUAN RAMÓN JIMÉNEZ,08114,081141,MARTORELL,24,5,29
2019/2020,08020516,CEE EL PONTARRÓ,08114,081141,MARTORELL,27,2,29
2019/2020,08020498,ESCOLA ELS CONVENTS,08114,081141,MARTORELL,16,1,17
2019/2020,08020474,INSTITUT LLUÍS DE PEGUERA,08113,081136,MANRESA,59,26,85
2019/2020,08020462,INSTITUT LACETÀNIA,08113,081136,MANRESA,55,75,130
2019/2020,08020127,ESCOLA BAGES,08113,081136,MANRESA,28,3,31
2019/2020,08020097,ESCOLA PARE ALGUÉ,08113,081136,MANRESA,19,4,23
2019/2020,08020073,ESCOLA SANT IGNASI,08113,081136,MANRESA,27,8,35
2019/2020,08020061,ESCOLA LA RENAIXENÇA,08113,081136,MANRESA,18,4,22
2019/2020,08020012,ESCOLA MUNTANYA DEL DRAC,08113,081136,MANRESA,13,2,15
2019/2020,08019940,ESCOLA PUIG-AGUT,08112,081120,MANLLEU,31,3,34
2019/2020,08019927,ESCOLA MARIÀ CUBÍ I SOLER,08110,081108,MALGRAT DE MAR,20,9,29
2019/2020,08019873,ESCOLA MARE DE DÉU DE MONTSERRAT,08110,081108,MALGRAT DE MAR,12,4,16
2019/2020,08019861,ESCOLA GAFARRÓ - ZER ALT LLUÇANÈS,08109,081094,LLUÇÀ,4,1,5
2019/2020,08019824,ESCOLA LES LLISSES,08108,081081,LLIÇÀ DE VALL,19,5,24
2019/2020,08019782,ESCOLA SALVADOR SANROMÀ,08106,081069,LLINARS DEL VALLÈS,26,3,29
2019/2020,08019745,ESCOLA JOAN MARAGALL,08105,081056,LA LLAGOSTA,26,4,30
2019/2020,08019711,ESCOLA SAGRADA FAMÍLIA,08105,081056,LA LLAGOSTA,20,4,24
2019/2020,08019691,ESCOLA VILADEMÀGER - ZER SERRA D'ANCOSA,08104,081043,LA LLACUNA,3,1,4
2019/2020,08019678,ESCOLA GUERAU DE JORBA,08103,081038,JORBA,10,0,10
2019/2020,08019654,INSTITUT MILÀ I FONTANALS,08102,081022,IGUALADA,65,63,128
2019/2020,08019642,ESCOLA PARE RAMON CASTELLTORT I MIRALDA,08102,081022,IGUALADA,28,2,30
2019/2020,08019630,INSTITUT PERE VIVES I VICH,08102,081022,IGUALADA,42,29,71
2019/2020,08019460,ESCOLA EMILI VALLÈS,08102,081022,IGUALADA,16,2,18
2019/2020,08019459,ESCOLA GABRIEL CASTELLA I RAICH,08102,081022,IGUALADA,20,0,20
2019/2020,08019435,ESCOLA GARCÍA I FOSSAS,08102,081022,IGUALADA,27,3,30
2019/2020,08019411,INSTITUT BELLVITGE,08101,081017,L'HOSPITALET DE LLOBREGAT,27,14,41
2019/2020,08019401,INSTITUT PROVENÇANA,08101,081017,L'HOSPITALET DE LLOBREGAT,47,39,86
2019/2020,08019371,INSTITUT LLOBREGAT,08101,081017,L'HOSPITALET DE LLOBREGAT,8,29,37
2019/2020,08019320,INSTITUT TORRAS I BAGES,08101,081017,L'HOSPITALET DE LLOBREGAT,35,23,58
2019/2020,08019319,INSTITUT PEDRAFORCA,08101,081017,L'HOSPITALET DE LLOBREGAT,65,33,98
2019/2020,08019307,INSTITUT SANTA EULÀLIA,08101,081017,L'HOSPITALET DE LLOBREGAT,40,11,51
2019/2020,08019290,ESCOLA PROVENÇANA,08101,081017,L'HOSPITALET DE LLOBREGAT,14,3,17
2019/2020,08019277,ESCOLA LA MARINA,08101,081017,L'HOSPITALET DE LLOBREGAT,26,4,30
2019/2020,08019265,ESCOLA JOAQUIM RUYRA,08101,081017,L'HOSPITALET DE LLOBREGAT,30,8,38
2019/2020,08019241,ESCOLA FREDERIC MISTRAL,08101,081017,L'HOSPITALET DE LLOBREGAT,24,3,27
2019/2020,08019231,ESCOLA MILAGROS CONSARNAU,08101,081017,L'HOSPITALET DE LLOBREGAT,29,3,32
2019/2020,08019216,ESCOLA BUSQUETS I PUNSET,08101,081017,L'HOSPITALET DE LLOBREGAT,23,5,28
2019/2020,08019198,ESCOLA POMPEU FABRA,08101,081017,L'HOSPITALET DE LLOBREGAT,25,6,31
2019/2020,08019149,ESCOLA BERNAT METGE,08101,081017,L'HOSPITALET DE LLOBREGAT,19,3,22
2019/2020,08018157,ESCOLA SANTIAGO RAMON Y CAJAL,08101,081017,L'HOSPITALET DE LLOBREGAT,32,8,40
2019/2020,08018145,ESCOLA PAU VILA,08101,081017,L'HOSPITALET DE LLOBREGAT,20,4,24
2019/2020,08018091,ESCOLA PEP VENTURA,08101,081017,L'HOSPITALET DE LLOBREGAT,33,4,37
2019/2020,08018078,ESCOLA BELLVITGE,08101,081017,L'HOSPITALET DE LLOBREGAT,15,3,18
2019/2020,08018066,ESCOLA MENÉNDEZ PIDAL,08101,081017,L'HOSPITALET DE LLOBREGAT,48,7,55
2019/2020,08018029,ESCOLA LES ESCOLES,08100,081000,GURB,26,3,29
2019/2020,08018017,ESCOLA L'ALBIOL - ZER ALT BERGUEDÀ,08903,089030,SANT JULIÀ DE CERDANYOLA,2,0,2
2019/2020,08018005,ESCOLA SANT LLORENÇ,08099,080996,GUARDIOLA DE BERGUEDÀ,7,3,10
2019/2020,08017992,ESCOLA MONTSERRAT,08098,080983,SANT SALVADOR DE GUARDIOLA,20,2,22
2019/2020,08017979,ESCOLA AQUA ALBA,08097,080977,GUALBA,11,3,14
2019/2020,08017931,INSTITUT ANTONI CUMELLA,08096,080961,GRANOLLERS,34,21,55
2019/2020,08017918,ESCOLA GRANULLARIUS,08096,080961,GRANOLLERS,27,3,30
2019/2020,08017712,ESCOLA FERRER I GUÀRDIA,08096,080961,GRANOLLERS,16,1,17
2019/2020,08017700,ESCOLA JOAN SOLANS,08096,080961,GRANOLLERS,14,6,20
2019/2020,08017694,ESCOLA PEREANTON,08096,080961,GRANOLLERS,15,1,16
2019/2020,08017682,ESCOLA JACINT VERDAGUER,08094,080945,LA GRANADA,13,2,15
2019/2020,08017645,ESCOLA DE GIRONELLA,08092,080924,GIRONELLA,14,2,16
2019/2020,08017633,ESCOLA SANT MARC,08092,080924,GIRONELLA,14,1,15
2019/2020,08017611,ESCOLA MONTCAU,08091,080919,GELIDA,24,3,27
2019/2020,08017530,INSTITUT DE BRUGUERS,08089,080898,GAVÀ,31,19,50
2019/2020,08017505,ESCOLA JUAN SALAMERO,08089,080898,GAVÀ,13,3,16
2019/2020,08017360,ESCOLA JACME MARCH,08089,080898,GAVÀ,19,2,21
2019/2020,08017359,ESCOLA SALVADOR LLUCH,08089,080898,GAVÀ,28,2,30
2019/2020,08017311,ESCOLA PUIGGRACIÓS,08088,080885,LA GARRIGA,26,5,31
2019/2020,08017271,ESCOLA JOAN SANPERA I TORRAS,08086,080863,LES FRANQUESES DEL VALLÈS,28,2,30
2019/2020,08017244,ESCOLA FONT-RÚBIA,08085,080850,FONT-RUBÍ,15,1,16
2019/2020,08017232,ESCOLA AGRUPACIÓ SANT JORDI,08084,080847,FONOLLOSA,13,3,16
2019/2020,08017207,ESCOLA MOSSÈN CINTO,08083,080832,FOLGUEROLES,21,2,23
2019/2020,08017153,INSTITUT JOANOT MARTORELL,08077,080771,ESPLUGUES DE LLOBREGAT,32,16,48
2019/2020,08017131,INSTITUT SEVERO OCHOA,08077,080771,ESPLUGUES DE LLOBREGAT,65,29,94
2019/2020,08017116,ESCOLA MATILDE ORDUÑA,08077,080771,ESPLUGUES DE LLOBREGAT,12,4,16
2019/2020,08017104,ESCOLA GRAS I SOLER,08077,080771,ESPLUGUES DE LLOBREGAT,13,4,17
2019/2020,08016941,ESCOLA ISIDRE MARTÍ,08077,080771,ESPLUGUES DE LLOBREGAT,23,0,23
2019/2020,08016938,ESCOLA TAQUÍGRAF GARRIGA,08076,080765,ESPARREGUERA,23,5,28
2019/2020,08016872,ESCOLA MARE DE DÉU DE LA MUNTANYA,08076,080765,ESPARREGUERA,14,2,16
2019/2020,08016811,ESCOLA JOSEP ANDREU - CHARLIE RIVEL,08074,080749,CUBELLES,32,6,38
2019/2020,08016793,INSTITUT FRANCESC MACIÀ,08073,080734,CORNELLÀ DE LLOBREGAT,42,22,64
2019/2020,08016781,INSTITUT ESTEVE TERRADAS I ILLA,08073,080734,CORNELLÀ DE LLOBREGAT,72,78,150
2019/2020,08016771,ESCOLA ELS PINS,08073,080734,CORNELLÀ DE LLOBREGAT,24,4,28
2019/2020,08016744,ESCOLA ANTONI GAUDÍ,08073,080734,CORNELLÀ DE LLOBREGAT,18,2,20
2019/2020,08016422,ESCOLA ABAT OLIBA,08073,080734,CORNELLÀ DE LLOBREGAT,19,5,24
2019/2020,08016410,ESCOLA SANT ILDEFONS,08073,080734,CORNELLÀ DE LLOBREGAT,23,2,25
2019/2020,08016409,ESCOLA MONTSERRAT,08073,080734,CORNELLÀ DE LLOBREGAT,12,4,16
2019/2020,08016392,ESCOLA MOSSÈN JACINT VERDAGUER,08073,080734,CORNELLÀ DE LLOBREGAT,15,1,16
2019/2020,08016380,ESCOLA ANSELM CLAVÉ,08073,080734,CORNELLÀ DE LLOBREGAT,13,3,16
2019/2020,08016367,ESCOLA DOLORS ALMEDA,08073,080734,CORNELLÀ DE LLOBREGAT,26,2,28
2019/2020,08016331,ESCOLA JAUME BALMES,08072,080728,CORBERA DE LLOBREGAT,23,6,29
2019/2020,08016291,ESCOLA COPONS - ZER VENT D'AVALL,08071,080713,COPONS,6,0,6
2019/2020,08016264,ESCOLA EL SOLELL,08905,089058,LA PALMA DE CERVELLÓ,13,6,19
2019/2020,08016240,ESCOLA SANTA MARIA DE CERVELLÓ,08068,080689,CERVELLÓ,22,5,27
2019/2020,08016185,ESCOLA ILDEFONS CERDÀ,08067,080673,CENTELLES,22,4,26
2019/2020,08016173,ESCOLA MARE DE DÉU DE MONTSERRAT,08066,080667,CASTELLVÍ DE ROSANES,13,1,14
2019/2020,08016161,ESCOLA EL CASTELLOT,08065,080654,CASTELLVÍ DE LA MARCA,11,2,13
2019/2020,08016136,ESCOLA LES PASSERES - ZER TRES BRANQUES,08063,080636,CASTELLOLÍ,8,1,9
2019/2020,08016094,ESCOLA SANT MIQUEL,08061,080615,CASTELLGALÍ,16,0,16
2019/2020,08016082,ESCOLA SANT ROC - ZER VENT D'AVALL,08060,080608,CASTELLFOLLIT DE RIUBREGÓS,3,0,3
2019/2020,08016070,ESCOLA DE MAIANS - ZER TRES BRANQUES,08059,080594,CASTELLFOLLIT DEL BOIX,2,0,2
2019/2020,08016069,ESCOLA COLL DE GOSSEM - ZER TRES BRANQUES,08059,080594,CASTELLFOLLIT DEL BOIX,2,0,2
2019/2020,08016033,ESCOLA MONTANYANS,08058,080581,CASTELLET I LA GORNAL,10,3,13
2019/2020,08015961,ESCOLA JACINT VERDAGUER,08056,080569,CASTELLDEFELS,15,2,17
2019/2020,08015855,ESCOLA ELS PINS,08056,080569,CASTELLDEFELS,26,3,29
2019/2020,08015843,ESCOLA LLUÍS VIVES,08056,080569,CASTELLDEFELS,27,2,29
2019/2020,08015831,ESCOLA LA POPA - ZER EL MOIANÈS LLEVANT,08055,080556,CASTELLCIR,9,2,11
2019/2020,08015821,ESCOLA MARE DE DÉU DE MONTSERRAT,08054,080543,CASTELLBISBAL,29,1,30
2019/2020,08015806,ESCOLA JAUME BALMES,08053,080538,CASTELLBELL I EL VILAR,18,2,20
2019/2020,08015651,ESCOLA PRINCESA LÀSCARIS,08049,080497,CASSERRES,11,3,14
2019/2020,08015648,ESCOLA SERRA DE COLL-BAS,08048,080484,CARME,7,3,10
2019/2020,08015612,ESCOLA JOAN DE PALÀ - ZER EL CARDENER,08047,080478,CARDONA,5,0,5
2019/2020,08015582,ESCOLA MARE DE DÉU DEL PATROCINI,08047,080478,CARDONA,13,3,16
2019/2020,08015454,ESCOLA RAMON MACIP - DOLORS GRANÉS,08046,080462,CARDEDEU,19,4,23
2019/2020,08015430,ESCOLA MARQUÈS DE LA POBLA,08044,080446,CAPELLADES,21,7,28
2019/2020,08015399,ESCOLA SANT NICOLAU,08043,080431,CANYELLES,25,4,29
2019/2020,08015375,ESCOLA L'ESTELADA,08042,080425,CÀNOVES I SAMALÚS,16,4,20
2019/2020,08015351,ESCOLA JACINT VERDAGUER,08041,080410,CANOVELLES,22,4,26
2019/2020,08015302,ESCOLA MISERICÒRDIA,08040,080403,CANET DE MAR,25,4,29
2019/2020,08015259,ESCOLA L'ALZINAR - ZER BAIX MONTSENY,08039,080399,CAMPINS,5,0,5
2019/2020,08015247,ESCOLA JOVENTUT,08038,080386,CALLÚS,14,2,16
2019/2020,08015193,ESCOLA SANT MARC,08037,080370,CALLDETENES,21,2,23
2019/2020,08015171,INSTITUT BISBE SIVILLA,08035,080351,CALELLA,48,21,69
2019/2020,08015144,ESCOLA EL FAR,08035,080351,CALELLA,24,3,27
2019/2020,08015119,ESCOLA LA MINERVA,08035,080351,CALELLA,26,3,29
2019/2020,08015107,ESCOLA ANTON BUSQUETS I PUNSET - ZER EL MOIANÈS PONENT,08034,080348,CALDERS,7,1,8
2019/2020,08015077,ESCOLA EL FARELL,08033,080333,CALDES DE MONTBUI,27,1,28
2019/2020,08015004,ESCOLA SAGRADA FAMÍLIA,08032,080327,CALDES D'ESTRAC,15,1,16
2019/2020,08014929,ESCOLA ALTA SEGARRA,08031,080312,CALAF,29,4,33
2019/2020,08014905,ESCOLA L'OLIVERA,08030,080305,CABRILS,23,3,26
2019/2020,08014841,ESCOLA LES OLIVERES - ZER SERRA D'ANCOSA,08028,080288,CABRERA D'ANOIA,4,1,5
2019/2020,08014814,ESCOLA EL BRUC,08025,080253,EL BRUC,11,4,15
2019/2020,08014796,ESCOLA DE BORREDÀ - ZER BERGUEDÀ CENTRE,08024,080240,BORREDÀ,2,0,2
2019/2020,08014747,ESCOLA EL TURÓ,08023,080235,BIGUES I RIELLS,20,2,22
2019/2020,08014693,INSTITUT GUILLEM DE BERGUEDÀ,08022,080229,BERGA,43,15,58
2019/2020,08014681,ESCOLA SANTA EULÀLIA,08022,080229,BERGA,27,3,30
2019/2020,08014668,ESCOLA DE LA VALLDAN,08022,080229,BERGA,11,1,12
2019/2020,08014620,ESCOLA SANT JOAN,08022,080229,BERGA,24,4,28
2019/2020,08014589,ESCOLA SANT CRISTÒFOR,08020,080207,BEGUES,26,5,31
2019/2020,08014401,INSTITUT MARE DE DÉU DE LA MERCÈ,08019,080193,BARCELONA,57,90,147
2019/2020,08013470,INSTITUT BARRI BESÒS,08019,080193,BARCELONA,32,15,47
2019/2020,08013469,INSTITUT RAMBLA PRIM,08019,080193,BARCELONA,19,30,49
2019/2020,08013457,ESCOLA PEGASO,08019,080193,BARCELONA,29,2,31
2019/2020,08013411,ESCOLA POBLE-SEC,08019,080193,BARCELONA,25,5,30
2019/2020,08013408,ESCOLA BARCELONA,08019,080193,BARCELONA,27,3,30
2019/2020,08013366,INSTITUT SANT ANDREU,08019,080193,BARCELONA,35,14,49
2019/2020,08013329,EA LLOTJA,08019,080193,BARCELONA,57,52,109
2019/2020,08013305,ESCOLA RAMON BERENGUER III,08019,080193,BARCELONA,17,2,19
2019/2020,08013275,INSTITUT ESCOLA DEL TREBALL,08019,080193,BARCELONA,89,129,218
2019/2020,08013238,INSTITUT VERDAGUER,08019,080193,BARCELONA,27,10,37
2019/2020,08013226,INSTITUT MENÉNDEZ Y PELAYO,08019,080193,BARCELONA,35,30,65
2019/2020,08013214,INSTITUT NARCÍS MONTURIOL,08019,080193,BARCELONA,25,10,35
2019/2020,08013202,INSTITUT MONTSERRAT,08019,080193,BARCELONA,44,26,70
2019/2020,08013196,INSTITUT MILÀ I FONTANALS,08019,080193,BARCELONA,28,21,49
2019/2020,08013184,INSTITUT BERNAT METGE,08019,080193,BARCELONA,24,20,44
2019/2020,08013160,INSTITUT POETA MARAGALL,08019,080193,BARCELONA,45,20,65
2019/2020,08013159,INSTITUT INFANTA ISABEL D'ARAGÓ,08019,080193,BARCELONA,39,27,66
2019/2020,08013147,INSTITUT EMPERADOR CARLES,08019,080193,BARCELONA,42,15,57
2019/2020,08013135,INSTITUT MOISÈS BROGGI,08019,080193,BARCELONA,45,18,63
2019/2020,08013111,INSTITUT JAUME BALMES,08019,080193,BARCELONA,45,37,82
2019/2020,08013101,INSTITUT JOAN D'ÀUSTRIA,08019,080193,BARCELONA,37,35,72
2019/2020,08013093,INSTITUT MONTJUÏC,08019,080193,BARCELONA,24,11,35
2019/2020,08013081,ESCOLA COVES D'EN CIMANY,08019,080193,BARCELONA,18,1,19
2019/2020,08002991,ESCOLA CASCAVELL,08194,081944,SANT ADRIÀ DE BESÒS,16,5,21
2019/2020,08002988,ESCOLA PARE POVEDA,08019,080193,BARCELONA,24,2,26
2019/2020,08002976,ESCOLA RAMON CASAS,08019,080193,BARCELONA,26,3,29
2019/2020,08002952,ESCOLA ENRIC GRANADOS,08019,080193,BARCELONA,16,3,19
2019/2020,08002927,ESCOLA JOAQUIM RUYRA,08019,080193,BARCELONA,22,9,31
2019/2020,08002915,ESCOLA BRASIL,08019,080193,BARCELONA,22,3,25
2019/2020,08002903,CEE SANT JOAN DE LA CREU,08019,080193,BARCELONA,32,2,34
2019/2020,08002897,ESCOLA MESTRE MORERA,08019,080193,BARCELONA,19,2,21
2019/2020,08002885,ESCOLA PROSPERITAT,08019,080193,BARCELONA,17,1,18
2019/2020,08002873,ESCOLA BAC DE RODA,08019,080193,BARCELONA,26,3,29
2019/2020,08002800,ESCOLA MAS CASANOVAS,08019,080193,BARCELONA,18,1,19
2019/2020,08002770,ESCOLA ÀGORA,08019,080193,BARCELONA,12,4,16
2019/2020,08002745,ESCOLA EL CARMEL,08019,080193,BARCELONA,34,4,38
2019/2020,08002733,ESCOLA MIRALLETES,08019,080193,BARCELONA,17,1,18
2019/2020,08002721,ESCOLA FONT D'EN FARGAS,08019,080193,BARCELONA,29,3,32
2019/2020,08002681,ESCOLA DURAN I BAS,08019,080193,BARCELONA,27,2,29
2019/2020,08002678,ESCOLA AUSIÀS MARCH,08019,080193,BARCELONA,13,3,16
2019/2020,08002666,CEE CONCHA ESPINA,08019,080193,BARCELONA,17,3,20
2019/2020,08002654,ESCOLA PRIM,08019,080193,BARCELONA,23,1,24
2019/2020,08002642,ESCOLA POBLENOU,08019,080193,BARCELONA,17,4,21
2019/2020,08002630,ESCOLA ELS PORXOS,08019,080193,BARCELONA,14,2,16
2019/2020,08002629,ESCOLA LES ACÀCIES,08019,080193,BARCELONA,24,7,31
2019/2020,08002617,ESCOLA RAMBLETA DEL CLOT,08019,080193,BARCELONA,24,5,29
2019/2020,08002599,ESCOLA EDUARD MARQUINA,08019,080193,BARCELONA,15,5,20
2019/2020,08002587,ESCOLA CONCEPCIÓN ARENAL,08019,080193,BARCELONA,17,4,21
2019/2020,08002575,ESCOLA LA PAU,08019,080193,BARCELONA,17,2,19
2019/2020,08002563,ESCOLA LA MAR BELLA,08019,080193,BARCELONA,21,2,23
2019/2020,08002551,ESCOLA MOLÍ DE FINESTRELLES,08019,080193,BARCELONA,29,2,31
2019/2020,08002538,ESCOLA VÍCTOR CATALÀ,08019,080193,BARCELONA,30,0,30
2019/2020,08002526,ESCOLA TIBIDABO,08019,080193,BARCELONA,15,2,17
2019/2020,08002484,ESCOLA AIGUAMARINA,08019,080193,BARCELONA,15,3,18
2019/2020,08002459,ESCOLA ELISENDA DE MONTCADA,08019,080193,BARCELONA,28,8,36
2019/2020,08002447,ESCOLA RAMÓN Y CAJAL,08019,080193,BARCELONA,13,5,18
2019/2020,08002411,ESCOLA BARÓ DE VIVER,08019,080193,BARCELONA,14,3,17
2019/2020,08002393,ESCOLA L'ARC DE SANT MARTÍ,08019,080193,BARCELONA,19,1,20
2019/2020,08002368,ESCOLA TIMBALER DEL BRUC,08019,080193,BARCELONA,15,3,18
2019/2020,08002344,ESCOLA EL TURÓ,08019,080193,BARCELONA,17,2,19
2019/2020,08002320,ESCOLA CIUTAT COMTAL,08019,080193,BARCELONA,13,3,16
2019/2020,08002290,ESCOLA EMILI JUNCADELLA,08019,080193,BARCELONA,16,1,17
2019/2020,08002277,ESCOLA CALDERÓN DE LA BARCA,08019,080193,BARCELONA,27,4,31
2019/2020,08002216,ESCOLA JOSEP MARIA DE SAGARRA,08019,080193,BARCELONA,14,3,17
2019/2020,08002204,ESCOLA MONTSENY,08019,080193,BARCELONA,16,0,16
2019/2020,08002198,ESCOLA LA FARIGOLA DE VALLCARCA,08019,080193,BARCELONA,13,3,16
2019/2020,08002186,ESCOLA MARE DE DÉU DE MONTSERRAT,08019,080193,BARCELONA,15,2,17
2019/2020,08002174,ESCOLA BALDIRI REIXAC,08019,080193,BARCELONA,16,1,17
2019/2020,08002113,ESCOLA RIUS I TAULET,08019,080193,BARCELONA,30,1,31
2019/2020,08002071,ESCOLA GAYARRE,08019,080193,BARCELONA,17,1,18
2019/2020,08002061,ESCOLA JAUME I,08019,080193,BARCELONA,31,7,38
2019/2020,08002058,ESCOLA PRÀCTIQUES,08019,080193,BARCELONA,28,4,32
2019/2020,08002022,ESCOLA CAL MAIOL,08019,080193,BARCELONA,13,4,17
2019/2020,08002010,ESCOLA LLUÍS VIVES,08019,080193,BARCELONA,14,3,17
2019/2020,08002009,ESCOLA FRANCESC MACIÀ,08019,080193,BARCELONA,14,5,19
2019/2020,08001947,ESCOLA MALLORCA,08019,080193,BARCELONA,28,2,30
2019/2020,08001923,ESCOLA DIPUTACIÓ,08019,080193,BARCELONA,26,4,30
2019/2020,08001911,ESCOLA ELS LLORERS,08019,080193,BARCELONA,26,7,33
2019/2020,08001868,ESCOLA RUBÉN DARÍO,08019,080193,BARCELONA,17,4,21
2019/2020,08001856,ESCOLA DRASSANES,08019,080193,BARCELONA,30,7,37
2019/2020,08001832,ESCOLA CASTELLA,08019,080193,BARCELONA,18,2,20
2019/2020,08001820,ESCOLA MILÀ I FONTANALS,08019,080193,BARCELONA,33,4,37
2019/2020,08001819,ESCOLA COLLASO I GIL,08019,080193,BARCELONA,30,7,37
2019/2020,08001807,ESCOLA DE LA CONCEPCIÓ,08019,080193,BARCELONA,12,4,16
2019/2020,08001790,ESCOLA PERE VILA,08019,080193,BARCELONA,35,4,39
2019/2020,08001789,ESCOLA CERVANTES,08019,080193,BARCELONA,15,3,18
2019/2020,08001777,ESCOLA RAMON LLULL,08019,080193,BARCELONA,30,5,35
2019/2020,08001731,ESCOLA POETA FOIX,08019,080193,BARCELONA,19,0,19
2019/2020,08001716,ESCOLA DOLORS MONSERDÀ-SANTAPAU,08019,080193,BARCELONA,24,5,29
2019/2020,08001674,ESCOLA CAN CLOS,08019,080193,BARCELONA,15,1,16
2019/2020,08001650,ESCOLA EL POLVORÍ,08019,080193,BARCELONA,12,5,17
2019/2020,08001649,ESCOLA MOSSÈN JACINT VERDAGUER,08019,080193,BARCELONA,33,4,37
2019/2020,08001601,ESCOLA PARC DE LA CIUTADELLA,08019,080193,BARCELONA,17,1,18
2019/2020,08001595,ESCOLA BAIXERAS,08019,080193,BARCELONA,17,2,19
2019/2020,08001583,ESCOLA GUILLEM DE BALSARENY,08018,080180,BALSARENY,12,3,15
2019/2020,08001534,ESCOLA JOAN XXIII,08017,080174,BALENYÀ,21,3,24
2019/2020,08001522,ESCOLA GALCERAN DE PINÓS,08016,080168,BAGÀ,12,2,14
2019/2020,08001509,ESCOLA ANTONI BOTEY,08015,080155,BADALONA,33,3,36
2019/2020,08001480,EA PAU GARGALLO,08015,080155,BADALONA,24,25,49
2019/2020,08001443,INSTITUT EUGENI D'ORS,08015,080155,BADALONA,52,27,79
2019/2020,08001431,INSTITUT ISAAC ALBÉNIZ,08015,080155,BADALONA,26,32,58
2019/2020,08001421,INSTITUT LA PINEDA,08015,080155,BADALONA,53,47,100
2019/2020,08001391,ESCOLA PLANAS I CASALS,08015,080155,BADALONA,23,6,29
2019/2020,08000414,ESCOLA ALEXANDRE GALÍ,08015,080155,BADALONA,22,5,27
2019/2020,08000402,ESCOLA FELIU I VEGUÉS,08015,080155,BADALONA,25,6,31
2019/2020,08000396,ESCOLA VENTÓS I MIR,08015,080155,BADALONA,20,3,23
2019/2020,08000384,ESCOLA LOLA ANGLADA,08015,080155,BADALONA,28,2,30
2019/2020,08000359,ESCOLA LA MUNTANYA,08014,080142,AIGUAFREDA,19,2,21
2019/2020,08000347,ESCOLA D'AVINYONET DEL PENEDÈS,08013,080137,AVINYONET DEL PENEDÈS,10,1,11
2019/2020,08000271,ESCOLA SANTA MARIA D'AVIÀ,08011,080116,AVIÀ,20,1,21
2019/2020,08000244,ESCOLA DOCTOR FERRER,08010,080109,ARTÉS,25,4,29
2019/2020,08000189,ESCOLA BERNAT DE RIUDEMEIA,08009,080095,ARGENTONA,14,2,16
2019/2020,08000165,ESCOLA SANT MARTÍ,08007,080076,ARENYS DE MUNT,20,7,27
2019/2020,08000153,ESCOLA JOAN MARAGALL,08006,080060,ARENYS DE MAR,35,3,38
2019/2020,08000098,ESCOLA BERTÍ,08005,080057,L'AMETLLA DEL VALLÈS,23,1,24
2019/2020,08000086,ESCOLA LA FORJA - ZER ALT LLUÇANÈS,08004,080044,ALPENS,4,0,4
2019/2020,08000049,ESCOLA FABRA,08003,080039,ALELLA,26,2,28
2019/2020,43013099,INSTITUT ESCOLA AGUSTÍ BARBERÀ,43014,430141,AMPOSTA,28,9,37
2019/2020,43013087,INSTITUT ESCOLA MONTSANT,43049,430496,CORNUDELLA DE MONTSANT,17,6,23
2019/2020,43013075,INSTITUT ESCOLA TERESINA MARTORELL,43163,431634,EL VENDRELL,26,10,36
2019/2020,43012988,INSTITUT DE MIAMI,43092,430923,MONT-ROIG DEL CAMP,19,7,26
2019/2020,43012976,INSTITUT ESCOLA MEDITERRANI,43148,431482,TARRAGONA,21,6,27
2019/2020,43012903,ESCOLA EL BOSC - ZER EL FRANCOLÍ,43091,430918,MONT-RAL,2,0,2
2019/2020,43012812,INSTITUT ESCOLA L'AGULLA,43043,430430,EL CATLLAR,36,11,47
2019/2020,43012769,CEE FONT DEL LLEÓ,43123,431233,REUS,14,0,14
2019/2020,43012307,INSTITUT ESCOLA DANIEL MANGRANÉ,43155,431554,TORTOSA,41,12,53
2019/2020,43012289,INSTITUT ESCOLA 3 D'ABRIL,43094,430944,MÓRA LA NOVA,32,11,43
2019/2020,43012113,INSTITUT ESCOLA MARE DE DÉU DEL PORTAL,43022,430228,BATEA,23,7,30
2019/2020,43012095,ESCOLA JOAN MIRÓ,43092,430923,MONT-ROIG DEL CAMP,29,2,31
2019/2020,43012083,INSTITUT ESCOLA PI DEL BURGAR,43123,431233,REUS,45,12,57
2019/2020,43011492,ESCOLA LA CANALETA,43171,431711,VILA-SECA,26,4,30
2019/2020,43011479,INSTITUT TARRAGONA,43148,431482,TARRAGONA,42,15,57
2019/2020,43011418,INSTITUT RODA DE BERÀ,43131,431310,RODA DE BERÀ,16,17,33
2019/2020,43011303,ZER MONTSANT,43035,430350,CABACÉS,3,1,4
2019/2020,43011212,ESCOLA LA BÒBILA,43038,430385,CAMBRILS,27,4,31
2019/2020,43011200,EOI DE SALOU,43905,439057,SALOU,6,0,6
2019/2020,43011194,ESCOLA EL CUCURULL,43131,431310,RODA DE BERÀ,14,2,16
2019/2020,43011170,INSTITUT CRISTÒFOL DESPUIG,43155,431554,TORTOSA,36,13,49
2019/2020,43011145,ESCOLA ELS GANXETS,43123,431233,REUS,15,2,17
2019/2020,43011121,ESCOLA VILAMAR,43037,430379,CALAFELL,15,3,18
2019/2020,43011029,ZER EBRE,43125,431251,RIBA-ROJA D'EBRE,2,1,3
2019/2020,43010980,EOI RIBERA D'EBRE,43093,430939,MÓRA D'EBRE,4,0,4
2019/2020,43010888,INSTITUT DE TECNIFICACIÓ,43014,430141,AMPOSTA,25,22,47
2019/2020,43010876,ESCOLA L'ARRABASSADA,43148,431482,TARRAGONA,27,2,29
2019/2020,43010864,ESCOLA ISABEL BESORA,43123,431233,REUS,21,7,28
2019/2020,43010852,INSTITUT ROSETA MAURI,43123,431233,REUS,49,7,56
2019/2020,43010839,ESCOLA SERRA MAJOR - ZER L'AGLÀ,43174,431747,LA VILELLA BAIXA,3,0,3
2019/2020,43010815,ESCOLA ELS COSSETANS,43051,430516,CUNIT,21,3,24
2019/2020,43010773,ESCOLA CONSOL FERRÉ,43014,430141,AMPOSTA,21,8,29
2019/2020,43010748,INSTITUT ELS PALLARESOS,43100,431009,ELS PALLARESOS,32,21,53
2019/2020,43010670,EOI DE VALLS,43161,431613,VALLS,6,0,6
2019/2020,43010669,EOI D'AMPOSTA,43014,430141,AMPOSTA,6,1,7
2019/2020,43010621,ESCOLA CINGLE ROIG - ZER BAIX CAMP NORD,43169,431690,VILAPLANA,3,1,4
2019/2020,43010608,INSTITUT SERRA DE MIRAMAR,43161,431613,VALLS,26,15,41
2019/2020,43010591,ESCOLA ARQUITECTE JUJOL,43100,431009,ELS PALLARESOS,13,4,17
2019/2020,43010581,ESCOLA MAS CLARIANA,43038,430385,CAMBRILS,26,3,29
2019/2020,43010578,INSTITUT FONTANELLES,43031,430311,LES BORGES DEL CAMP,35,15,50
2019/2020,43010554,ZER LES VINYES,43076,430764,MARÇÀ,1,3,4
2019/2020,43010530,ESCOLA MIRAMAR,43171,431711,VILA-SECA,27,3,30
2019/2020,43010529,ESCOLA CAVALLER ARNAU,43129,431299,RIUDOMS,16,2,18
2019/2020,43010505,ESCOLA LA VITXETA,43123,431233,REUS,26,3,29
2019/2020,43010499,CFA PAU CASALS,43043,430430,EL CATLLAR,11,7,18
2019/2020,43010487,ESCOLA MARCEL·LÍ ESQUIUS,43092,430923,MONT-ROIG DEL CAMP,14,2,16
2018/2019,08001856,ESCOLA DRASSANES,08019,080193,BARCELONA,28,6,34
2018/2019,08001868,ESCOLA RUBÉN DARÍO,08019,080193,BARCELONA,18,3,21
2018/2019,08001911,ESCOLA ELS LLORERS,08019,080193,BARCELONA,29,4,33
2018/2019,08001923,ESCOLA DIPUTACIÓ,08019,080193,BARCELONA,26,4,30
2018/2019,08001947,ESCOLA MALLORCA,08019,080193,BARCELONA,28,2,30
2018/2019,08002009,ESCOLA FRANCESC MACIÀ,08019,080193,BARCELONA,14,4,18
2018/2019,08002010,ESCOLA LLUÍS VIVES,08019,080193,BARCELONA,16,2,18
2018/2019,08002022,ESCOLA CAL MAIOL,08019,080193,BARCELONA,14,3,17
2018/2019,08002034,ESCOLA MIQUEL BLEACH,08019,080193,BARCELONA,19,2,21
2018/2019,08002058,ESCOLA PRÀCTIQUES,08019,080193,BARCELONA,30,3,33
2018/2019,08002061,ESCOLA JAUME I,08019,080193,BARCELONA,27,7,34
2018/2019,08002071,ESCOLA GAYARRE,08019,080193,BARCELONA,16,2,18
2018/2019,08002113,ESCOLA RIUS I TAULET,08019,080193,BARCELONA,29,1,30
2018/2019,08002174,ESCOLA BALDIRI REIXAC,08019,080193,BARCELONA,14,3,17
2018/2019,08002186,ESCOLA MARE DE DÉU DE MONTSERRAT,08019,080193,BARCELONA,13,5,18
2018/2019,08002198,ESCOLA LA FARIGOLA DE VALLCARCA,08019,080193,BARCELONA,17,1,18
2018/2019,08002204,ESCOLA MONTSENY,08019,080193,BARCELONA,15,2,17
2018/2019,08002216,ESCOLA JOSEP MARIA DE SAGARRA,08019,080193,BARCELONA,15,2,17
2018/2019,08002277,ESCOLA CALDERÓN DE LA BARCA,08019,080193,BARCELONA,29,3,32
2018/2019,08002290,ESCOLA EMILI JUNCADELLA,08019,080193,BARCELONA,15,2,17
2018/2019,08002320,ESCOLA CIUTAT COMTAL,08019,080193,BARCELONA,11,4,15
2018/2019,08002344,ESCOLA EL TURÓ,08019,080193,BARCELONA,17,2,19
2018/2019,08002368,ESCOLA TIMBALER DEL BRUC,08019,080193,BARCELONA,17,1,18
2018/2019,08002393,ESCOLA L'ARC DE SANT MARTÍ,08019,080193,BARCELONA,15,5,20
2018/2019,08002411,ESCOLA BARÓ DE VIVER,08019,080193,BARCELONA,14,3,17
2018/2019,08002447,ESCOLA RAMÓN Y CAJAL,08019,080193,BARCELONA,14,4,18
2018/2019,08002459,ESCOLA ELISENDA DE MONTCADA,08019,080193,BARCELONA,27,9,36
2018/2019,08002484,ESCOLA AIGUAMARINA,08019,080193,BARCELONA,14,4,18
2018/2019,08002526,ESCOLA TIBIDABO,08019,080193,BARCELONA,15,2,17
2018/2019,08002538,ESCOLA VÍCTOR CATALÀ,08019,080193,BARCELONA,29,1,30
2018/2019,08002551,ESCOLA MOLÍ DE FINESTRELLES,08019,080193,BARCELONA,29,2,31
2018/2019,08002563,ESCOLA LA MAR BELLA,08019,080193,BARCELONA,19,2,21
2018/2019,08002587,ESCOLA CONCEPCIÓN ARENAL,08019,080193,BARCELONA,18,4,22
2018/2019,08002599,ESCOLA EDUARD MARQUINA,08019,080193,BARCELONA,16,5,21
2018/2019,08002617,ESCOLA RAMBLETA DEL CLOT,08019,080193,BARCELONA,24,4,28
2018/2019,08002629,ESCOLA LES ACÀCIES,08019,080193,BARCELONA,26,4,30
2018/2019,08002630,ESCOLA ELS PORXOS,08019,080193,BARCELONA,14,2,16
2018/2019,08002642,ESCOLA POBLENOU,08019,080193,BARCELONA,20,3,23
2018/2019,08002654,ESCOLA PRIM,08019,080193,BARCELONA,23,3,26
2018/2019,08002666,CEE CONCHA ESPINA,08019,080193,BARCELONA,16,4,20
2018/2019,08002678,ESCOLA AUSIÀS MARCH,08019,080193,BARCELONA,12,6,18
2018/2019,08002681,ESCOLA DURAN I BAS,08019,080193,BARCELONA,25,4,29
2018/2019,08002721,ESCOLA FONT D'EN FARGAS,08019,080193,BARCELONA,29,3,32
2018/2019,08002733,ESCOLA MIRALLETES,08019,080193,BARCELONA,17,1,18
2018/2019,08002745,ESCOLA EL CARMEL,08019,080193,BARCELONA,35,3,38
2018/2019,08002770,ESCOLA ÀGORA,08019,080193,BARCELONA,12,4,16
2018/2019,08002800,ESCOLA MAS CASANOVAS,08019,080193,BARCELONA,15,4,19
2018/2019,08002873,ESCOLA BAC DE RODA,08019,080193,BARCELONA,27,3,30
2018/2019,08002885,ESCOLA PROSPERITAT,08019,080193,BARCELONA,17,1,18
2018/2019,08002897,ESCOLA MESTRE MORERA,08019,080193,BARCELONA,20,1,21
2018/2019,08002903,CEE SANT JOAN DE LA CREU,08019,080193,BARCELONA,32,3,35
2018/2019,08002915,ESCOLA BRASIL,08019,080193,BARCELONA,23,4,27
2018/2019,08002927,ESCOLA JOAQUIM RUYRA,08019,080193,BARCELONA,22,9,31
2018/2019,08002952,ESCOLA ENRIC GRANADOS,08019,080193,BARCELONA,16,3,19
2018/2019,08002976,ESCOLA RAMON CASAS,08019,080193,BARCELONA,25,4,29
2018/2019,08002988,ESCOLA PARE POVEDA,08019,080193,BARCELONA,27,0,27
2018/2019,08002991,ESCOLA CASCAVELL,08194,081944,SANT ADRIÀ DE BESÒS,18,4,22
2018/2019,08013081,ESCOLA COVES D'EN CIMANY,08019,080193,BARCELONA,19,0,19
2018/2019,08013093,INSTITUT MONTJUÏC,08019,080193,BARCELONA,22,13,35
2018/2019,08013101,INSTITUT JOAN D'ÀUSTRIA,08019,080193,BARCELONA,36,34,70
2018/2019,08013111,INSTITUT JAUME BALMES,08019,080193,BARCELONA,42,41,83
2018/2019,08013123,INSTITUT JOAN BOSCÀ,08019,080193,BARCELONA,42,16,58
2018/2019,08013135,INSTITUT MOISÈS BROGGI,08019,080193,BARCELONA,45,20,65
2018/2019,08013147,INSTITUT EMPERADOR CARLES,08019,080193,BARCELONA,37,20,57
2018/2019,08013159,INSTITUT INFANTA ISABEL D'ARAGÓ,08019,080193,BARCELONA,39,26,65
2018/2019,08013160,INSTITUT POETA MARAGALL,08019,080193,BARCELONA,49,17,66
2018/2019,08013172,INSTITUT AUSIÀS MARCH,08019,080193,BARCELONA,30,42,72
2018/2019,08013184,INSTITUT BERNAT METGE,08019,080193,BARCELONA,23,25,48
2018/2019,08013196,INSTITUT MILÀ I FONTANALS,08019,080193,BARCELONA,28,19,47
2018/2019,08013202,INSTITUT MONTSERRAT,08019,080193,BARCELONA,44,26,70
2018/2019,08013214,INSTITUT NARCÍS MONTURIOL,08019,080193,BARCELONA,21,13,34
2018/2019,08013226,INSTITUT MENÉNDEZ Y PELAYO,08019,080193,BARCELONA,33,31,64
2018/2019,08013238,INSTITUT VERDAGUER,08019,080193,BARCELONA,25,9,34
2018/2019,08013275,INSTITUT ESCOLA DEL TREBALL,08019,080193,BARCELONA,88,134,222
2018/2019,08013305,ESCOLA RAMON BERENGUER III,08019,080193,BARCELONA,18,1,19
2018/2019,08013329,EASD LLOTJA,08019,080193,BARCELONA,54,53,107
2018/2019,08013366,INSTITUT SANT ANDREU,08019,080193,BARCELONA,29,16,45
2018/2019,08013408,ESCOLA BARCELONA,08019,080193,BARCELONA,27,3,30
2018/2019,08013411,ESCOLA POBLE-SEC,08019,080193,BARCELONA,25,4,29
2018/2019,08013457,ESCOLA PEGASO,08019,080193,BARCELONA,31,2,33
2018/2019,08013469,INSTITUT RAMBLA PRIM,08019,080193,BARCELONA,20,32,52
2018/2019,08013470,INSTITUT BARRI BESÒS,08019,080193,BARCELONA,32,16,48
2018/2019,08014401,INSTITUT MARE DE DÉU DE LA MERCÈ,08019,080193,BARCELONA,51,93,144
2018/2019,08014589,ESCOLA SANT CRISTÒFOR,08020,080207,BEGUES,26,6,32
2018/2019,08014620,ESCOLA SANT JOAN,08022,080229,BERGA,23,5,28
2018/2019,08014668,ESCOLA DE LA VALLDAN,08022,080229,BERGA,11,1,12
2018/2019,08014681,ESCOLA SANTA EULÀLIA,08022,080229,BERGA,27,4,31
2018/2019,08014693,INSTITUT GUILLEM DE BERGUEDÀ,08022,080229,BERGA,39,17,56
2018/2019,08014747,ESCOLA EL TURÓ,08023,080235,BIGUES I RIELLS,21,3,24
2018/2019,08014796,ESCOLA DE BORREDÀ - ZER BERGUEDÀ CENTRE,08024,080240,BORREDÀ,2,0,2
2018/2019,08014814,ESCOLA EL BRUC,08025,080253,EL BRUC,11,5,16
2018/2019,08014841,ESCOLA LES OLIVERES - ZER SERRA D'ANCOSA,08028,080288,CABRERA D'ANOIA,4,2,6
2018/2019,08014905,ESCOLA L'OLIVERA,08030,080305,CABRILS,23,2,25
2018/2019,08014929,ESCOLA ALTA SEGARRA,08031,080312,CALAF,26,6,32
2018/2019,08015004,ESCOLA SAGRADA FAMÍLIA,08032,080327,CALDES D'ESTRAC,15,1,16
2018/2019,08015077,ESCOLA EL FARELL,08033,080333,CALDES DE MONTBUI,27,1,28
2018/2019,08015107,ESCOLA ANTON BUSQUETS I PUNSET - ZER EL MOIANÈS PONENT,08034,080348,CALDERS,10,0,10
2018/2019,08015119,ESCOLA LA MINERVA,08035,080351,CALELLA,23,7,30
2018/2019,08015144,ESCOLA EL FAR,08035,080351,CALELLA,23,3,26
2018/2019,08015171,INSTITUT BISBE SIVILLA,08035,080351,CALELLA,47,23,70
2018/2019,08015193,ESCOLA SANT MARC,08037,080370,CALLDETENES,21,2,23
2018/2019,08015247,ESCOLA JOVENTUT,08038,080386,CALLÚS,14,2,16
2018/2019,08015259,ESCOLA L'ALZINAR - ZER BAIX MONTSENY,08039,080399,CAMPINS,5,0,5
2018/2019,08015302,ESCOLA MISERICÒRDIA,08040,080403,CANET DE MAR,26,4,30
2018/2019,08015351,ESCOLA JACINT VERDAGUER,08041,080410,CANOVELLES,27,2,29
2018/2019,08015375,ESCOLA L'ESTELADA,08042,080425,CÀNOVES I SAMALÚS,17,4,21
2018/2019,08015399,ESCOLA SANT NICOLAU,08043,080431,CANYELLES,25,5,30
2018/2019,08015430,ESCOLA MARQUÈS DE LA POBLA,08044,080446,CAPELLADES,19,9,28
2018/2019,08015454,ESCOLA RAMON MACIP - DOLORS GRANÉS,08046,080462,CARDEDEU,20,5,25
2018/2019,08015582,ESCOLA MARE DE DÉU DEL PATROCINI,08047,080478,CARDONA,14,2,16
2018/2019,08015612,ESCOLA JOAN DE PALÀ - ZER EL CARDENER,08047,080478,CARDONA,5,0,5
2018/2019,08015648,ESCOLA SERRA DE COLL-BAS,08048,080484,CARME,7,2,9
2018/2019,08015651,ESCOLA PRINCESA LÀSCARIS,08049,080497,CASSERRES,12,2,14
2018/2019,08015806,ESCOLA JAUME BALMES,08053,080538,CASTELLBELL I EL VILAR,18,2,20
2018/2019,08015821,ESCOLA MARE DE DÉU DE MONTSERRAT,08054,080543,CASTELLBISBAL,28,2,30
2018/2019,08015831,ESCOLA LA POPA - ZER EL MOIANÈS LLEVANT,08055,080556,CASTELLCIR,9,2,11
2018/2019,08015843,ESCOLA LLUÍS VIVES,08056,080569,CASTELLDEFELS,29,2,31
2018/2019,08015855,ESCOLA ELS PINS,08056,080569,CASTELLDEFELS,26,3,29
2018/2019,08015961,ESCOLA JACINT VERDAGUER,08056,080569,CASTELLDEFELS,14,2,16
2018/2019,08016033,ESCOLA MONTANYANS,08058,080581,CASTELLET I LA GORNAL,11,3,14
2018/2019,08016069,ESCOLA COLL DE GOSSEM - ZER TRES BRANQUES,08059,080594,CASTELLFOLLIT DEL BOIX,2,0,2
2018/2019,08016070,ESCOLA DE MAIANS - ZER TRES BRANQUES,08059,080594,CASTELLFOLLIT DEL BOIX,2,0,2
2018/2019,08016082,ESCOLA SANT ROC - ZER VENT D'AVALL,08060,080608,CASTELLFOLLIT DE RIUBREGÓS,3,0,3
2018/2019,08016094,ESCOLA SANT MIQUEL,08061,080615,CASTELLGALÍ,16,0,16
2018/2019,08016136,ESCOLA LES PASSERES - ZER TRES BRANQUES,08063,080636,CASTELLOLÍ,9,0,9
2018/2019,08016161,ESCOLA EL CASTELLOT,08065,080654,CASTELLVÍ DE LA MARCA,9,4,13
2018/2019,08016173,ESCOLA MARE DE DÉU DE MONTSERRAT,08066,080667,CASTELLVÍ DE ROSANES,13,1,14
2018/2019,08016185,ESCOLA ILDEFONS CERDÀ,08067,080673,CENTELLES,22,4,26
2018/2019,08016240,ESCOLA SANTA MARIA DE CERVELLÓ,08068,080689,CERVELLÓ,24,4,28
2018/2019,08016264,ESCOLA EL SOLELL,08905,089058,LA PALMA DE CERVELLÓ,14,7,21
2018/2019,08016291,ESCOLA COPONS - ZER VENT D'AVALL,08071,080713,COPONS,4,1,5
2018/2019,08016331,ESCOLA JAUME BALMES,08072,080728,CORBERA DE LLOBREGAT,23,6,29
2018/2019,08016367,ESCOLA DOLORS ALMEDA,08073,080734,CORNELLÀ DE LLOBREGAT,26,2,28
2018/2019,08016380,ESCOLA ANSELM CLAVÉ,08073,080734,CORNELLÀ DE LLOBREGAT,14,2,16
2018/2019,08016392,ESCOLA MOSSÈN JACINT VERDAGUER,08073,080734,CORNELLÀ DE LLOBREGAT,15,1,16
2018/2019,08016409,ESCOLA MONTSERRAT,08073,080734,CORNELLÀ DE LLOBREGAT,13,3,16
2018/2019,08016410,ESCOLA SANT ILDEFONS,08073,080734,CORNELLÀ DE LLOBREGAT,25,2,27
2018/2019,08016422,ESCOLA ABAT OLIBA,08073,080734,CORNELLÀ DE LLOBREGAT,20,5,25
2018/2019,08016744,ESCOLA ANTONI GAUDÍ,08073,080734,CORNELLÀ DE LLOBREGAT,19,3,22
2018/2019,08016771,ESCOLA ELS PINS,08073,080734,CORNELLÀ DE LLOBREGAT,26,2,28
2018/2019,08016781,INSTITUT ESTEVE TERRADAS I ILLA,08073,080734,CORNELLÀ DE LLOBREGAT,69,84,153
2018/2019,08016793,INSTITUT FRANCESC MACIÀ,08073,080734,CORNELLÀ DE LLOBREGAT,37,24,61
2018/2019,08016811,ESCOLA JOSEP ANDREU - CHARLIE RIVEL,08074,080749,CUBELLES,31,5,36
2018/2019,08016872,ESCOLA MARE DE DÉU DE LA MUNTANYA,08076,080765,ESPARREGUERA,14,2,16
2018/2019,08016938,ESCOLA TAQUÍGRAF GARRIGA,08076,080765,ESPARREGUERA,24,6,30
2018/2019,08016941,ESCOLA ISIDRE MARTÍ,08077,080771,ESPLUGUES DE LLOBREGAT,23,0,23
2018/2019,08017104,ESCOLA GRAS I SOLER,08077,080771,ESPLUGUES DE LLOBREGAT,14,3,17
2018/2019,08017116,ESCOLA MATILDE ORDUÑA,08077,080771,ESPLUGUES DE LLOBREGAT,12,4,16
2018/2019,08017131,INSTITUT SEVERO OCHOA,08077,080771,ESPLUGUES DE LLOBREGAT,64,32,96
2018/2019,08017153,INSTITUT JOANOT MARTORELL,08077,080771,ESPLUGUES DE LLOBREGAT,30,17,47
2018/2019,08017207,ESCOLA MOSSÈN CINTO,08083,080832,FOLGUEROLES,21,3,24
2018/2019,08017232,ESCOLA AGRUPACIÓ SANT JORDI,08084,080847,FONOLLOSA,11,5,16
2018/2019,08017244,ESCOLA FONT-RÚBIA,08085,080850,FONT-RUBÍ,15,1,16
2018/2019,08017271,ESCOLA JOAN SANPERA I TORRAS,08086,080863,LES FRANQUESES DEL VALLÈS,27,3,30
2018/2019,08017311,ESCOLA PUIGGRACIÓS,08088,080885,LA GARRIGA,25,5,30
2018/2019,08017359,ESCOLA SALVADOR LLUCH,08089,080898,GAVÀ,28,2,30
2018/2019,08017360,ESCOLA JACME MARCH,08089,080898,GAVÀ,21,2,23
2018/2019,08017505,ESCOLA JUAN SALAMERO,08089,080898,GAVÀ,13,2,15
2018/2019,08017530,INSTITUT DE BRUGUERS,08089,080898,GAVÀ,31,22,53
2018/2019,08017611,ESCOLA MONTCAU,08091,080919,GELIDA,26,3,29
2018/2019,08017633,ESCOLA SANT MARC,08092,080924,GIRONELLA,13,1,14
2018/2019,08017645,ESCOLA DE GIRONELLA,08092,080924,GIRONELLA,13,3,16
2018/2019,08017682,ESCOLA JACINT VERDAGUER,08094,080945,LA GRANADA,13,3,16
2018/2019,08017694,ESCOLA PEREANTON,08096,080961,GRANOLLERS,13,3,16
2018/2019,08017700,ESCOLA JOAN SOLANS,08096,080961,GRANOLLERS,15,6,21
2018/2019,08017712,ESCOLA FERRER I GUÀRDIA,08096,080961,GRANOLLERS,16,3,19
2018/2019,08017918,ESCOLA GRANULLARIUS,08096,080961,GRANOLLERS,27,2,29
2018/2019,08017931,INSTITUT ANTONI CUMELLA,08096,080961,GRANOLLERS,34,21,55
2018/2019,08017979,ESCOLA AQUA ALBA,08097,080977,GUALBA,12,3,15
2018/2019,08017992,ESCOLA MONTSERRAT,08098,080983,SANT SALVADOR DE GUARDIOLA,22,2,24
2018/2019,08018005,ESCOLA SANT LLORENÇ,08099,080996,GUARDIOLA DE BERGUEDÀ,7,3,10
2018/2019,08018017,ESCOLA L'ALBIOL - ZER ALT BERGUEDÀ,08903,089030,SANT JULIÀ DE CERDANYOLA,2,0,2
2018/2019,08018029,ESCOLA LES ESCOLES,08100,081000,GURB,27,2,29
2018/2019,08018066,ESCOLA MENÉNDEZ PIDAL,08101,081017,L'HOSPITALET DE LLOBREGAT,47,7,54
2018/2019,08018078,ESCOLA BELLVITGE,08101,081017,L'HOSPITALET DE LLOBREGAT,17,2,19
2018/2019,08018091,ESCOLA PEP VENTURA,08101,081017,L'HOSPITALET DE LLOBREGAT,31,5,36
2018/2019,08018145,ESCOLA PAU VILA,08101,081017,L'HOSPITALET DE LLOBREGAT,20,3,23
2018/2019,08018157,ESCOLA SANTIAGO RAMON Y CAJAL,08101,081017,L'HOSPITALET DE LLOBREGAT,32,6,38
2018/2019,08019149,ESCOLA BERNAT METGE,08101,081017,L'HOSPITALET DE LLOBREGAT,18,5,23
2018/2019,08019198,ESCOLA POMPEU FABRA,08101,081017,L'HOSPITALET DE LLOBREGAT,28,4,32
2018/2019,08019216,ESCOLA BUSQUETS I PUNSET,08101,081017,L'HOSPITALET DE LLOBREGAT,24,4,28
2018/2019,08019231,ESCOLA MILAGROS CONSARNAU,08101,081017,L'HOSPITALET DE LLOBREGAT,28,3,31
2018/2019,08019241,ESCOLA FREDERIC MISTRAL,08101,081017,L'HOSPITALET DE LLOBREGAT,24,3,27
2018/2019,08019265,ESCOLA JOAQUIM RUYRA,08101,081017,L'HOSPITALET DE LLOBREGAT,27,9,36
2018/2019,08019277,ESCOLA LA MARINA,08101,081017,L'HOSPITALET DE LLOBREGAT,25,4,29
2018/2019,08019290,ESCOLA PROVENÇANA,08101,081017,L'HOSPITALET DE LLOBREGAT,15,2,17
2018/2019,08019307,INSTITUT SANTA EULÀLIA,08101,081017,L'HOSPITALET DE LLOBREGAT,38,16,54
2018/2019,08019319,INSTITUT PEDRAFORCA,08101,081017,L'HOSPITALET DE LLOBREGAT,62,33,95
2018/2019,08019320,INSTITUT TORRAS I BAGES,08101,081017,L'HOSPITALET DE LLOBREGAT,37,22,59
2018/2019,08019368,ESCOLA PERE LLISCART,08101,081017,L'HOSPITALET DE LLOBREGAT,33,5,38
2018/2019,08019371,INSTITUT LLOBREGAT,08101,081017,L'HOSPITALET DE LLOBREGAT,9,24,33
2018/2019,08019401,INSTITUT PROVENÇANA,08101,081017,L'HOSPITALET DE LLOBREGAT,51,35,86
2018/2019,08019411,INSTITUT BELLVITGE,08101,081017,L'HOSPITALET DE LLOBREGAT,25,14,39
2018/2019,08019435,ESCOLA GARCÍA I FOSSAS,08102,081022,IGUALADA,28,2,30
2018/2019,08019459,ESCOLA GABRIEL CASTELLA I RAICH,08102,081022,IGUALADA,20,0,20
2018/2019,08019460,ESCOLA EMILI VALLÈS,08102,081022,IGUALADA,15,2,17
2018/2019,08019630,INSTITUT PERE VIVES I VICH,08102,081022,IGUALADA,39,29,68
2018/2019,08019642,ESCOLA PARE RAMON CASTELLTORT I MIRALDA,08102,081022,IGUALADA,28,2,30
2018/2019,08019654,INSTITUT MILÀ I FONTANALS,08102,081022,IGUALADA,58,63,121
2018/2019,08019678,ESCOLA GUERAU DE JORBA,08103,081038,JORBA,11,0,11
2018/2019,08019691,ESCOLA VILADEMÀGER - ZER SERRA D'ANCOSA,08104,081043,LA LLACUNA,4,1,5
2018/2019,08019711,ESCOLA SAGRADA FAMÍLIA,08105,081056,LA LLAGOSTA,20,5,25
2018/2019,08019745,ESCOLA JOAN MARAGALL,08105,081056,LA LLAGOSTA,24,6,30
2018/2019,08019782,ESCOLA SALVADOR SANROMÀ,08106,081069,LLINARS DEL VALLÈS,25,3,28
2018/2019,08019824,ESCOLA LES LLISSES,08108,081081,LLIÇÀ DE VALL,19,5,24
2018/2019,08019861,ESCOLA GAFARRÓ - ZER ALT LLUÇANÈS,08109,081094,LLUÇÀ,5,0,5
2018/2019,08019873,ESCOLA MARE DE DÉU DE MONTSERRAT,08110,081108,MALGRAT DE MAR,12,4,16
2018/2019,08019927,ESCOLA MARIÀ CUBÍ I SOLER,08110,081108,MALGRAT DE MAR,23,6,29
2018/2019,08019940,ESCOLA PUIG-AGUT,08112,081120,MANLLEU,31,4,35
2018/2019,08020012,ESCOLA MUNTANYA DEL DRAC,08113,081136,MANRESA,13,1,14
2018/2019,08020061,ESCOLA LA RENAIXENÇA,08113,081136,MANRESA,18,4,22
2018/2019,08020073,ESCOLA SANT IGNASI,08113,081136,MANRESA,30,5,35
2018/2019,08020097,ESCOLA PARE ALGUÉ,08113,081136,MANRESA,17,6,23
2018/2019,08020127,ESCOLA BAGES,08113,081136,MANRESA,29,2,31
2018/2019,08020462,INSTITUT LACETÀNIA,08113,081136,MANRESA,55,76,131
2018/2019,08020474,INSTITUT LLUÍS DE PEGUERA,08113,081136,MANRESA,56,28,84
2018/2019,08020498,ESCOLA ELS CONVENTS,08114,081141,MARTORELL,16,1,17
2018/2019,08020516,CEE EL PONTARRÓ,08114,081141,MARTORELL,28,1,29
2018/2019,08020607,ESCOLA JUAN RAMÓN JIMÉNEZ,08114,081141,MARTORELL,26,3,29
2018/2019,08020619,ESCOLA JOSÉ ECHEGARAY,08114,081141,MARTORELL,28,4,32
2018/2019,08020620,INSTITUT POMPEU FABRA,08114,081141,MARTORELL,42,37,79
2018/2019,08020656,ESCOLA SIMEÓ RABASA,08115,081154,MARTORELLES,13,2,15
2018/2019,08020701,ESCOLA COMTES DE LACAMBRA,08117,081173,LES MASIES DE VOLTREGÀ,10,3,13
2018/2019,08020723,ESCOLA OCATA,08118,081189,EL MASNOU,14,2,16
2018/2019,08020826,INSTITUT MAREMAR,08118,081189,EL MASNOU,36,20,56
2018/2019,08020838,INSTITUT MEDITERRÀNIA,08118,081189,EL MASNOU,18,22,40
2018/2019,08020841,ESCOLA EL TURÓ,08119,081192,MASQUEFA,27,6,33
2018/2019,08020863,ESCOLA GINESTA,08120,081206,MATADEPERA,26,1,27
2018/2019,08020905,ESCOLA ANGELETA FERRER,08121,081213,MATARÓ,16,2,18
2018/2019,08020917,ESCOLA JOSEP MANUEL PERAMÀS,08121,081213,MATARÓ,28,4,32
2018/2019,08020929,ESCOLA GERMANES BERTOMEU,08121,081213,MATARÓ,30,5,35
2018/2019,08021041,ESCOLA JOSEP MONTSERRAT,08121,081213,MATARÓ,15,3,18
2018/2019,08021260,INSTITUT ALEXANDRE SATORRAS,08121,081213,MATARÓ,58,28,86
2018/2019,08021302,INSTITUT DAMIÀ CAMPENY,08121,081213,MATARÓ,35,25,60
2018/2019,08021326,ESCOLA LA FASSINA,08122,081228,MEDIONA,8,2,10
2018/2019,08021351,ESCOLA EL PALAU,08123,081234,MOLINS DE REI,15,1,16
2018/2019,08021363,ESCOLA L'ALZINA,08123,081234,MOLINS DE REI,15,2,17
2018/2019,08021430,INSTITUT LLUÍS DE REQUESENS,08123,081234,MOLINS DE REI,45,22,67
2018/2019,08021442,ESCOLA CASTELL CIURÓ,08123,081234,MOLINS DE REI,21,6,27
2018/2019,08021466,ESCOLA COL·LEGIS NOUS,08124,081249,MOLLET DEL VALLÈS,26,1,27
2018/2019,08021570,ESCOLA DEL BOSC,08124,081249,MOLLET DEL VALLÈS,14,4,18
2018/2019,08021582,ESCOLA JOAN SALVAT PAPASSEIT,08124,081249,MOLLET DEL VALLÈS,11,5,16
2018/2019,08021594,INSTITUT DE MOLLET DEL VALLÈS,08124,081249,MOLLET DEL VALLÈS,37,59,96
2018/2019,08021600,INSTITUT VICENÇ PLANTADA,08124,081249,MOLLET DEL VALLÈS,41,30,71
2018/2019,08021636,ESCOLA EL VIVER,08125,081252,MONTCADA I REIXAC,31,4,35
2018/2019,08021685,ESCOLA FONT FREDA,08125,081252,MONTCADA I REIXAC,15,1,16
2018/2019,08021764,ESCOLA MITJA COSTA,08125,081252,MONTCADA I REIXAC,13,3,16
2018/2019,08021788,INSTITUT MONTSERRAT MIRÓ I VILA,08125,081252,MONTCADA I REIXAC,32,21,53
2018/2019,08021880,ESCOLA SALVADOR ESPRIU,08126,081265,MONTGAT,27,2,29
2018/2019,08021892,ESCOLA SANT PERE,08127,081271,MONISTROL DE MONTSERRAT,14,2,16
2018/2019,08021934,ESCOLA L'ESQUEIX - ZER EL MOIANÈS PONENT,08128,081287,MONISTROL DE CALDERS,3,1,4
2018/2019,08021961,ESCOLA EL ROCAL - ZER ELS CASTELLS,08131,081311,MONTESQUIU,9,1,10
2018/2019,08021983,ESCOLA GIRA-SOL - ZER BAIX BERGUEDÀ,08132,081326,MONTMAJOR,6,0,6
2018/2019,08022008,ESCOLA MONTMANY,08134,081347,FIGARÓ-MONTMANY,9,1,10
2018/2019,08022011,ESCOLA PAU CASALS,08135,081350,MONTMELÓ,22,2,24
2018/2019,08022045,ESCOLA SANT JORDI,08135,081350,MONTMELÓ,26,3,29
2018/2019,08022057,ESCOLA SANT SADURNÍ,08136,081363,MONTORNÈS DEL VALLÈS,12,3,15
2018/2019,08022070,ESCOLA MARINADA,08136,081363,MONTORNÈS DEL VALLÈS,29,4,33
2018/2019,08022082,ESCOLA PUIG DRAU - ZER BAIX MONTSENY,08137,081379,MONTSENY,4,0,4
2018/2019,08022094,ESCOLA JOSEP ORRIOLS I ROCA,08138,081385,MOIÀ,25,2,27
2018/2019,08022197,ESCOLA CATALUNYA,08140,081402,NAVARCLES,23,10,33
2018/2019,08022321,ESCOLA CASTELL D'ÒDENA,08143,081430,ÒDENA,23,3,26
2018/2019,08022331,ESCOLA D'OLVAN - ZER BAIX BERGUEDÀ,08144,081445,OLVAN,7,0,7
2018/2019,08022343,ESCOLA CIRCELL,08145,081458,OLÈRDOLA,16,3,19
2018/2019,08022367,ESCOLA ROSSEND MONTANÉ,08145,081458,OLÈRDOLA,14,3,17
2018/2019,08022379,ESCOLA PONT DE L'ARCADA,08146,081461,OLESA DE BONESVALLS,11,2,13
2018/2019,08022380,ESCOLA MARE DE DÉU DE MONTSERRAT,08147,081477,OLESA DE MONTSERRAT,24,2,26
2018/2019,08022461,ESCOLA SANT BERNAT,08147,081477,OLESA DE MONTSERRAT,25,4,29
2018/2019,08022495,ESCOLA TERRA NOSTRA,08149,081496,OLOST,11,1,12
2018/2019,08022549,ESCOLA LLEVANT - ZER GAVARRESA,08151,081516,ORISTÀ,4,0,4
2018/2019,08022574,ESCOLA FRANCESC MACIÀ,08153,081537,ÒRRIUS,9,3,12
2018/2019,08022586,ESCOLA EL DRAC,08154,081542,PACS DEL PENEDÈS,10,1,11
2018/2019,08022598,ESCOLA LES FERRERIES DE PALAFOLLS,08155,081555,PALAFOLLS,28,4,32
2018/2019,08022616,ESCOLA JOSEP MARIA FOLCH I TORRES,08156,081568,PALAU-SOLITÀ I PLEGAMANS,19,2,21
2018/2019,08022665,ESCOLA ÀNGEL GUIMERÀ,08157,081574,PALLEJÀ,17,5,22
2018/2019,08022677,ESCOLA JACINT VERDAGUER,08157,081574,PALLEJÀ,16,2,18
2018/2019,08022689,ESCOLA PAU VILA,08158,081580,EL PAPIOL,26,3,29
2018/2019,08022690,ESCOLA LLUÍS PIQUER,08159,081593,PARETS DEL VALLÈS,27,3,30
2018/2019,08022707,ESCOLA POMPEU FABRA,08159,081593,PARETS DEL VALLÈS,15,2,17
2018/2019,08022768,ESCOLA HEROIS DEL BRUC,08161,081614,PIERA,30,6,36
2018/2019,08022793,ESCOLA RENAIXENÇA,08162,081629,ELS HOSTALETS DE PIEROLA,24,3,27
2018/2019,08022801,ESCOLA ANTONI DOLTRA,08163,081635,PINEDA DE MAR,18,2,20
2018/2019,08022835,ESCOLA JAUME I,08163,081635,PINEDA DE MAR,22,4,26
2018/2019,08022847,ESCOLA SANTS ABDÓ I SENÉN,08164,081640,EL PLA DEL PENEDÈS,10,3,13
2018/2019,08022859,ESCOLA MARIA BORÉS,08165,081653,LA POBLA DE CLARAMUNT,14,3,17
2018/2019,08022860,ESCOLA LILLET A. GÜELL,08166,081666,LA POBLA DE LILLET,5,3,8
2018/2019,08022872,ESCOLA PERE CALDERS,08167,081672,POLINYÀ,22,7,29
2018/2019,08022884,ESCOLA JOAN MARAGALL,08169,081691,EL PRAT DE LLOBREGAT,17,1,18
2018/2019,08022902,ESCOLA DEL PARC,08169,081691,EL PRAT DE LLOBREGAT,29,2,31
2018/2019,08022914,ESCOLA JAUME BALMES,08169,081691,EL PRAT DE LLOBREGAT,31,2,33
2018/2019,08022926,CEE CAN RIGOL,08169,081691,EL PRAT DE LLOBREGAT,27,4,31
2018/2019,08022938,ESCOLA JACINT VERDAGUER,08169,081691,EL PRAT DE LLOBREGAT,29,2,31
2018/2019,08023131,INSTITUT BALDIRI GUILERA,08169,081691,EL PRAT DE LLOBREGAT,44,19,63
2018/2019,08023141,ESCOLA MARE DE DÉU DEL PORTAL - ZER VENT D'AVALL,08170,081705,ELS PRATS DE REI,5,1,6
2018/2019,08023207,ESCOLA LLUÇANÈS,08171,081712,PRATS DE LLUÇANÈS,16,1,17
2018/2019,08023232,ESCOLA SANT CRISTÒFOL,08172,081727,PREMIÀ DE MAR,21,4,25
2018/2019,08023335,ESCOLA MONTSERRAT,08172,081727,PREMIÀ DE MAR,19,6,25
2018/2019,08023359,ESCOLA VIROLAI - ZER CEP DE SIS,08174,081748,PUIGDÀLBER,3,2,5
2018/2019,08023372,ESCOLA ALFRED MATA,08175,081751,PUIG-REIG,15,1,16
2018/2019,08023426,ESCOLA GASSÓ I VIDAL,08180,081803,RIPOLLET,14,1,15
2018/2019,08023542,ESCOLA TIANA DE LA RIBA,08180,081803,RIPOLLET,16,4,20
2018/2019,08023554,ESCOLA JOSEP MARIA GINESTA,08180,081803,RIPOLLET,29,1,30
2018/2019,08023566,ESCOLA ANSELM CLAVÉ,08180,081803,RIPOLLET,26,3,29
2018/2019,08023591,ESCOLA PILAR MESTRES-JAUME TORRENS,08181,081810,LA ROCA DEL VALLÈS,15,4,19
2018/2019,08023657,ESCOLA POMPEU FABRA,08182,081825,EL PONT DE VILOMARA I ROCAFORT,21,6,27
2018/2019,08023669,ESCOLA MARE DE DÉU DEL SÒL DEL PONT,08183,081831,RODA DE TER,26,4,30
2018/2019,08023852,ESCOLA JOAN MARAGALL,08184,081846,RUBÍ,20,2,22
2018/2019,08023918,ESCOLA CONCÒRDIA,08187,081878,SABADELL,27,2,29
2018/2019,08023921,ESCOLA ESPRONCEDA,08187,081878,SABADELL,28,3,31
2018/2019,08023931,ESCOLA ENRIC CASASSAS,08187,081878,SABADELL,13,2,15
2018/2019,08023943,ESCOLA GAUDÍ,08187,081878,SABADELL,18,1,19
2018/2019,08023955,ESCOLA CIFUENTES,08187,081878,SABADELL,25,6,31
2018/2019,08023979,ESCOLA JOAN MONTLLOR,08187,081878,SABADELL,13,6,19
2018/2019,08023980,ESCOLA JUAN RAMÓN JIMÉNEZ,08187,081878,SABADELL,15,2,17
2018/2019,08023992,ESCOLA JOAN SALLARÈS I PLA,08187,081878,SABADELL,22,5,27
2018/2019,08024005,ESCOLA JOAN MARAGALL,08187,081878,SABADELL,24,3,27
2018/2019,08024017,ESCOLA MIQUEL CARRERAS,08187,081878,SABADELL,18,5,23
2018/2019,08024030,ESCOLA SAMUNTADA,08187,081878,SABADELL,17,2,19
2018/2019,08024042,ESCOLA LA ROMÀNICA,08187,081878,SABADELL,24,5,29
2018/2019,08024066,ESCOLA ALCALDE MARCET,08187,081878,SABADELL,16,2,18
2018/2019,08024741,INSTITUT ESCOLA INDUSTRIAL,08187,081878,SABADELL,49,64,113
2018/2019,08024765,INSTITUT ARRAONA,08187,081878,SABADELL,26,18,44
2018/2019,08024777,INSTITUT EGARA,08279,082798,TERRASSA,26,14,40
2018/2019,08024789,CEE FRANCESC BELLAPART,08187,081878,SABADELL,33,6,39
2018/2019,08024790,ESCOLA ROUREDA,08187,081878,SABADELL,25,4,29
2018/2019,08024807,ESCOLA AGNÈS ARMENGOL,08187,081878,SABADELL,18,4,22
2018/2019,08024819,ESCOLA CALVET D'ESTRELLA,08187,081878,SABADELL,15,3,18
2018/2019,08024820,ESCOLA PAU CASALS,08187,081878,SABADELL,24,4,28
2018/2019,08024832,ESCOLA FLORESTA,08187,081878,SABADELL,16,3,19
2018/2019,08024844,ESCOLA TORREGUITART,08187,081878,SABADELL,15,2,17
2018/2019,08024856,ESCOLA FONT ROSELLA,08187,081878,SABADELL,21,6,27
2018/2019,08024871,INSTITUT PAU VILA,08187,081878,SABADELL,44,27,71
2018/2019,08024881,INSTITUT FERRAN CASABLANCAS,08187,081878,SABADELL,40,49,89
2018/2019,08024893,INSTITUT CASTELLARNAU,08187,081878,SABADELL,45,48,93
2018/2019,08024972,ESCOLA TORRES AMAT,08191,081918,SALLENT,25,3,28
2018/2019,08025058,ESCOLA RIU D'OR,08192,081923,SANTPEDOR,22,6,28
2018/2019,08025071,ESCOLA DONES D'AIGUA,08193,081939,SANT ISCLE DE VALLALTA,12,2,14
2018/2019,08025083,ESCOLA POMPEU FABRA,08194,081944,SANT ADRIÀ DE BESÒS,26,8,34
2018/2019,08025241,ESCOLA JOAN MARAGALL,08196,081960,SANT ANDREU DE LA BARCA,13,3,16
2018/2019,08025265,ESCOLA ÀNGEL GUIMERÀ,08196,081960,SANT ANDREU DE LA BARCA,27,6,33
2018/2019,08025319,ESCOLA JOAN CASAS,08198,081982,SANT ANTONI DE VILAMAJOR,25,2,27
2018/2019,08025320,ESCOLA LA MONJOIA,08199,081995,SANT BARTOMEU DEL GRAU,9,1,10
2018/2019,08025344,ESCOLA AMAT VERDÚ,08200,082009,SANT BOI DE LLOBREGAT,19,5,24
2018/2019,08025526,ESCOLA CIUTAT COOPERATIVA,08200,082009,SANT BOI DE LLOBREGAT,13,3,16
2018/2019,08025587,ESCOLA CASABLANCA,08200,082009,SANT BOI DE LLOBREGAT,29,3,32
2018/2019,08025599,ESCOLA MARIANAO,08200,082009,SANT BOI DE LLOBREGAT,16,1,17
2018/2019,08025605,INSTITUT CAMPS BLANCS,08200,082009,SANT BOI DE LLOBREGAT,78,43,121
2018/2019,08025642,ESCOLA JOSEP MARIA CIURANA,08200,082009,SANT BOI DE LLOBREGAT,27,2,29
2018/2019,08025654,INSTITUT JOAQUIM RUBIÓ I ORS,08200,082009,SANT BOI DE LLOBREGAT,39,23,62
2018/2019,08025666,ESCOLA AURORA - ZER ALT LLUÇANÈS,08201,082016,SANT BOI DE LLUÇANÈS,4,1,5
2018/2019,08025770,ESCOLA JOSEP PALLEROLA I ROCA,08202,082021,SANT CELONI,31,5,36
2018/2019,08025800,ESCOLA EL PI GROS,08203,082037,SANT CEBRIÀ DE VALLALTA,20,3,23
2018/2019,08025812,ESCOLA SANT CLIMENT,08204,082042,SANT CLIMENT DE LLOBREGAT,29,3,32
2018/2019,08025824,ESCOLA LA FLORESTA,08205,082055,SANT CUGAT DEL VALLÈS,15,3,18
2018/2019,08025927,ESCOLA PI D'EN XANDRI,08205,082055,SANT CUGAT DEL VALLÈS,28,2,30
2018/2019,08026026,ESCOLA PINS DEL VALLÈS,08205,082055,SANT CUGAT DEL VALLÈS,26,4,30
2018/2019,08026087,ESCOLA JAUME FERRAN I CLUA,08205,082055,SANT CUGAT DEL VALLÈS,27,2,29
2018/2019,08026099,ESCOLA LES VINYES,08206,082068,SANT CUGAT SESGARRIGUES,13,2,15
2018/2019,08026117,ESCOLA VALLMANYA,08207,082074,SANT ESTEVE DE PALAUTORDERA,27,2,29
2018/2019,08026130,ESCOLA LA ROUREDA,08208,082080,SANT ESTEVE SESROVIRES,24,3,27
2018/2019,08026154,ESCOLA JOAQUIM ABRIL,08209,082093,SANT FOST DE CAMPSENTELLES,24,2,26
2018/2019,08026208,ESCOLA JAUME BALMES,08210,082107,SANT FELIU DE CODINES,21,7,28
2018/2019,08026211,ESCOLA NADAL,08211,082114,SANT FELIU DE LLOBREGAT,24,5,29
2018/2019,08026221,ESCOLA FALGUERA,08211,082114,SANT FELIU DE LLOBREGAT,11,6,17
2018/2019,08026373,ESCOLA JOSEP MONMANY AMAT,08211,082114,SANT FELIU DE LLOBREGAT,19,5,24
2018/2019,08026385,ESCOLA ARQUITECTE GAUDÍ,08211,082114,SANT FELIU DE LLOBREGAT,18,3,21
2018/2019,08026397,INSTITUT OLORDA,08211,082114,SANT FELIU DE LLOBREGAT,49,17,66
2018/2019,08026415,ESCOLA ELS ROURES - ZER GAVARRESA,08212,082129,SANT FELIU SASSERRA,5,2,7
2018/2019,08026464,ESCOLA MONSENYOR GIBERT,08213,082135,SANT FRUITÓS DE BAGES,23,4,27
2018/2019,08026476,ESCOLA FRANCESC MACIÀ,08214,082140,VILASSAR DE DALT,25,6,31
2018/2019,08026521,ESCOLA ABAT OLIBA,08215,082153,SANT HIPÒLIT DE VOLTREGÀ,13,2,15
2018/2019,08026567,ESCOLA SANT FRANCESC D'ASSÍS,08217,082172,SANT JOAN DESPÍ,26,5,31
2018/2019,08026661,ESCOLA PAU CASALS,08217,082172,SANT JOAN DESPÍ,25,3,28
2018/2019,08026671,ESCOLA JOAN PERICH I VALLS,08217,082172,SANT JOAN DESPÍ,18,2,20
2018/2019,08026683,INSTITUT FRANCESC FERRER I GUÀRDIA,08217,082172,SANT JOAN DESPÍ,57,25,82
2018/2019,08026725,ESCOLA JONCADELLA,08218,082188,SANT JOAN DE VILATORRADA,27,1,28
2018/2019,08026749,ESCOLA PÉREZ SALA,08219,082191,VILASSAR DE MAR,18,9,27
2018/2019,08026786,ESCOLA BELLPUIG,08220,082205,SANT JULIÀ DE VILATORTA,15,2,17
2018/2019,08026816,ESCOLA MONTSERRAT,08221,082212,SANT JUST DESVERN,22,4,26
2018/2019,08026889,ESCOLA VINYES VERDES,08119,081192,MASQUEFA,12,3,15
2018/2019,08026907,ESCOLA PAU CASALS,08222,082227,SANT LLORENÇ D'HORTONS,15,2,17
2018/2019,08026919,ESCOLA JOSEP GRAS,08223,082233,SANT LLORENÇ SAVALL,15,0,15
2018/2019,08026956,ESCOLA CÉRVOLA BLANCA,08226,082264,SANT MARTÍ DE TOUS,14,2,16
2018/2019,08027018,ESCOLA JAUME BALMES,08227,082270,SANT MARTÍ SARROCA,19,5,24
2018/2019,08027021,ESCOLA FONT DE L'ANOIA - ZER VENT D'AVALL,08228,082286,SANT MARTÍ SESGUEIOLES,4,0,4
2018/2019,08027110,ESCOLA EL PI,08231,082310,SANT PERE DE RIBES,15,1,16
2018/2019,08027134,ESCOLA LES ROQUETES,08231,082310,SANT PERE DE RIBES,18,6,24
2018/2019,08027146,ESCOLA SANT JERONI,08232,082325,SANT PERE DE RIUDEBITLLES,17,2,19
2018/2019,08027171,ESCOLA JOSEP MARIA XANDRI,08233,082331,SANT PERE DE TORELLÓ,11,4,15
2018/2019,08027183,ESCOLA TORRE ROJA,08234,082346,SANT PERE DE VILAMAJOR,23,6,29
2018/2019,08027225,ESCOLA SANT PAU,08235,082359,SANT POL DE MAR,27,5,32
2018/2019,08027237,ESCOLA ANTONI GRAU MINGUELL,08236,082362,SANT QUINTÍ DE MEDIONA,16,2,18
2018/2019,08027249,ESCOLA SEGIMON COMAS,08237,082378,SANT QUIRZE DE BESORA,13,2,15
2018/2019,08027432,ESCOLA WAGNER,08245,082457,SANTA COLOMA DE GRAMENET,17,4,21
2018/2019,08027456,ESCOLA FERRAN DE SAGARRA,08245,082457,SANTA COLOMA DE GRAMENET,36,4,40
2018/2019,08027468,ESCOLA PALLARESA,08245,082457,SANTA COLOMA DE GRAMENET,25,6,31
2018/2019,08027471,ESCOLA SANT JUST,08245,082457,SANTA COLOMA DE GRAMENET,26,4,30
2018/2019,08027511,ESCOLA TORRE BALLDOVINA,08245,082457,SANTA COLOMA DE GRAMENET,24,7,31
2018/2019,08027870,ESCOLA LES PALMERES,08245,082457,SANTA COLOMA DE GRAMENET,26,3,29
2018/2019,08027936,ESCOLA LLUÍS MILLET,08245,082457,SANTA COLOMA DE GRAMENET,12,4,16
2018/2019,08027973,ESCOLA BEETHOVEN,08245,082457,SANTA COLOMA DE GRAMENET,20,2,22
2018/2019,08027985,ESCOLA JAUME SALVATELLA,08245,082457,SANTA COLOMA DE GRAMENET,24,6,30
2018/2019,08028035,ESCOLA AUSIÀS MARCH,08245,082457,SANTA COLOMA DE GRAMENET,14,4,18
2018/2019,08028047,INSTITUT PUIG CASTELLAR,08245,082457,SANTA COLOMA DE GRAMENET,49,36,85
2018/2019,08028059,ESCOLA JACINT VERDAGUER,08246,082460,SANTA EUGÈNIA DE BERGA,14,3,17
2018/2019,08028072,ESCOLA EL ROURE GROS,08247,082476,SANTA EULÀLIA DE RIUPRIMER,12,2,14
2018/2019,08028102,ESCOLA RONÇANA,08248,082482,SANTA EULÀLIA DE RONÇANA,23,1,24
2018/2019,08028151,ESCOLA LES MORERES - ZER CEP DE SIS,08249,082495,SANTA FE DEL PENEDÈS,5,0,5
2018/2019,08028163,ESCOLA MONTBOU,08250,082508,SANTA MARGARIDA DE MONTBUI,12,4,16
2018/2019,08028217,ESCOLA DOCTOR SAMARANCH I FINA,08251,082515,SANTA MARGARIDA I ELS MONJOS,26,2,28
2018/2019,08028229,ESCOLA ELISA BADIA,08252,082520,BARBERÀ DEL VALLÈS,24,5,29
2018/2019,08028254,ESCOLA CAN LLOBET,08252,082520,BARBERÀ DEL VALLÈS,28,2,30
2018/2019,08028333,ESCOLA EL CABRERÈS,08254,082541,L'ESQUIROL,13,3,16
2018/2019,08028345,ESCOLA LES MIMOSES,08256,082567,SANTA MARIA DE MARTORELLES,11,3,14
2018/2019,08028382,ESCOLA SESMON D'OLÓ,08258,082589,SANTA MARIA D'OLÓ,10,1,11
2018/2019,08028424,ESCOLA FONTMARTINA,08259,082592,SANTA MARIA DE PALAUTORDERA,22,2,24
2018/2019,08028436,ESCOLA LA FLORIDA,08260,082606,SANTA PERPÈTUA DE MOGODA,26,2,28
2018/2019,08028497,ESCOLA SANTA PERPÈTUA,08260,082606,SANTA PERPÈTUA DE MOGODA,22,4,26
2018/2019,08028515,ESCOLA SANTA SUSANNA,08261,082613,SANTA SUSANNA,13,4,17
2018/2019,08028576,ESCOLA SANT VICENÇ,08262,082628,SANT VICENÇ DE CASTELLET,28,6,34
2018/2019,08028588,ESCOLA SANT JORDI,08263,082634,SANT VICENÇ DELS HORTS,15,2,17
2018/2019,08028591,ESCOLA LA VINYALA,08263,082634,SANT VICENÇ DELS HORTS,24,1,25
2018/2019,08028667,ESCOLA JOAN JUNCADELLA,08263,082634,SANT VICENÇ DELS HORTS,29,1,30
2018/2019,08028709,ESCOLA LLORIANA,08265,082652,SANT VICENÇ DE TORELLÓ,13,1,14
2018/2019,08028746,ESCOLA SANT MARTÍ,08266,082665,CERDANYOLA DEL VALLÈS,15,3,18
2018/2019,08028758,ESCOLA LES FONTETES,08266,082665,CERDANYOLA DEL VALLÈS,11,4,15
2018/2019,08028783,ESCOLA SERRAPARERA,08266,082665,CERDANYOLA DEL VALLÈS,26,2,28
2018/2019,08028904,ESCOLA CARLES BUÏGAS,08266,082665,CERDANYOLA DEL VALLÈS,22,0,22
2018/2019,08028916,ESCOLA LAS SEGUIDILLAS,08904,089045,BADIA DEL VALLÈS,32,5,37
2018/2019,08028928,ESCOLA LA JOTA,08904,089045,BADIA DEL VALLÈS,27,7,34
2018/2019,08028941,ESCOLA LA SARDANA,08904,089045,BADIA DEL VALLÈS,26,3,29
2018/2019,08028990,ESCOLA CAN SORTS,08267,082671,SENTMENAT,34,9,43
2018/2019,08029015,ESCOLA SANT SALVADOR,08268,082687,CERCS,10,0,10
2018/2019,08029027,ESCOLA FARIGOLA,08269,082690,SEVA,14,1,15
2018/2019,08029088,ESCOLA MIQUEL UTRILLO,08270,082704,SITGES,22,9,31
2018/2019,08029143,ESCOLA SUBIRATS - ZER SUBIRATS,08273,082732,SUBIRATS,9,1,10
2018/2019,08029155,ESCOLA EL MONTCAU - ZER SUBIRATS,08273,082732,SUBIRATS,7,1,8
2018/2019,08029192,ESCOLA SANT JORDI - ZER SUBIRATS,08273,082732,SUBIRATS,12,1,13
2018/2019,08029209,ESCOLA MARE DE DÉU DE MONTSERRAT,08274,082747,SÚRIA,12,2,14
2018/2019,08029222,ESCOLA FRANCESC MACIÀ,08274,082747,SÚRIA,16,0,16
2018/2019,08029283,ESCOLA EL GURRI - ZER GUILLERIES,08278,082785,TARADELL,4,0,4
2018/2019,08029301,ESCOLA LES PINEDIQUES,08278,082785,TARADELL,25,4,29
2018/2019,08029350,ESCOLA FRANÇA,08279,082798,TERRASSA,25,6,31
2018/2019,08029374,ESCOLA BISBAT D'EGARA,08279,082798,TERRASSA,40,3,43
2018/2019,08029386,ESCOLA RAMÓN Y CAJAL,08279,082798,TERRASSA,24,6,30
2018/2019,08029507,ESCOLA ISAAC PERAL,08279,082798,TERRASSA,16,1,17
2018/2019,08030194,ESCOLA PERE VIVER I AYMERICH,08279,082798,TERRASSA,24,4,28
2018/2019,08030200,ESCOLA MARIÀ GALÍ GUIX,08279,082798,TERRASSA,23,3,26
2018/2019,08030212,ESCOLA JOSEP VENTALLÓ I VINTRÓ,08279,082798,TERRASSA,21,0,21
2018/2019,08030224,ESCOLA ANTONI UBACH I SOLER,08279,082798,TERRASSA,30,4,34
2018/2019,08030248,ESCOLA PAU VILA I DINARÈS,08279,082798,TERRASSA,34,4,38
2018/2019,08030285,ESCOLA PRESIDENT SALVANS,08279,082798,TERRASSA,23,6,29
2018/2019,08030297,ESCOLA SALVADOR VINYALS I GALÍ,08279,082798,TERRASSA,19,3,22
2018/2019,08030315,ESCOLA JOAN XXIII,08279,082798,TERRASSA,24,5,29
2018/2019,08030339,INSTITUT DE TERRASSA,08279,082798,TERRASSA,93,52,145
2018/2019,08030340,INSTITUT INVESTIGADOR BLANXART,08279,082798,TERRASSA,43,29,72
2018/2019,08030364,ESCOLA EL CIM,08281,082819,TEIÀ,23,8,31
2018/2019,08030388,ESCOLA LOLA ANGLADA,08282,082824,TIANA,25,4,29
2018/2019,08030421,ESCOLA L'ERA DE DALT,08283,082830,TONA,27,6,33
2018/2019,08030467,ESCOLA IGNASI IGLESIAS,08284,082845,TORDERA,25,5,30
2018/2019,08030510,ESCOLA DOCTOR FORTIÀ I SOLÀ,08285,082858,TORELLÓ,29,1,30
2018/2019,08030522,ESCOLA VALL DEL GES,08285,082858,TORELLÓ,16,0,16
2018/2019,08030583,ESCOLA LA TORRE,08286,082861,LA TORRE DE CLARAMUNT,14,1,15
2018/2019,08030595,ESCOLA TORRESCASANA,08286,082861,LA TORRE DE CLARAMUNT,13,2,15
2018/2019,08030613,ESCOLA J.J. RÀFOLS,08287,082877,TORRELAVIT,11,3,14
2018/2019,08030637,ESCOLA GUERAU DE PEGUERA,08288,082883,TORRELLES DE FOIX,12,4,16
2018/2019,08030649,ESCOLA SANT MARTÍ,08289,082896,TORRELLES DE LLOBREGAT,24,4,28
2018/2019,08030662,ESCOLA SERRALAVELLA,08290,082900,ULLASTRELL,19,4,23
2018/2019,08030686,ESCOLA PAU CASALS,08291,082917,VACARISSES,23,3,26
2018/2019,08030698,ESCOLA JOSEP MASCLANS,08292,082922,VALLBONA D'ANOIA,12,3,15
2018/2019,08030728,ESCOLA SERRAT VOLTOR - ZER ALT BERGUEDÀ,08293,082938,VALLCEBRE,2,0,2
2018/2019,08030789,ESCOLA POMPEU FABRA,08295,082956,VALLIRANA,20,2,22
2018/2019,08030807,ESCOLA ELS TRES PINS,08296,082969,VALLROMANES,20,1,21
2018/2019,08030819,ESCOLA SENTFORES,08298,082981,VIC,16,1,17
2018/2019,08031009,ESCOLA DOCTOR JOAQUIM SALARICH,08298,082981,VIC,31,5,36
2018/2019,08031022,INSTITUT DE VIC,08298,082981,VIC,76,58,134
2018/2019,08031034,INSTITUT JAUME CALLÍS,08298,082981,VIC,43,18,61
2018/2019,08031046,ESCOLA SERRA DE PICAMILL - ZER BERGUEDÀ CENTRE,08299,082994,VILADA,3,0,3
2018/2019,08031061,ESCOLA ROSELLA,08300,083008,VILADECAVALLS,27,4,31
2018/2019,08031083,ESCOLA ÀNGELA ROCA,08301,083015,VILADECANS,25,2,27
2018/2019,08031101,ESCOLA MONTSERRATINA,08301,083015,VILADECANS,26,4,30
2018/2019,08031204,ESCOLA EL GARROFER,08301,083015,VILADECANS,25,4,29
2018/2019,08031228,INSTITUT TORRE ROJA,08301,083015,VILADECANS,57,35,92
2018/2019,08031277,ESCOLA JOAN MARAGALL,08302,083020,VILANOVA DEL CAMÍ,32,5,37
2018/2019,08031290,ESCOLA LES ROQUES,08303,083036,VILANOVA DE SAU,4,1,5
2018/2019,08031319,ESCOLA LLEBEIG,08304,083041,VILOBÍ DEL PENEDÈS,12,3,15
2018/2019,08031320,ESCOLA ESTALELLA I GRAELLS,08305,083054,VILAFRANCA DEL PENEDÈS,26,4,30
2018/2019,08031332,ESCOLA JOSEP BALTÀ I ELIAS,08305,083054,VILAFRANCA DEL PENEDÈS,30,3,33
2018/2019,08031459,INSTITUT EUGENI D'ORS,08305,083054,VILAFRANCA DEL PENEDÈS,55,45,100
2018/2019,08031460,ESCOLA TRENTAPASSES,08306,083067,VILALBA SASSERRA,13,2,15
2018/2019,08031472,ESCOLA POMPEU FABRA,08307,083073,VILANOVA I LA GELTRÚ,23,5,28
2018/2019,08031484,ESCOLA GINESTA,08307,083073,VILANOVA I LA GELTRÚ,25,7,32
2018/2019,08031666,ESCOLA CANIGÓ,08307,083073,VILANOVA I LA GELTRÚ,23,4,27
2018/2019,08031681,INSTITUT FRANCESC XAVIER LLUCH I RAFECAS,08307,083073,VILANOVA I LA GELTRÚ,40,45,85
2018/2019,08031711,INSTITUT MANUEL DE CABANYES,08307,083073,VILANOVA I LA GELTRÚ,49,25,74
2018/2019,08031757,INSTITUT FORAT DEL VENT,08266,082665,CERDANYOLA DEL VALLÈS,44,19,63
2018/2019,08031770,INSTITUT CAN JOFRESA,08279,082798,TERRASSA,37,17,54
2018/2019,08031794,ESCOLA PALMA DE MALLORCA,08019,080193,BARCELONA,20,1,21
2018/2019,08031800,ESCOLA PAU CASALS,08019,080193,BARCELONA,13,5,18
2018/2019,08031812,INSTITUT VALLDEMOSSA,08019,080193,BARCELONA,30,15,45
2018/2019,08031836,INSTITUT ILLA DELS BANYOLS,08169,081691,EL PRAT DE LLOBREGAT,7,45,52
2018/2019,08031861,INSTITUT LEONARDO DA VINCI,08205,082055,SANT CUGAT DEL VALLÈS,59,29,88
2018/2019,08031873,INSTITUT ARNAU CADELL,08205,082055,SANT CUGAT DEL VALLÈS,35,24,59
2018/2019,08032300,ESCOLA FRAY LUIS DE LEÓN,08245,082457,SANTA COLOMA DE GRAMENET,31,3,34
2018/2019,08032312,ESCOLA MIGUEL DE UNAMUNO,08245,082457,SANTA COLOMA DE GRAMENET,31,3,34
2018/2019,08032348,ESCOLA 25 DE SETEMBRE,08184,081846,RUBÍ,38,5,43
2018/2019,08032351,ESCOLA PAU CASALS,08184,081846,RUBÍ,28,4,32
2018/2019,08032476,ESCOLA PRAT DE LA RIBA,08077,080771,ESPLUGUES DE LLOBREGAT,14,1,15
2018/2019,08032488,ESCOLA PUIG I GAIRALT,08101,081017,L'HOSPITALET DE LLOBREGAT,32,8,40
2018/2019,08032491,ESCOLA SANT VICENÇ,08124,081249,MOLLET DEL VALLÈS,24,7,31
2018/2019,08032521,ESCOLA VALL DE PALAU,08196,081960,SANT ANDREU DE LA BARCA,29,1,30
2018/2019,08032580,ESCOLA CANIGÓ,08221,082212,SANT JUST DESVERN,26,3,29
2018/2019,08032592,ESCOLA SANT JORDI,08264,082649,SANT VICENÇ DE MONTALT,15,1,16
2018/2019,08032634,ESCOLA FERRER I GUÀRDIA,08019,080193,BARCELONA,30,7,37
2018/2019,08032658,ESCOLA L'ERAMPRUNYÀ,08089,080898,GAVÀ,29,2,31
2018/2019,08032701,ESCOLA LLUÍS MILLET,08118,081189,EL MASNOU,26,3,29
2018/2019,08032713,ESCOLA SANT JORDI,08124,081249,MOLLET DEL VALLÈS,25,3,28
2018/2019,08032725,ESCOLA HONORABLE JOSEP TARRADELLAS,08169,081691,EL PRAT DE LLOBREGAT,29,5,34
2018/2019,08032737,ESCOLA CAN RULL,08187,081878,SABADELL,25,4,29
2018/2019,08032750,ESCOLA PAU CASALS,08301,083015,VILADECANS,28,4,32
2018/2019,08032762,ESCOLA DOCTOR TRUETA,08301,083015,VILADECANS,27,2,29
2018/2019,08033341,ESCOLA BANÚS,08245,082457,SANTA COLOMA DE GRAMENET,14,3,17
2018/2019,08033407,ESCOLA PURIFICACIÓ SALAS I XANDRI,08238,082384,SANT QUIRZE DEL VALLÈS,18,2,20
2018/2019,08033468,ESCOLA LA SALUT,08069,080692,COLLBATÓ,20,4,24
2018/2019,08033501,ESCOLA ANTONI BRUSI,08019,080193,BARCELONA,26,4,30
2018/2019,08033523,ESCOLA LA MUNTANYETA,08019,080193,BARCELONA,15,3,18
2018/2019,08033535,ESCOLA JOAN MARAGALL,08077,080771,ESPLUGUES DE LLOBREGAT,29,3,32
2018/2019,08033560,ESCOLA MÀRIUS TORRES,08101,081017,L'HOSPITALET DE LLOBREGAT,35,5,40
2018/2019,08033602,ESCOLA CAN SERRA,08252,082520,BARBERÀ DEL VALLÈS,27,3,30
2018/2019,08033857,ESCOLA BALDOMER SOLÀ,08015,080155,BADALONA,25,5,30
2018/2019,08033869,INSTITUT PAU CASALS,08015,080155,BADALONA,28,21,49
2018/2019,08033882,INSTITUT JOAN COROMINES,08019,080193,BARCELONA,24,26,50
2018/2019,08033894,INSTITUT PRÍNCEP DE GIRONA,08019,080193,BARCELONA,24,22,46
2018/2019,08033900,INSTITUT JOAN MIRÓ,08073,080734,CORNELLÀ DE LLOBREGAT,31,14,45
2018/2019,08033912,INSTITUT MERCÈ RODOREDA,08101,081017,L'HOSPITALET DE LLOBREGAT,32,25,57
2018/2019,08033924,INSTITUT PIUS FONT I QUER,08113,081136,MANRESA,32,27,59
2018/2019,08033948,ESCOLA ENRIC TATCHÉ I POL,08180,081803,RIPOLLET,27,5,32
2018/2019,08033961,INSTITUT RAFAEL CASANOVA,08200,082009,SANT BOI DE LLOBREGAT,45,21,66
2018/2019,08033973,INSTITUT JAUME SALVADOR I PEDROL,08217,082172,SANT JOAN DESPÍ,40,25,65
2018/2019,08033985,INSTITUT DE SANT JUST DESVERN,08221,082212,SANT JUST DESVERN,33,20,53
2018/2019,08033997,ESCOLA PRIMAVERA,08245,082457,SANTA COLOMA DE GRAMENET,16,2,18
2018/2019,08034001,INSTITUT TERRA ROJA,08245,082457,SANTA COLOMA DE GRAMENET,46,12,58
2018/2019,08034011,INSTITUT FREDERIC MOMPOU,08263,082634,SANT VICENÇ DELS HORTS,39,15,54
2018/2019,08034035,INSTITUT FEDERICA MONTSENY,08904,089045,BADIA DEL VALLÈS,21,20,41
2018/2019,08034059,INSTITUT NICOLAU COPÈRNIC,08279,082798,TERRASSA,30,40,70
2018/2019,08034060,ESCOLA MOSSÈN CINTO VERDAGUER,08184,081846,RUBÍ,26,6,32
2018/2019,08034084,ESCOLA CAN ROCA,08056,080569,CASTELLDEFELS,25,4,29
2018/2019,08034096,ESCOLA ANTONI GAUDÍ,08056,080569,CASTELLDEFELS,23,7,30
2018/2019,08034102,ESCOLA JOSEP MARIA MADORELL,08123,081234,MOLINS DE REI,23,1,24
2018/2019,08034126,ESCOLA PAU BOADA,08305,083054,VILAFRANCA DEL PENEDÈS,21,6,27
2018/2019,08034138,INSTITUT POBLENOU,08019,080193,BARCELONA,28,30,58
2018/2019,08034187,INSTITUT DOMÈNEC PERRAMON,08007,080076,ARENYS DE MUNT,23,17,40
2018/2019,08034205,INSTITUT LA GUINEUETA,08019,080193,BARCELONA,67,56,123
2018/2019,08034217,INSTITUT BERNAT EL FERRER,08123,081234,MOLINS DE REI,56,43,99
2018/2019,08034229,ESCOLA BONAVISTA,08051,080517,CASTELLAR DEL VALLÈS,14,3,17
2018/2019,08034242,ESCOLA PABLO NERUDA,08101,081017,L'HOSPITALET DE LLOBREGAT,14,4,18
2018/2019,08034266,ESCOLA JOAN MARAGALL,08101,081017,L'HOSPITALET DE LLOBREGAT,13,3,16
2018/2019,08034278,ESCOLA VICENTE ALEIXANDRE,08114,081141,MARTORELL,26,3,29
2018/2019,08034321,ESCOLA TORRE LLAUDER,08121,081213,MATARÓ,25,2,27
2018/2019,08034333,ESCOLA LA LLÀNTIA,08121,081213,MATARÓ,27,5,32
2018/2019,08034357,ESCOLA VISTA ALEGRE,08121,081213,MATARÓ,13,2,15
2018/2019,08034382,ESCOLA RAMON LLULL,08184,081846,RUBÍ,24,5,29
2018/2019,08034394,ESCOLA TERESA ALTET,08184,081846,RUBÍ,26,5,31
2018/2019,08034400,ESCOLA ANTONI GAUDÍ,08200,082009,SANT BOI DE LLOBREGAT,18,3,21
2018/2019,08034412,ESCOLA CAN MASSALLERA,08200,082009,SANT BOI DE LLOBREGAT,15,2,17
2018/2019,08034448,ESCOLA SANTA EULÀLIA,08231,082310,SANT PERE DE RIBES,24,5,29
2018/2019,08034461,ESCOLA BERNAT DE MOGODA,08260,082606,SANTA PERPÈTUA DE MOGODA,24,4,28
2018/2019,08034485,ESCOLA JOAN MARQUÈS I CASALS,08279,082798,TERRASSA,30,4,34
2018/2019,08034497,ESCOLA L'ARAGAI,08307,083073,VILANOVA I LA GELTRÚ,20,4,24
2018/2019,08034527,ESCOLA RAMON MUNTANER,08101,081017,L'HOSPITALET DE LLOBREGAT,15,1,16
2018/2019,08034564,INSTITUT LES CORTS,08019,080193,BARCELONA,41,19,60
2018/2019,08034576,INSTITUT JOAN SALVAT I PAPASSEIT,08019,080193,BARCELONA,16,12,28
2018/2019,08034591,INSTITUT JOAN OLIVER,08187,081878,SABADELL,32,13,45
2018/2019,08034606,INSTITUT BAIX MONTSENY,08202,082021,SANT CELONI,47,31,78
2018/2019,08034621,INSTITUT DE SALES,08301,083015,VILADECANS,57,26,83
2018/2019,08034643,INSTITUT LES VINYES,08245,082457,SANTA COLOMA DE GRAMENET,51,36,87
2018/2019,08034667,ESCOLA ESTEVE BARRACHINA,08270,082704,SITGES,28,4,32
2018/2019,08034692,ESCOLA CATALUNYA,08205,082055,SANT CUGAT DEL VALLÈS,26,4,30
2018/2019,08034734,ESCOLA CAMÍ DEL MIG,08121,081213,MATARÓ,27,5,32
2018/2019,08034746,ESCOLA ROCAFONDA,08121,081213,MATARÓ,35,0,35
2018/2019,08034783,ESCOLA ELVIRA CUYÀS,08125,081252,MONTCADA I REIXAC,25,5,30
2018/2019,08034795,ESCOLA HEUROM - ZER ALT LLUÇANÈS,08160,081607,PERAFITA,4,0,4
2018/2019,08034837,ESCOLA BERNAT DESCLOT,08101,081017,L'HOSPITALET DE LLOBREGAT,16,1,17
2018/2019,08034850,ESCOLA PAU CASALS,08101,081017,L'HOSPITALET DE LLOBREGAT,31,3,34
2018/2019,08034862,ESCOLA AUSIÀS MARCH,08101,081017,L'HOSPITALET DE LLOBREGAT,15,4,19
2018/2019,08034898,ESCOLA SANT ESTEVE,08051,080517,CASTELLAR DEL VALLÈS,26,2,28
2018/2019,08034904,ESCOLA EMILI CARLES I TOLRÀ,08051,080517,CASTELLAR DEL VALLÈS,11,4,15
2018/2019,08034953,ESCOLA LLIBERTAT,08015,080155,BADALONA,18,1,19
2018/2019,08034965,ESCOLA MARGARIDA XIRGU,08015,080155,BADALONA,31,1,32
2018/2019,08034989,ESCOLA CATALUNYA,08194,081944,SANT ADRIÀ DE BESÒS,27,3,30
2018/2019,08034990,ESCOLA PARELLADA,08200,082009,SANT BOI DE LLOBREGAT,23,6,29
2018/2019,08035003,EASD DE VIC,08298,082981,VIC,18,25,43
2018/2019,08035143,INSTITUT MIQUEL MARTÍ I POL,08073,080734,CORNELLÀ DE LLOBREGAT,72,35,107
2018/2019,08035155,INSTITUT ELS TRES TURONS,08006,080060,ARENYS DE MAR,44,16,60
2018/2019,08035167,INSTITUT BARCELONA-CONGRÉS,08019,080193,BARCELONA,35,14,49
2018/2019,08035209,INSTITUT PABLO R. PICASSO,08019,080193,BARCELONA,27,21,48
2018/2019,08035222,INSTITUT MANUEL BLANCAFORT,08088,080885,LA GARRIGA,28,15,43
2018/2019,08035234,INSTITUT VIL·LA ROMANA,08088,080885,LA GARRIGA,35,14,49
2018/2019,08035246,INSTITUT GELIDA,08091,080919,GELIDA,20,20,40
2018/2019,08035258,INSTITUT APEL·LES MESTRES,08101,081017,L'HOSPITALET DE LLOBREGAT,23,15,38
2018/2019,08035283,ESCOLA REIXAC,08125,081252,MONTCADA I REIXAC,30,2,32
2018/2019,08035295,INSTITUT PALAU AUSIT,08180,081803,RIPOLLET,46,46,92
2018/2019,08035301,INSTITUT DUC DE MONTBLANC,08184,081846,RUBÍ,43,23,66
2018/2019,08035313,INSTITUT QUERCUS,08218,082188,SANT JOAN DE VILATORRADA,43,22,65
2018/2019,08035325,INSTITUT TORRENT DE LES BRUIXES,08245,082457,SANTA COLOMA DE GRAMENET,29,18,47
2018/2019,08035349,INSTITUT LA ROMÀNICA,08252,082520,BARBERÀ DEL VALLÈS,65,25,90
2018/2019,08035350,ESCOLA SANT JOSEP,08263,082634,SANT VICENÇ DELS HORTS,32,2,34
2018/2019,08035362,INSTITUT ALT PENEDÈS,08305,083054,VILAFRANCA DEL PENEDÈS,46,38,84
2018/2019,08035398,ESCOLA MIGUEL HERNÁNDEZ,08015,080155,BADALONA,15,5,20
2018/2019,08035404,ESCOLA JOAN MIRÓ,08015,080155,BADALONA,18,2,20
2018/2019,08035416,ESCOLA JOSEP BOADA,08015,080155,BADALONA,33,5,38
2018/2019,08035428,ESCOLA LA FARIGOLA DEL CLOT,08019,080193,BARCELONA,26,4,30
2018/2019,08035431,ESCOLA BOGATELL,08019,080193,BARCELONA,26,3,29
2018/2019,08035441,ESCOLA CATALÒNIA,08019,080193,BARCELONA,23,6,29
2018/2019,08035453,ESCOLA TOMÀS MORO,08019,080193,BARCELONA,13,5,18
2018/2019,08035465,ESCOLA MARE NOSTRUM,08019,080193,BARCELONA,26,1,27
2018/2019,08035477,ESCOLA SANTIAGO RUSIÑOL,08019,080193,BARCELONA,28,3,31
2018/2019,08035519,ESCOLA ANTONI GAUDÍ,08245,082457,SANTA COLOMA DE GRAMENET,32,6,38
2018/2019,08035544,CEE JOSEP PLA,08019,080193,BARCELONA,11,1,12
2018/2019,08035623,CEE JERONI DE MORAGAS,08266,082665,CERDANYOLA DEL VALLÈS,17,2,19
2018/2019,08035684,ESCOLA MARIÀ MANENT,08230,082303,PREMIÀ DE DALT,26,4,30
2018/2019,08035696,ESCOLA SANT JULIÀ,08187,081878,SABADELL,20,3,23
2018/2019,08035854,ESCOLA LLORENS I ARTIGAS,08015,080155,BADALONA,27,1,28
2018/2019,08035878,ESCOLA PERE DE TERA,08015,080155,BADALONA,23,6,29
2018/2019,08035881,ESCOLA L'ARENY,08073,080734,CORNELLÀ DE LLOBREGAT,27,2,29
2018/2019,08035945,ESCOLA LA CARPA,08101,081017,L'HOSPITALET DE LLOBREGAT,45,4,49
2018/2019,08035957,ESCOLA CAN DEU,08187,081878,SABADELL,11,5,16
2018/2019,08035969,ESCOLA JOAQUIM BLUME,08187,081878,SABADELL,24,3,27
2018/2019,08035994,ESCOLA SALVADOR ESPRIU,08211,082114,SANT FELIU DE LLOBREGAT,23,5,28
2018/2019,08036007,ESCOLA PAU VILA,08211,082114,SANT FELIU DE LLOBREGAT,16,2,18
2018/2019,08036044,ESCOLA PAU VILA,08076,080765,ESPARREGUERA,24,5,29
2018/2019,08036056,ESCOLA FOLCH I TORRES,08077,080771,ESPLUGUES DE LLOBREGAT,27,2,29
2018/2019,08036101,ESCOLA SAGRADA FAMÍLIA,08245,082457,SANTA COLOMA DE GRAMENET,27,1,28
2018/2019,08036111,ESCOLA MAS I PERERA,08305,083054,VILAFRANCA DEL PENEDÈS,26,5,31
2018/2019,08036135,ESCOLA JOAN CORET,08015,080155,BADALONA,26,2,28
2018/2019,08036147,ESCOLA PAU PICASSO,08015,080155,BADALONA,20,7,27
2018/2019,08036330,INSTITUT J.V. FOIX,08184,081846,RUBÍ,25,20,45
2018/2019,08036342,ESCOLA JOAN LLONGUERAS,08015,080155,BADALONA,14,3,17
2018/2019,08036366,ESCOLA LOLA ANGLADA,08101,081017,L'HOSPITALET DE LLOBREGAT,18,3,21
2018/2019,08036378,ESCOLA CHARLIE RIVEL,08101,081017,L'HOSPITALET DE LLOBREGAT,14,7,21
2018/2019,08036391,INSTITUT ARQUITECTE MANUEL RASPALL,08046,080462,CARDEDEU,35,15,50
2018/2019,08036411,ESCOLA SALTELLS,08266,082665,CERDANYOLA DEL VALLÈS,26,2,28
2018/2019,08037152,INSTITUT JOAN ORÓ,08114,081141,MARTORELL,72,50,122
2018/2019,08037176,INSTITUT LA BASTIDA,08245,082457,SANTA COLOMA DE GRAMENET,51,31,82
2018/2019,08037206,INSTITUT LLUÍS COMPANYS,08180,081803,RIPOLLET,42,27,69
2018/2019,08037292,CEE CENTRE DE FORMACIÓ I TREBALL FLOR DE MAIG,08266,082665,CERDANYOLA DEL VALLÈS,14,6,20
2018/2019,08037504,ESCOLA MONTNEGRE,08202,082021,SANT CELONI,13,1,14
2018/2019,08037528,ESCOLA SANT DOMÈNEC,08251,082515,SANTA MARGARIDA I ELS MONJOS,15,1,16
2018/2019,08037802,ESCOLA LES CORTS,08019,080193,BARCELONA,27,3,30
2018/2019,08037814,ESCOLA ALEXANDRE GALÍ,08019,080193,BARCELONA,24,1,25
2018/2019,08037841,ESCOLA SPLAI,08019,080193,BARCELONA,14,2,16
2018/2019,08037863,ESCOLA SEAT,08019,080193,BARCELONA,29,1,30
2018/2019,08037875,ESCOLA RAFAEL CASANOVA,08015,080155,BADALONA,25,6,31
2018/2019,08037887,ESCOLA BALDIRI REIXAC,08015,080155,BADALONA,18,10,28
2018/2019,08037899,ESCOLA FOLCH I TORRES,08015,080155,BADALONA,20,3,23
2018/2019,08037917,ESCOLA JOAN MIRÓ,08041,080410,CANOVELLES,13,4,17
2018/2019,08037929,ESCOLA TORRE BARONA,08056,080569,CASTELLDEFELS,24,6,30
2018/2019,08037930,ESCOLA MARGALLÓ,08056,080569,CASTELLDEFELS,23,6,29
2018/2019,08037966,ESCOLA IGNASI IGLÉSIAS,08073,080734,CORNELLÀ DE LLOBREGAT,29,1,30
2018/2019,08037978,ESCOLA SURIS,08073,080734,CORNELLÀ DE LLOBREGAT,28,4,32
2018/2019,08037981,ESCOLA DE L'ESTANY - ZER EL MOIANÈS LLEVANT,08079,080790,L'ESTANY,4,1,5
2018/2019,08037991,ESCOLA MARCEL·LÍ MORAGAS,08089,080898,GAVÀ,22,5,27
2018/2019,08038004,ESCOLA JOSEP JANÉS,08101,081017,L'HOSPITALET DE LLOBREGAT,26,3,29
2018/2019,08038031,ESCOLA ROSA SENSAT,08118,081189,EL MASNOU,14,2,16
2018/2019,08038041,ESCOLA FEDERICO GARCÍA LORCA,08124,081249,MOLLET DEL VALLÈS,6,5,11
2018/2019,08038065,ESCOLA MONTSENY,08124,081249,MOLLET DEL VALLÈS,24,4,28
2018/2019,08038077,ESCOLA CAN PARERA,08136,081363,MONTORNÈS DEL VALLÈS,25,3,28
2018/2019,08038089,ESCOLA SANT ESTEVE - ZER EL CARDENER,08229,082299,SANT MATEU DE BAGES,4,1,5
2018/2019,08038090,ESCOLA SANT JAUME,08169,081691,EL PRAT DE LLOBREGAT,26,5,31
2018/2019,08038156,ESCOLA ESCURSELL I BARTALOT,08180,081803,RIPOLLET,29,3,32
2018/2019,08038168,ESCOLA LA TORRETA,08181,081810,LA ROCA DEL VALLÈS,16,3,19
2018/2019,08038171,ESCOLA MONTESSORI,08184,081846,RUBÍ,27,5,32
2018/2019,08038181,ESCOLA SERRA I HÚNTER,08113,081136,MANRESA,29,6,35
2018/2019,08038201,ESCOLA LA BAUMETA - ZER ELS CASTELLS,08253,082536,SANTA MARIA DE BESORA,2,0,2
2018/2019,08038211,ESCOLA JOSÉ JUAN ORTIZ,08196,081960,SANT ANDREU DE LA BARCA,24,10,34
2018/2019,08038223,ESCOLA BENVIURE,08200,082009,SANT BOI DE LLOBREGAT,24,5,29
2018/2019,08038247,ESCOLA POMPEU FABRA,08302,083020,VILANOVA DEL CAMÍ,22,4,26
2018/2019,08038259,ESCOLA ANTONI TÀPIES,08200,082009,SANT BOI DE LLOBREGAT,25,3,28
2018/2019,08038260,ESCOLA JOAN MARAGALL,08205,082055,SANT CUGAT DEL VALLÈS,26,3,29
2018/2019,08038272,ESCOLA GARCÍA LORCA,08250,082508,SANTA MARGARIDA DE MONTBUI,26,5,31
2018/2019,08038284,ESCOLA LA GUÀRDIA,08263,082634,SANT VICENÇ DELS HORTS,15,2,17
2018/2019,08038314,ESCOLA MARE DE DÉU DE MONTSERRAT,08279,082798,TERRASSA,17,2,19
2018/2019,08038326,ESCOLA EL VALLÈS,08279,082798,TERRASSA,24,3,27
2018/2019,08038351,ESCOLA XARAU,08266,082665,CERDANYOLA DEL VALLÈS,16,5,21
2018/2019,08038570,EOI DE BARCELONA,08019,080193,BARCELONA,75,23,98
2018/2019,08038582,ESCOLA CATALUNYA,08187,081878,SABADELL,28,3,31
2018/2019,08039057,INSTITUT L'ALZINA,08019,080193,BARCELONA,32,15,47
2018/2019,08039069,INSTITUT MARGARIDA XIRGU,08101,081017,L'HOSPITALET DE LLOBREGAT,36,16,52
2018/2019,08039203,INSTITUT AGUSTÍ SERRA I FONTANET,08187,081878,SABADELL,67,50,117
2018/2019,08039264,ESCOLA MESTRES MUNGUET-CORTÉS,08902,089024,VILANOVA DEL VALLÈS,26,2,28
2018/2019,08039288,ESCOLA RENAIXENÇA,08122,081228,MEDIONA,4,5,9
2018/2019,08039291,ESCOLA CRISTÒFOR MESTRE,08305,083054,VILAFRANCA DEL PENEDÈS,23,8,31
2018/2019,08039306,ESCOLA ELS PINS - ZER MOIANÈS PONENT,08191,081918,SALLENT,4,1,5
2018/2019,08039318,ESCOLA PUIGBERENGUER,08113,081136,MANRESA,28,2,30
2018/2019,08039343,ESCOLA JOSEP FERRÀ I ESTEVA,08147,081477,OLESA DE MONTSERRAT,26,4,30
2018/2019,08039355,ESCOLA RAMON LLULL,08169,081691,EL PRAT DE LLOBREGAT,26,3,29
2018/2019,08039367,ESCOLA JOSEP PLA,08196,081960,SANT ANDREU DE LA BARCA,27,3,30
2018/2019,08039379,ESCOLA RAFAEL CASANOVA,08200,082009,SANT BOI DE LLOBREGAT,25,6,31
2018/2019,08039380,ESCOLA GERMANS AMAT I TARGA,08301,083015,VILADECANS,26,3,29
2018/2019,08039422,ESCOLA RAFAEL ALBERTI,08015,080155,BADALONA,28,3,31
2018/2019,08039434,ESCOLA DOCTOR FERRAN I CLUA,08019,080193,BARCELONA,26,5,31
2018/2019,08039471,ESCOLA MERCÈ RODOREDA,08019,080193,BARCELONA,24,5,29
2018/2019,08039483,ESCOLA ELS HORTS,08019,080193,BARCELONA,17,0,17
2018/2019,08039495,ESCOLA LA PALMERA,08019,080193,BARCELONA,27,2,29
2018/2019,08039513,ESCOLA TAXONERA,08019,080193,BARCELONA,30,6,36
2018/2019,08039525,ESCOLA LA SEDETA,08019,080193,BARCELONA,12,4,16
2018/2019,08039537,ESCOLA TORRENT D'EN MELIS,08019,080193,BARCELONA,28,2,30
2018/2019,08039562,ESCOLA PRAT DE LA MANTA,08101,081017,L'HOSPITALET DE LLOBREGAT,16,2,18
2018/2019,08039574,ESCOLA PAU SANS,08101,081017,L'HOSPITALET DE LLOBREGAT,12,3,15
2018/2019,08039586,ESCOLA L'ARJAU,08307,083073,VILANOVA I LA GELTRÚ,28,3,31
2018/2019,08039598,ESCOLA SANT MIQUEL DEL CROS,08009,080095,ARGENTONA,16,1,17
2018/2019,08039604,ESCOLA FRANCESC FERRER I GUÀRDIA,08118,081189,EL MASNOU,13,3,16
2018/2019,08039616,ESCOLA CAMÍ DEL CROS,08121,081213,MATARÓ,29,2,31
2018/2019,08039628,ESCOLA POMPEU FABRA,08112,081120,MANLLEU,35,4,39
2018/2019,08039631,ESCOLA L'AGULLOLA,08901,089019,RUPIT I PRUIT,5,0,5
2018/2019,08039641,ESCOLA PABLO PICASSO,08252,082520,BARBERÀ DEL VALLÈS,26,2,28
2018/2019,08039653,ESCOLA AGUSTÍ BARTRA,08279,082798,TERRASSA,27,6,33
2018/2019,08039665,ESCOLA LANASPA-GIRALT,08279,082798,TERRASSA,13,3,16
2018/2019,08039677,ESCOLA CONGOST,08041,080410,CANOVELLES,33,6,39
2018/2019,08039690,ESCOLA GERMANS CORBELLA,08046,080462,CARDEDEU,24,3,27
2018/2019,08039707,ESCOLA TAGAMANENT,08088,080885,LA GARRIGA,13,2,15
2018/2019,08039719,ESCOLA LES PLANES,08105,081056,LA LLAGOSTA,23,5,28
2018/2019,08039744,ESCOLA DEL PONT TRENCAT - ZER BAIX MONTSENY,08259,082592,SANTA MARIA DE PALAUTORDERA,6,0,6
2018/2019,08039835,ESCOLA JOVELLANOS,08019,080193,BARCELONA,24,8,32
2018/2019,08039896,ESCOLA BELLATERRA,08266,082665,CERDANYOLA DEL VALLÈS,30,1,31
2018/2019,08040047,CEE JOSEP SOL I RODRÍGUEZ,08245,082457,SANTA COLOMA DE GRAMENET,29,7,36
2018/2019,08040059,ESCOLA JOAN SALVAT I PAPASSEIT,08245,082457,SANTA COLOMA DE GRAMENET,32,1,33
2018/2019,08040060,ESCOLA DEL MAR,08219,082191,VILASSAR DE MAR,28,4,32
2018/2019,08040138,INSTITUT LA SEDETA,08019,080193,BARCELONA,20,15,35
2018/2019,08040141,INSTITUT ICÀRIA,08019,080193,BARCELONA,41,21,62
2018/2019,08040333,ESCOLA BERNAT METGE,08169,081691,EL PRAT DE LLOBREGAT,15,1,16
2018/2019,08040345,ESCOLA MERCÈ RODOREDA,08015,080155,BADALONA,14,1,15
2018/2019,08040357,CEE FOLCH I CAMARASA,08019,080193,BARCELONA,9,0,9
2018/2019,08040382,ESCOLA MERCÈ RODOREDA,08245,082457,SANTA COLOMA DE GRAMENET,33,4,37
2018/2019,08040400,ESCOLA AMADEU VIVES,08187,081878,SABADELL,23,8,31
2018/2019,08040412,ESCOLA EL MARGALLÓ,08307,083073,VILANOVA I LA GELTRÚ,15,6,21
2018/2019,08040527,INSTITUT LA LLAUNA,08015,080155,BADALONA,25,25,50
2018/2019,08040539,INSTITUT LES MARINES,08056,080569,CASTELLDEFELS,38,11,49
2018/2019,08040540,INSTITUT EL CAIRAT,08076,080765,ESPARREGUERA,47,16,63
2018/2019,08040552,INSTITUT ANTONI POUS I ARGILA,08112,081120,MANLLEU,49,22,71
2018/2019,08040564,INSTITUT JAUME ALMERA,08214,082140,VILASSAR DE DALT,27,15,42
2018/2019,08040618,ESCOLA CAN VIDALET,08077,080771,ESPLUGUES DE LLOBREGAT,14,3,17
2018/2019,08040849,INSTITUT FORT PIUS,08019,080193,BARCELONA,32,14,46
2018/2019,08041131,ESCOLA SANT ANTONI,08263,082634,SANT VICENÇ DELS HORTS,15,2,17
2018/2019,08041167,ESCOLA JOSEP CARNER,08015,080155,BADALONA,32,2,34
2018/2019,08041179,ESCOLA MESTRE ENRIC GIBERT I CAMINS,08019,080193,BARCELONA,29,4,33
2018/2019,08041180,ESCOLA ROSSELLÓ PÒRCEL,08245,082457,SANTA COLOMA DE GRAMENET,16,1,17
2018/2019,08041210,ESCOLA DEL BOSC,08252,082520,BARBERÀ DEL VALLÈS,28,2,30
2018/2019,08041222,ESCOLA CAN CLADELLAS,08156,081568,PALAU-SOLITÀ I PLEGAMANS,26,2,28
2018/2019,08041234,ESCOLA COLLSEROLA,08205,082055,SANT CUGAT DEL VALLÈS,27,2,29
2018/2019,08041246,ESCOLA FRANCESC ALDEA I PÉREZ,08279,082798,TERRASSA,15,1,16
2018/2019,08041374,INSTITUT LA MALLOLA,08077,080771,ESPLUGUES DE LLOBREGAT,25,14,39
2018/2019,08041519,INSTITUT MARTÍ DOT,08211,082114,SANT FELIU DE LLOBREGAT,48,37,85
2018/2019,08041556,ESCOLA MONTSENY,08221,082212,SANT JUST DESVERN,17,0,17
2018/2019,08041568,ESCOLA JUNGFRAU,08015,080155,BADALONA,26,5,31
2018/2019,08041571,ESCOLA ARTUR MARTORELL,08015,080155,BADALONA,15,2,17
2018/2019,08041581,ESCOLA GITANJALI,08015,080155,BADALONA,15,0,15
2018/2019,08041601,ESCOLA TORRE DE LA LLEBRE,08184,081846,RUBÍ,14,2,16
2018/2019,08041611,ESCOLA JOANOT ALISANDA,08187,081878,SABADELL,29,1,30
2018/2019,08041647,ESCOLA PONENT,08096,080961,GRANOLLERS,29,6,35
2018/2019,08041659,ESCOLA MESTRES MONTAÑA,08096,080961,GRANOLLERS,25,5,30
2018/2019,08041660,ESCOLA PONT DE LA CADENA,08123,081234,MOLINS DE REI,15,2,17
2018/2019,08041672,ESCOLA CREU ALTA,08187,081878,SABADELL,13,2,15
2018/2019,08041684,ESCOLA ESPAI 3,08217,082172,SANT JOAN DESPÍ,28,1,29
2018/2019,08041696,ESCOLA VAIXELL BURRIAC,08219,082191,VILASSAR DE MAR,26,3,29
2018/2019,08041714,ESCOLA LES BASSEROLES,08269,082690,SEVA,13,2,15
2018/2019,08041726,ESCOLA ROC BLANC,08300,083008,VILADECAVALLS,21,2,23
2018/2019,08041751,ESCOLA LA CAIXA,08019,080193,BARCELONA,21,4,25
2018/2019,08041866,INSTITUT EL CALAMOT,08089,080898,GAVÀ,56,44,100
2018/2019,08042019,INSTITUT BADALONA VII,08015,080155,BADALONA,35,35,70
2018/2019,08042020,INSTITUT VALLÈS,08187,081878,SABADELL,32,21,53
2018/2019,08042044,INSTITUT MIG-MÓN,08274,082747,SÚRIA,28,15,43
2018/2019,08042056,INSTITUT CAN PUIG,08231,082310,SANT PERE DE RIBES,38,30,68
2018/2019,08042093,INSTITUT VINYES VELLES,08136,081363,MONTORNÈS DEL VALLÈS,36,18,54
2018/2019,08042101,INSTITUT MANUEL VÁZQUEZ MONTALBÁN,08194,081944,SANT ADRIÀ DE BESÒS,37,16,53
2018/2019,08042287,ESCOLA SALVADOR ESPRIU,08096,080961,GRANOLLERS,27,4,31
2018/2019,08042299,ESCOLA SANT MIQUEL,08073,080734,CORNELLÀ DE LLOBREGAT,25,3,28
2018/2019,08042305,ESCOLA JOAN MIRÓ,08019,080193,BARCELONA,27,3,30
2018/2019,08042329,ESCOLA ELS XIPRERS,08019,080193,BARCELONA,9,6,15
2018/2019,08042330,INSTITUT SANT RAMON,08047,080478,CARDONA,10,8,18
2018/2019,08042342,INSTITUT DE BADIA DEL VALLÈS,08904,089045,BADIA DEL VALLÈS,35,34,69
2018/2019,08042780,ESCOLA JOSEP MARIA JUJOL,08019,080193,BARCELONA,26,5,31
2018/2019,08042792,ESCOLA DAMIÀ MATEU,08106,081069,LLINARS DEL VALLÈS,17,1,18
2018/2019,08042809,ESCOLA GALILEO GALILEI,08169,081691,EL PRAT DE LLOBREGAT,26,3,29
2018/2019,08042810,ESCOLA CHARLES DARWIN,08169,081691,EL PRAT DE LLOBREGAT,30,4,34
2018/2019,08042834,ESCOLA CAN PALMER,08301,083015,VILADECANS,23,4,27
2018/2019,08042846,CFA CORNELLÀ DE LLOBREGAT,08073,080734,CORNELLÀ DE LLOBREGAT,9,5,14
2018/2019,08042858,CFA ELS TARONGERS,08121,081213,MATARÓ,8,3,11
2018/2019,08042861,ESCOLA LOLA ANGLADA,08077,080771,ESPLUGUES DE LLOBREGAT,12,3,15
2018/2019,08042871,ESCOLA PATUFET SANT JORDI-FRANCESC BATALLÉ I ARA,08101,081017,L'HOSPITALET DE LLOBREGAT,28,2,30
2018/2019,08042883,ESCOLA SANT JOSEP - EL PI,08101,081017,L'HOSPITALET DE LLOBREGAT,12,3,15
2018/2019,08042895,ESCOLA SCHOLA,08184,081846,RUBÍ,15,0,15
2018/2019,08043103,ESCOLA ANTONI BALMANYA,08019,080193,BARCELONA,25,4,29
2018/2019,08043115,ESCOLA PROVENÇALS,08019,080193,BARCELONA,27,2,29
2018/2019,08043255,ESCOLA ÍTACA,08019,080193,BARCELONA,25,4,29
2018/2019,08043267,ESCOLA PAU CASALS-GRÀCIA,08019,080193,BARCELONA,25,4,29
2018/2019,08043279,ESCOLA POMPEU FABRA,08019,080193,BARCELONA,13,4,17
2018/2019,08043310,ESCOLA EDUMAR,08056,080569,CASTELLDEFELS,26,5,31
2018/2019,08043334,ESCOLA ALEXANDRE GALÍ,08073,080734,CORNELLÀ DE LLOBREGAT,14,2,16
2018/2019,08043346,ESCOLA MONTSERRAT,08076,080765,ESPARREGUERA,16,2,18
2018/2019,08043361,ESCOLA EL TURÓ,08125,081252,MONTCADA I REIXAC,15,2,17
2018/2019,08043371,ESCOLA LA LIÓ,08172,081727,PREMIÀ DE MAR,13,2,15
2018/2019,08043383,ESCOLA NOSTRA LLAR,08187,081878,SABADELL,30,1,31
2018/2019,08043395,INSTITUT ALEXANDRE DE RIQUER,08031,080312,CALAF,17,16,33
2018/2019,08043401,ESCOLA BARRUFET,08200,082009,SANT BOI DE LLOBREGAT,20,5,25
2018/2019,08043437,ESCOLA FONT DE L'ALBA,08279,082798,TERRASSA,25,4,29
2018/2019,08043462,INSTITUT ERNEST LLUCH,08019,080193,BARCELONA,44,17,61
2018/2019,08043474,ESCOLA L'ESTEL,08019,080193,BARCELONA,13,3,16
2018/2019,08043486,INSTITUT MANOLO HUGUÉ,08033,080333,CALDES DE MONTBUI,41,25,66
2018/2019,08043504,INSTITUT PERE CALDERS,08266,082665,CERDANYOLA DEL VALLÈS,29,11,40
2018/2019,08043516,INSTITUT SANTA EULÀLIA,08279,082798,TERRASSA,43,59,102
2018/2019,08043589,INSTITUT SALVADOR DALÍ,08169,081691,EL PRAT DE LLOBREGAT,43,18,61
2018/2019,08043644,INSTITUT CARLES VALLBONA,08096,080961,GRANOLLERS,47,42,89
2018/2019,08043656,INSTITUT MARINA,08105,081056,LA LLAGOSTA,42,35,77
2018/2019,08043668,INSTITUT L'ESTATUT,08184,081846,RUBÍ,38,26,64
2018/2019,08043671,INSTITUT EL PALAU,08196,081960,SANT ANDREU DE LA BARCA,54,47,101
2018/2019,08043681,INSTITUT MARIANAO,08200,082009,SANT BOI DE LLOBREGAT,44,43,87
2018/2019,08043693,INSTITUT JOAQUIM MIR,08307,083073,VILANOVA I LA GELTRÚ,57,42,99
2018/2019,08043747,ESCOLA BALOO,08019,080193,BARCELONA,11,4,15
2018/2019,08043760,ESCOLA COLÒNIA GÜELL,08244,082444,SANTA COLOMA DE CERVELLÓ,31,5,36
2018/2019,08043784,ESCOLA ÀNGELS GARRIGA,08019,080193,BARCELONA,11,4,15
2018/2019,08043796,ESCOLA BARRUFET,08019,080193,BARCELONA,24,5,29
2018/2019,08043814,ESCOLA CARLIT,08019,080193,BARCELONA,15,2,17
2018/2019,08043838,ESCOLA TURÓ DEL CARGOL,08019,080193,BARCELONA,15,1,16
2018/2019,08043841,ESCOLA LAVÍNIA,08019,080193,BARCELONA,13,2,15
2018/2019,08043851,ESCOLA NABÍ,08019,080193,BARCELONA,13,2,15
2018/2019,08043863,ESCOLA ORLANDAI,08019,080193,BARCELONA,14,2,16
2018/2019,08043875,ESCOLA PIT-ROIG,08019,080193,BARCELONA,14,1,15
2018/2019,08043887,ESCOLA SAGRADA FAMÍLIA,08019,080193,BARCELONA,26,3,29
2018/2019,08043899,ESCOLA TÀBER,08019,080193,BARCELONA,30,1,31
2018/2019,08043905,ESCOLA EL DOFÍ,08172,081727,PREMIÀ DE MAR,13,2,15
2018/2019,08043917,ESCOLA COSSETÀNIA,08307,083073,VILANOVA I LA GELTRÚ,12,3,15
2018/2019,08043929,ESCOLA LLEBETX,08307,083073,VILANOVA I LA GELTRÚ,18,2,20
2018/2019,08043930,ESCOLA MARINADA,08118,081189,EL MASNOU,12,3,15
2018/2019,08043942,ESCOLA MONTBUI,08033,080333,CALDES DE MONTBUI,28,1,29
2018/2019,08043954,ESCOLA RIBATALLADA,08187,081878,SABADELL,12,3,15
2018/2019,08043966,ESCOLA HEURA,08019,080193,BARCELONA,14,1,15
2018/2019,08043978,INSTITUT DANIEL BLANXART I PEDRALS,08147,081477,OLESA DE MONTSERRAT,44,38,82
2018/2019,08043981,INSTITUT JOAN RAMON BENAPRÈS,08270,082704,SITGES,39,39,78
2018/2019,08044016,ESCOLA FLAMA,08213,082135,SANT FRUITÓS DE BAGES,28,2,30
2018/2019,08044028,CEE HORITZÓ,08163,081635,PINEDA DE MAR,21,5,26
2018/2019,08044053,INSTITUT SALVADOR SEGUÍ,08019,080193,BARCELONA,99,26,125
2018/2019,08044065,INSTITUT GALILEO GALILEI,08019,080193,BARCELONA,30,18,48
2018/2019,08044077,EASD JOSEP SERRA I ABELLA,08101,081017,L'HOSPITALET DE LLOBREGAT,28,16,44
2018/2019,08044120,CFA FREIRE,08019,080193,BARCELONA,8,5,13
2018/2019,08044156,EASD DEIÀ,08019,080193,BARCELONA,19,20,39
2018/2019,08044168,INSTITUT PLA DE LES MORERES,08302,083020,VILANOVA DEL CAMÍ,39,22,61
2018/2019,08044201,ESCOLA DOVELLA,08019,080193,BARCELONA,15,0,15
2018/2019,08044223,CEE L'ESTEL- CAN BORI,08101,081017,L'HOSPITALET DE LLOBREGAT,22,8,30
2018/2019,08044247,ESCOLA ESTEL,08123,081234,MOLINS DE REI,15,0,15
2018/2019,08044296,ESCOLA SALVADOR ESPRIU,08015,080155,BADALONA,24,4,28
2018/2019,08044302,ESCOLA JOAN ABELLÓ,08124,081249,MOLLET DEL VALLÈS,29,1,30
2018/2019,08044314,ESCOLA ANDREU CASTELLS,08187,081878,SABADELL,30,1,31
2018/2019,08044430,ESCOLA LA GARALDA,08157,081574,PALLEJÀ,28,2,30
2018/2019,08044442,ESCOLA SANTA ANNA,08230,082303,PREMIÀ DE DALT,29,1,30
2018/2019,08044454,ESCOLA PILARÍN BAYÉS,08238,082384,SANT QUIRZE DEL VALLÈS,26,4,30
2018/2019,08044508,ESCOLA ÍTACA,08015,080155,BADALONA,19,1,20
2018/2019,08044511,EOI BARCELONA-VALL D'HEBRON,08019,080193,BARCELONA,35,4,39
2018/2019,08044521,ESCOLA ELS PINETONS,08088,080885,LA GARRIGA,25,4,29
2018/2019,08044533,INSTITUT LA FERRERIA,08125,081252,MONTCADA I REIXAC,55,42,97
2018/2019,08044545,ESCOLA COLLBAIX,08218,082188,SANT JOAN DE VILATORRADA,12,3,15
2018/2019,08044569,INSTITUT PERE BARNILS,08067,080673,CENTELLES,33,20,53
2018/2019,08044570,INSTITUT VALL D'ARÚS,08295,082956,VALLIRANA,43,26,69
2018/2019,08044582,EOI DE L'HOSPITALET DE LLOBREGAT,08101,081017,L'HOSPITALET DE LLOBREGAT,19,7,26
2018/2019,08044594,INSTITUT GIOLA,08106,081069,LLINARS DEL VALLÈS,32,25,57
2018/2019,08044600,INSTITUT MOIANÈS,08138,081385,MOIÀ,23,21,44
2018/2019,08044612,INSTITUT TORRE DE MALLA,08159,081593,PARETS DEL VALLÈS,40,27,67
2018/2019,08044624,INSTITUT SABADELL,08187,081878,SABADELL,44,34,78
2018/2019,08044636,EOI DE SABADELL,08187,081878,SABADELL,17,6,23
2018/2019,08044648,ESCOLA LA RODA,08279,082798,TERRASSA,27,2,29
2018/2019,08044715,INSTITUT JAUME MIMÓ,08266,082665,CERDANYOLA DEL VALLÈS,44,30,74
2018/2019,08044910,ESCOLA EL TURONET,08238,082384,SANT QUIRZE DEL VALLÈS,16,0,16
2018/2019,08044922,INSTITUT DR. PUIGVERT,08019,080193,BARCELONA,38,20,58
2018/2019,08044934,INSTITUT ESCOLA D'HOTELERIA I TURISME DE BARCELONA,08019,080193,BARCELONA,51,35,86
2018/2019,08044958,INSTITUT JOSEP PLA,08019,080193,BARCELONA,25,19,44
2018/2019,08044961,ESCRBC DE CATALUNYA,08019,080193,BARCELONA,15,8,23
2018/2019,08044971,INSTITUT PERE FONTDEVILA,08092,080924,GIRONELLA,21,13,34
2018/2019,08044983,INSTITUT LLUÍS COMPANYS,08284,082845,TORDERA,23,20,43
2018/2019,08044995,INSTITUT BARRES I ONES,08015,080155,BADALONA,35,22,57
2018/2019,08045011,INSTITUT TORRE DEL PALAU,08279,082798,TERRASSA,44,23,67
2018/2019,08045021,INSTITUT ESTELA IBÈRICA,08260,082606,SANTA PERPÈTUA DE MOGODA,46,25,71
2018/2019,08045033,ESCOLA MONTPALAU,08163,081635,PINEDA DE MAR,12,5,17
2018/2019,08045045,ESCOLA MEDITERRÀNIA,08163,081635,PINEDA DE MAR,16,2,18
2018/2019,08045057,ESCOLA EL SAGRER,08019,080193,BARCELONA,29,1,30
2018/2019,08045070,INSTITUT EUROPA,08101,081017,L'HOSPITALET DE LLOBREGAT,21,12,33
2018/2019,08045203,INSTITUT OBERT DE CATALUNYA,08019,080193,BARCELONA,74,56,130
2018/2019,08045227,CEE LES AIGÜES,08121,081213,MATARÓ,40,4,44
2018/2019,08045306,INSTITUT RAMON CASAS I CARBÓ,08156,081568,PALAU-SOLITÀ I PLEGAMANS,44,28,72
2018/2019,08045471,INSTITUT POMPEU FABRA,08015,080155,BADALONA,38,54,92
2018/2019,08045483,INSTITUT VILA DE GRÀCIA,08019,080193,BARCELONA,22,13,35
2018/2019,08045513,INSTITUT FLOS I CALCAT,08019,080193,BARCELONA,26,7,33
2018/2019,08045525,INSTITUT MANUEL CARRASCO I FORMIGUERA,08019,080193,BARCELONA,25,9,34
2018/2019,08045537,INSTITUT JOSEP LLUÍS SERT,08056,080569,CASTELLDEFELS,37,22,59
2018/2019,08045549,INSTITUT BANÚS,08266,082665,CERDANYOLA DEL VALLÈS,32,24,56
2018/2019,08045562,INSTITUT CAN PLANAS,08252,082520,BARBERÀ DEL VALLÈS,38,19,57
2018/2019,08045574,ESCOLA SERRA DE MARINA,08245,082457,SANTA COLOMA DE GRAMENET,24,8,32
2018/2019,08045586,ESCOLA LES PRUNERES,08115,081154,MARTORELLES,14,0,14
2018/2019,08045598,ESCOLA MIL·LENARI,08046,080462,CARDEDEU,27,2,29
2018/2019,08045604,INSTITUT ENRIC BORRÀS,08015,080155,BADALONA,45,27,72
2018/2019,08045628,INSTITUT CELESTÍ BELLERA,08096,080961,GRANOLLERS,41,19,60
2018/2019,08045641,INSTITUT LLUÍS DOMÈNECH I MONTANER,08040,080403,CANET DE MAR,45,19,64
2018/2019,08045653,INSTITUT DOLORS MALLAFRÈ I ROS,08307,083073,VILANOVA I LA GELTRÚ,39,16,55
2018/2019,08045665,INSTITUT RAMON TURRÓ I DARDER,08110,081108,MALGRAT DE MAR,43,24,67
2018/2019,08045677,INSTITUT THALASSA,08126,081265,MONTGAT,29,19,48
2018/2019,08045689,INSTITUT VOLTRERA,08001,080018,ABRERA,44,18,62
2018/2019,08045859,INSTITUT DE CORBERA DE LLOBREGAT,08072,080728,CORBERA DE LLOBREGAT,28,21,49
2018/2019,08045860,INSTITUT MIRAMAR,08301,083015,VILADECANS,35,21,56
2018/2019,08046281,ESCOLA ESTEL-GUINARDÓ,08019,080193,BARCELONA,14,2,16
2018/2019,08046293,ESCOLA CAVALL BERNAT,08019,080193,BARCELONA,16,3,19
2018/2019,08046581,INSTITUT LLUÍS VIVES,08019,080193,BARCELONA,22,14,36
2018/2019,08046608,INSTITUT PRÍNCEP DE VIANA,08019,080193,BARCELONA,27,17,44
2018/2019,08046645,INSTITUT MOLÍ DE LA VILA,08044,080446,CAPELLADES,34,16,50
2018/2019,08046657,INSTITUT JOAQUIM BLUME,08077,080771,ESPLUGUES DE LLOBREGAT,14,12,26
2018/2019,08046669,INSTITUT RIBOT I SERRA,08187,081878,SABADELL,50,20,70
2018/2019,08046670,INSTITUT ANGELETA FERRER I SENSAT,08205,082055,SANT CUGAT DEL VALLÈS,42,26,68
2018/2019,08046682,INSTITUT DE CASTELLAR,08051,080517,CASTELLAR DEL VALLÈS,50,41,91
2018/2019,08046694,INSTITUT CENTRE D'ALT RENDIMENT ESPORTIU,08205,082055,SANT CUGAT DEL VALLÈS,22,29,51
2018/2019,08046724,INSTITUT MONTSERRAT ROIG,08279,082798,TERRASSA,64,38,102
2018/2019,08046736,INSTITUT MILÀ I FONTANALS,08305,083054,VILAFRANCA DEL PENEDÈS,45,27,72
2018/2019,08046748,INSTITUT THOS I CODINA,08121,081213,MATARÓ,67,32,99
2018/2019,08046751,INSTITUT VENTURA GASSOL,08015,080155,BADALONA,30,19,49
2018/2019,08046761,INSTITUT GUILLEM CATÀ,08113,081136,MANRESA,60,32,92
2018/2019,08046785,INSTITUT D'ALELLA,08003,080039,ALELLA,27,14,41
2018/2019,08046797,INSTITUT LAIA L'ARQUERA,08121,081213,MATARÓ,34,21,55
2018/2019,08046803,INSTITUT VILATZARA,08219,082191,VILASSAR DE MAR,40,29,69
2018/2019,08046840,INSTITUT CASTELLET,08262,082628,SANT VICENÇ DE CASTELLET,39,36,75
2018/2019,08046852,INSTITUT LLAVANERES,08197,081976,SANT ANDREU DE LLAVANERES,34,21,55
2018/2019,08046864,INSTITUT BELLULLA,08041,080410,CANOVELLES,32,20,52
2018/2019,08046876,INSTITUT MIQUEL BOSCH I JOVER,08010,080109,ARTÉS,27,14,41
2018/2019,08047364,INSTITUT JOAN MERCADER,08102,081022,IGUALADA,42,24,66
2018/2019,08047376,INSTITUT LLOBREGAT,08191,081918,SALLENT,22,17,39
2018/2019,08047421,INSTITUT SECRETARI COLOMA,08019,080193,BARCELONA,24,20,44
2018/2019,08047431,INSTITUT XXV OLIMPÍADA,08019,080193,BARCELONA,32,23,55
2018/2019,08047467,INSTITUT ALEXANDRE GALÍ,08231,082310,SANT PERE DE RIBES,43,14,57
2018/2019,08047479,INSTITUT ALBA DEL VALLÈS,08209,082093,SANT FOST DE CAMPSENTELLES,39,18,57
2018/2019,08047480,INSTITUT MEDITERRÀNIA,08056,080569,CASTELLDEFELS,60,28,88
2018/2019,08047492,INSTITUT RIBERA BAIXA,08169,081691,EL PRAT DE LLOBREGAT,37,20,57
2018/2019,08047509,INSTITUT ÍTACA,08200,082009,SANT BOI DE LLOBREGAT,23,22,45
2018/2019,08047583,INSTITUT SANT QUIRZE DEL VALLÈS,08238,082384,SANT QUIRZE DEL VALLÈS,43,32,75
2018/2019,08047698,INSTITUT CRISTÒFOL COLOM,08019,080193,BARCELONA,4,1,5
2018/2019,08047820,INSTITUT GUINOVARDA,08161,081614,PIERA,48,19,67
2018/2019,08047832,INSTITUT JOAN COROMINES,08163,081635,PINEDA DE MAR,48,25,73
2018/2019,08051240,ESCOLA MEDITERRÀNIA,08073,080734,CORNELLÀ DE LLOBREGAT,27,3,30
2018/2019,08051264,INSTITUT EDUARD FONTSERÈ,08101,081017,L'HOSPITALET DE LLOBREGAT,33,14,47
2018/2019,08051306,ESCOLA ABAT MARCET,08279,082798,TERRASSA,24,4,28
2018/2019,08051318,ESCOLA SANT LLORENÇ DEL MUNT,08279,082798,TERRASSA,27,3,30
2018/2019,08051471,ESCOLA JOSEP MARIA FOLCH I TORRES,08101,081017,L'HOSPITALET DE LLOBREGAT,25,5,30
2018/2019,08052165,ESCOLA OCTAVIO PAZ,08019,080193,BARCELONA,12,5,17
2018/2019,08052207,INSTITUT DE PUIG-REIG,08175,081751,PUIG-REIG,18,10,28
2018/2019,08052581,INSTITUT MIQUEL TARRADELL,08019,080193,BARCELONA,48,13,61
2018/2019,08052608,INSTITUT PAU CLARIS,08019,080193,BARCELONA,23,12,35
2018/2019,08052621,ESCOLA PAU ROMEVA,08019,080193,BARCELONA,28,2,30
2018/2019,08052657,ESCOLA FORT PIENC,08019,080193,BARCELONA,25,3,28
2018/2019,08052669,ESCOLA FERRAN SUNYER,08019,080193,BARCELONA,27,7,34
2018/2019,08052670,ESCOLA AURÓ,08019,080193,BARCELONA,31,1,32
2018/2019,08052700,INSTITUT VALL D'HEBRON,08019,080193,BARCELONA,85,42,127
2018/2019,08052724,INSTITUT FRANCISCO DE GOYA,08019,080193,BARCELONA,28,15,43
2018/2019,08052761,INSTITUT JOSEP COMAS I SOLÀ,08019,080193,BARCELONA,16,7,23
2018/2019,08052785,ESCOLA VILA OLÍMPICA,08019,080193,BARCELONA,26,4,30
2018/2019,08052797,INSTITUT SALVADOR ESPRIU,08019,080193,BARCELONA,35,27,62
2018/2019,08052827,INSTITUT LLUÍS DOMÈNECH I MONTANER,08019,080193,BARCELONA,27,19,46
2018/2019,08052839,INSTITUT CONSELL DE CENT,08019,080193,BARCELONA,31,18,49
2018/2019,08052876,INSTITUT D'ARGENTONA,08009,080095,ARGENTONA,48,20,68
2018/2019,08052888,INSTITUT JÚLIA MINGUELL,08015,080155,BADALONA,27,27,54
2018/2019,08052891,INSTITUT L'ALT BERGUEDÀ,08016,080168,BAGÀ,18,15,33
2018/2019,08052906,INSTITUT LAURO,08086,080863,LES FRANQUESES DEL VALLÈS,49,23,72
2018/2019,08052918,INSTITUT BISBE BERENGUER,08101,081017,L'HOSPITALET DE LLOBREGAT,28,21,49
2018/2019,08052921,INSTITUT EUGENI D'ORS,08101,081017,L'HOSPITALET DE LLOBREGAT,32,12,44
2018/2019,08052931,EOI DEL MARESME,08121,081213,MATARÓ,11,2,13
2018/2019,08052955,INSTITUT DE LLIÇÀ,08107,081075,LLIÇÀ D'AMUNT,39,23,62
2018/2019,08052979,INSTITUT JOSEP PUIG I CADAFALCH,08121,081213,MATARÓ,53,23,76
2018/2019,08052980,INSTITUT MONTMELÓ,08135,081350,MONTMELÓ,38,19,57
2018/2019,08052992,INSTITUT EUCLIDES,08163,081635,PINEDA DE MAR,38,18,56
2018/2019,08053005,INSTITUT CASTELL DE QUER,08171,081712,PRATS DE LLUÇANÈS,21,9,30
2018/2019,08053017,INSTITUT VALERIÀ PUJOL I BOSCH,08230,082303,PREMIÀ DE DALT,30,17,47
2018/2019,08053029,EOI BADALONA,08015,080155,BADALONA,8,3,11
2018/2019,08053030,INSTITUT DE LA ROCA DEL VALLÈS,08181,081810,LA ROCA DEL VALLÈS,32,18,50
2018/2019,08053042,INSTITUT MIQUEL MARTÍ I POL,08183,081831,RODA DE TER,33,9,42
2018/2019,08053054,INSTITUT GERBERT D'AURILLAC,08213,082135,SANT FRUITÓS DE BAGES,30,13,43
2018/2019,08053078,INSTITUT NUMÀNCIA,08245,082457,SANTA COLOMA DE GRAMENET,42,14,56
2018/2019,08053091,INSTITUT EL FOIX,08251,082515,SANTA MARGARIDA I ELS MONJOS,38,15,53
2018/2019,08053108,INSTITUT REGUISSOL,08259,082592,SANTA MARIA DE PALAUTORDERA,36,10,46
2018/2019,08053111,INSTITUT D'AURO,08192,081923,SANTPEDOR,32,15,47
2018/2019,08053121,INSTITUT TARADELL,08278,082785,TARADELL,31,20,51
2018/2019,08053145,INSTITUT CASTELLBISBAL,08054,080543,CASTELLBISBAL,36,24,60
2018/2019,08053157,INSTITUT GORGS,08266,082665,CERDANYOLA DEL VALLÈS,35,17,52
2018/2019,08053169,INSTITUT MATADEPERA,08120,081206,MATADEPERA,41,17,58
2018/2019,08053170,INSTITUT POLINYÀ,08167,081672,POLINYÀ,27,20,47
2018/2019,08053182,INSTITUT LA SERRETA,08184,081846,RUBÍ,62,27,89
2018/2019,08053194,EOI DE TERRASSA,08279,082798,TERRASSA,19,6,25
2018/2019,08053200,INSTITUT MIQUEL CRUSAFONT I PAIRÓ,08187,081878,SABADELL,28,16,44
2018/2019,08053212,INSTITUT JONQUERES,08187,081878,SABADELL,34,17,51
2018/2019,08053224,INSTITUT LES TERMES,08187,081878,SABADELL,32,15,47
2018/2019,08053236,INSTITUT ROVIRA-FORNS,08260,082606,SANTA PERPÈTUA DE MOGODA,42,17,59
2018/2019,08053248,INSTITUT DE SENTMENAT,08267,082671,SENTMENAT,34,11,45
2018/2019,08053251,INSTITUT CAVALL BERNAT,08279,082798,TERRASSA,49,30,79
2018/2019,08053261,INSTITUT DE VILADECAVALLS,08300,083008,VILADECAVALLS,38,24,62
2018/2019,08053285,INSTITUT EL CASTELL,08076,080765,ESPARREGUERA,43,22,65
2018/2019,08053297,INSTITUT DE PALLEJÀ,08157,081574,PALLEJÀ,35,22,57
2018/2019,08053315,INSTITUT MONTSERRAT ROIG,08196,081960,SANT ANDREU DE LA BARCA,31,23,54
2018/2019,08053340,INSTITUT GABRIELA MISTRAL,08263,082634,SANT VICENÇ DELS HORTS,49,28,77
2018/2019,08053352,INSTITUT MONTBUI,08250,082508,SANTA MARGARIDA DE MONTBUI,35,15,50
2018/2019,08053364,INSTITUT JOSEP MESTRES I BUSQUETS,08301,083015,VILADECANS,37,14,51
2018/2019,08053391,ESCOLA LLEDONER,08096,080961,GRANOLLERS,27,5,32
2018/2019,08053406,ESCOLA CAN BESORA,08124,081249,MOLLET DEL VALLÈS,26,2,28
2018/2019,08053418,ESCOLA EL MORSELL,08148,081483,OLIVELLA,20,1,21
2018/2019,08053421,ESCOLA ALOC,08163,081635,PINEDA DE MAR,19,5,24
2018/2019,08053431,ESCOLA EL ROURE,08168,081688,PONTONS,3,1,4
2018/2019,08053443,EOI SANTA COLOMA,08245,082457,SANTA COLOMA DE GRAMENET,7,6,13
2018/2019,08053455,ESCOLA LES AIGÜES,08046,080462,CARDEDEU,25,4,29
2018/2019,08053467,ESCOLA PALAU,08156,081568,PALAU-SOLITÀ I PLEGAMANS,22,6,28
2018/2019,08053492,ESCOLA TERESA CLARAMUNT,08187,081878,SABADELL,25,4,29
2018/2019,08053510,ESCOLA PUIG D'AGULLES,08072,080728,CORBERA DE LLOBREGAT,19,4,23
2018/2019,08053522,ESCOLA LA GINESTA,08295,082956,VALLIRANA,15,1,16
2018/2019,08053571,INST-ESC ART. ORIOL MARTORELL,08019,080193,BARCELONA,74,44,118
2018/2019,08053583,ESCOLA MARIA OSSÓ,08270,082704,SITGES,27,3,30
2018/2019,08053601,ESCOLA LOLA ANGLADA,08114,081141,MARTORELL,31,1,32
2018/2019,08053650,ESCOLA TURÓ DE GUIERA,08266,082665,CERDANYOLA DEL VALLÈS,26,4,30
2018/2019,08054022,ESCOLA MARINADA,08019,080193,BARCELONA,14,4,18
2018/2019,08054034,INSTITUT GALLECS,08124,081249,MOLLET DEL VALLÈS,79,36,115
2018/2019,08054058,ESCOLA TORRE DE LA MIRANDA,08073,080734,CORNELLÀ DE LLOBREGAT,33,5,38
2018/2019,08054061,ESCOLA MONTBAIG,08200,082009,SANT BOI DE LLOBREGAT,15,4,19
2018/2019,08054113,ESCOLA ANXANETA,08121,081213,MATARÓ,28,3,31
2018/2019,08054174,INSTITUT LA RIBERA,08125,081252,MONTCADA I REIXAC,28,15,43
2018/2019,08054186,INSTITUT CAN MAS,08180,081803,RIPOLLET,39,18,57
2018/2019,08054198,INSTITUT ESTANY DE LA RICARDA,08169,081691,EL PRAT DE LLOBREGAT,29,16,45
2018/2019,08054228,INSTITUT JOAN FUSTER,08019,080193,BARCELONA,29,14,43
2018/2019,08054241,INSTITUT EUGENI XAMMAR,08005,080057,L'AMETLLA DEL VALLÈS,27,20,47
2018/2019,08054277,INSTITUT DE TONA,08283,082830,TONA,42,20,62
2018/2019,08054344,EOI ESPLUGUES,08077,080771,ESPLUGUES DE LLOBREGAT,12,3,15
2018/2019,08054368,CEE CA N'ORIOL,08184,081846,RUBÍ,18,3,21
2018/2019,08054401,INSTITUT EL SUI,08046,080462,CARDEDEU,38,12,50
2018/2019,08054411,ESCOLA VALLGORGUINA,08294,082943,VALLGORGUINA,12,3,15
2018/2019,08054824,ESCOLA MESTRE PLA,08051,080517,CASTELLAR DEL VALLÈS,15,2,17
2018/2019,08054836,ESCOLA ONZE DE SETEMBRE,08238,082384,SANT QUIRZE DEL VALLÈS,19,3,22
2018/2019,08054873,INSTITUT JOAQUIMA PLA I FARRERAS,08205,082055,SANT CUGAT DEL VALLÈS,42,18,60
2018/2019,08054903,ESCOLA MEDITERRÀNIA,08019,080193,BARCELONA,17,5,22
2018/2019,08055002,CFA BARRI GÒTIC,08019,080193,BARCELONA,5,3,8
2018/2019,08055041,CFA CANOVELLES,08041,080410,CANOVELLES,5,4,9
2018/2019,08055051,CFA CASTELLDEFELS,08056,080569,CASTELLDEFELS,4,4,8
2018/2019,08055063,CFA CANYELLES,08019,080193,BARCELONA,3,2,5
2018/2019,08055075,CFA TORRE ROMEU,08187,081878,SABADELL,3,2,5
2018/2019,08055105,ESCOLA ARRAONA,08187,081878,SABADELL,26,4,30
2018/2019,08055385,CFA MOLLET DEL VALLÈS,08124,081249,MOLLET DEL VALLÈS,6,3,9
2018/2019,08055397,CFA JAUME TUSET,08180,081803,RIPOLLET,6,5,11
2018/2019,08055403,CFA SANT ROC,08015,080155,BADALONA,4,4,8
2018/2019,08055439,CFA MESTRE ESTEVE,08211,082114,SANT FELIU DE LLOBREGAT,5,3,8
2018/2019,08055440,CFA GARROSA,08263,082634,SANT VICENÇ DELS HORTS,7,3,10
2018/2019,08055683,CFA MANUEL SACRISTÁN,08019,080193,BARCELONA,6,6,12
2018/2019,08055695,CFA RAFAEL FARRÉ,08123,081234,MOLINS DE REI,1,5,6
2018/2019,08055713,CFA SANT CUGAT DEL VALLÈS,08205,082055,SANT CUGAT DEL VALLÈS,7,0,7
2018/2019,08055889,ESCOLA MIQUEL MARTÍ I POL,08187,081878,SABADELL,27,2,29
2018/2019,08055890,ESCOLA SOBIRANS,08007,080076,ARENYS DE MUNT,21,2,23
2018/2019,08055907,ESCOLA MIQUEL MARTÍ I POL,08107,081075,LLIÇÀ D'AMUNT,16,4,20
2018/2019,08055932,ESCOLA TORRENT DE CAN CARABASSA,08019,080193,BARCELONA,29,1,30
2018/2019,08055944,INSTITUT RUBIÓ I ORS,08101,081017,L'HOSPITALET DE LLOBREGAT,25,11,36
2018/2019,08056109,INSTITUT CAN VILUMARA,08101,081017,L'HOSPITALET DE LLOBREGAT,59,26,85
2018/2019,08056122,ESCOLA LES FLANDES,08161,081614,PIERA,23,8,31
2018/2019,08056560,CFA BARBERÀ,08252,082520,BARBERÀ DEL VALLÈS,6,3,9
2018/2019,08056572,CFA TERRA BAIXA,08169,081691,EL PRAT DE LLOBREGAT,4,8,12
2018/2019,08056584,CFA L'ALZINA DE CERDANYOLA,08266,082665,CERDANYOLA DEL VALLÈS,7,3,10
2018/2019,08056614,ESCOLA CIRERA,08121,081213,MATARÓ,25,3,28
2018/2019,08056729,ZER EL MOIANÈS PONENT,08034,080348,CALDERS,3,1,4
2018/2019,08056742,ZER ALT LLUÇANÈS,08201,082016,SANT BOI DE LLUÇANÈS,2,1,3
2018/2019,08056766,ZER SUBIRATS,08273,082732,SUBIRATS,2,1,3
2018/2019,08056781,ZER SERRA D'ANCOSA,08104,081043,LA LLACUNA,2,1,3
2018/2019,08056791,ZER VENT D'AVALL,08170,081705,ELS PRATS DE REI,3,1,4
2018/2019,08056811,ZER ALT BERGUEDÀ,08293,082938,VALLCEBRE,2,1,3
2018/2019,08056833,ZER BAIX MONTSENY,08259,082592,SANTA MARIA DE PALAUTORDERA,2,1,3
2018/2019,08056857,ZER GAVARRESA,08212,082129,SANT FELIU SASSERRA,4,0,4
2018/2019,08056985,INSTITUT RAMON BERENGUER IV,08245,082457,SANTA COLOMA DE GRAMENET,39,20,59
2018/2019,08056997,CFA LA CONCÒRDIA,08187,081878,SABADELL,13,3,16
2018/2019,08057001,CFA LA CREU DE BARBERÀ,08187,081878,SABADELL,8,2,10
2018/2019,08057011,CFA CAN RULL,08187,081878,SABADELL,5,3,8
2018/2019,08057096,ESCOLA GUILLEM DE MONT-RODON,08298,082981,VIC,31,3,34
2018/2019,08057102,ESCOLA ANDERSEN,08298,082981,VIC,34,2,36
2018/2019,08057163,CFA TERESA MAÑÉ,08307,083073,VILANOVA I LA GELTRÚ,6,7,13
2018/2019,08057229,ESCOLA ELS ARENYS,08054,080543,CASTELLBISBAL,20,3,23
2018/2019,08057230,INSTITUT CUBELLES,08074,080749,CUBELLES,37,12,49
2018/2019,08057242,ESCOLA SERENA VALL,08197,081976,SANT ANDREU DE LLAVANERES,27,3,30
2018/2019,08057254,INSTITUT PERE RIBOT,08219,082191,VILASSAR DE MAR,30,16,46
2018/2019,08057266,ESCOLA ELS CINGLES,08005,080057,L'AMETLLA DEL VALLÈS,20,4,24
2018/2019,08057281,ZER CEP DE SIS,08249,082495,SANTA FE DEL PENEDÈS,3,1,4
2018/2019,08057540,INSTITUT JOAN BROSSA,08019,080193,BARCELONA,44,29,73
2018/2019,08057667,CFA TRINITAT VELLA,08019,080193,BARCELONA,5,0,5
2018/2019,08057679,CFA EL GORNAL,08101,081017,L'HOSPITALET DE LLOBREGAT,6,5,11
2018/2019,08057734,ESCOLA ANTONI GAUDÍ,08250,082508,SANTA MARGARIDA DE MONTBUI,28,5,33
2018/2019,08057746,INSTITUT BAETULO,08015,080155,BADALONA,20,8,28
2018/2019,08057874,CFA CATALÒNIA,08101,081017,L'HOSPITALET DE LLOBREGAT,7,2,9
2018/2019,08057965,CFA CAN SERRA,08101,081017,L'HOSPITALET DE LLOBREGAT,8,3,11
2018/2019,08058076,ZER ELS CASTELLS,08131,081311,MONTESQUIU,2,2,4
2018/2019,08058088,ZER BERGUEDÀ CENTRE,08299,082994,VILADA,3,0,3
2018/2019,08058091,ZER BAIX BERGUEDÀ,08144,081445,OLVAN,4,0,4
2018/2019,08058209,CFA SANT BOI,08200,082009,SANT BOI DE LLOBREGAT,6,6,12
2018/2019,08058210,CFA BADIA DEL VALLÈS,08904,089045,BADIA DEL VALLÈS,2,0,2
2018/2019,08058362,ESCOLA RIERA DE RIBES,08231,082310,SANT PERE DE RIBES,26,3,29
2018/2019,08058374,ESCOLA ELS ALOCS,08219,082191,VILASSAR DE MAR,13,3,16
2018/2019,08058404,INSTITUT CIRVIÀNUM DE TORELLÓ,08285,082858,TORELLÓ,39,20,59
2018/2019,08058416,ESCOLA L'ARENAL DE LLEVANT,08019,080193,BARCELONA,24,5,29
2018/2019,08058428,INSTITUT BISAURA,08237,082378,SANT QUIRZE DE BESORA,10,10,20
2018/2019,08058441,ESCOLA GIROI,08088,080885,LA GARRIGA,22,3,25
2018/2019,08058465,ESCOLA ENXANETA,08279,082798,TERRASSA,36,5,41
2018/2019,08058519,ESCOLA SINERA,08006,080060,ARENYS DE MAR,24,5,29
2018/2019,08058520,INSTITUT PUIG DE LA CREU,08051,080517,CASTELLAR DEL VALLÈS,34,14,48
2018/2019,08058775,INSTITUT FRONT MARÍTIM,08019,080193,BARCELONA,33,16,49
2018/2019,08058817,ZER TRES BRANQUES,08063,080636,CASTELLOLÍ,3,1,4
2018/2019,08058957,ESCOLA ELS COSTERETS,08231,082310,SANT PERE DE RIBES,25,2,27
2018/2019,08058969,INSTITUT EL VERN,08108,081081,LLIÇÀ DE VALL,21,9,30
2018/2019,08059044,CFA LA LLAGOSTA,08105,081056,LA LLAGOSTA,8,2,10
2018/2019,08059093,ESCOLA D'HORTSAVINYÀ,08284,082845,TORDERA,4,3,7
2018/2019,08059287,ZER GUILLERIES,17220,172207,VILADRAU,2,2,4
2018/2019,08059329,INSTITUT CAN PEIXAUET,08245,082457,SANTA COLOMA DE GRAMENET,30,26,56
2018/2019,08059354,ESCOLA LES ROQUES BLAVES,08076,080765,ESPARREGUERA,23,1,24
2018/2019,08059524,INSTITUT DE NAVARCLES,08140,081402,NAVARCLES,14,9,23
2018/2019,08059551,EOI DE MANRESA,08113,081136,MANRESA,10,3,13
2018/2019,08059639,ESCOLA PROGRÉS,08015,080155,BADALONA,28,2,30
2018/2019,08059688,INSTITUT MARIA AURÈLIA CAPMANY,08073,080734,CORNELLÀ DE LLOBREGAT,31,20,51
2018/2019,08059691,CFA ANNA MURIÀ,08279,082798,TERRASSA,9,2,11
2018/2019,08059706,CFA SALVADOR ESPRIU,08279,082798,TERRASSA,6,0,6
2018/2019,08059721,ESCOLA MARTA MATA,08301,083015,VILADECANS,36,2,38
2018/2019,08059731,CFA ARQUITECTE JUJOL,08217,082172,SANT JOAN DESPÍ,10,3,13
2018/2019,08059755,ESCOLA LA FONT,08113,081136,MANRESA,29,4,33
2018/2019,08059767,ESCOLA TANIT,08245,082457,SANTA COLOMA DE GRAMENET,18,3,21
2018/2019,08059779,ESCOLA PLA DE L'AVELLÀ,08029,080291,CABRERA DE MAR,29,1,30
2018/2019,08059780,ESCOLA BELLAVISTA-JOAN CAMPS I GIRÓ,08086,080863,LES FRANQUESES DEL VALLÈS,26,4,30
2018/2019,08059792,ESCOLA MOGENT,08136,081363,MONTORNÈS DEL VALLÈS,27,3,30
2018/2019,08059809,ESCOLA EL ROURE,08209,082093,SANT FOST DE CAMPSENTELLES,17,0,17
2018/2019,08059810,ESCOLA VINYA DEL SASTRET,08208,082080,SANT ESTEVE SESROVIRES,15,2,17
2018/2019,08059822,ESCOLA ERNEST LLUCH,08001,080018,ABRERA,24,5,29
2018/2019,08059871,ESCOLA GERBERT D'ORLHAC,08205,082055,SANT CUGAT DEL VALLÈS,26,4,30
2018/2019,08059883,ESCOLA EL MARTINET,08180,081803,RIPOLLET,28,1,29
2018/2019,08059998,ESCOLA LA PAU,08240,082401,SANT SADURNÍ D'ANOIA,29,2,31
2018/2019,08060009,INSTITUT MANUEL CARRASCO I FORMIGUERA,08210,082107,SANT FELIU DE CODINES,11,8,19
2018/2019,08060095,CFA MONTSENY,08298,082981,VIC,9,1,10
2018/2019,08060113,CFA JACINT CARRIÓ I VILASECA,08113,081136,MANRESA,6,6,12
2018/2019,08060125,CFA MANUEL FERNÁNDEZ,08194,081944,SANT ADRIÀ DE BESÒS,4,4,8
2018/2019,08060137,CFA EDÈLIA HERNÁNDEZ,08301,083015,VILADECANS,6,5,11
2018/2019,08060204,CFA GRAN SOL,08015,080155,BADALONA,7,5,12
2018/2019,08060216,CFA MORERA POMAR,08015,080155,BADALONA,9,2,11
2018/2019,08060228,CFA EL CLOT,08019,080193,BARCELONA,5,6,11
2018/2019,08060231,CFA PEGASO,08019,080193,BARCELONA,8,4,12
2018/2019,08060253,CFA CAN MARFÀ,08121,081213,MATARÓ,9,3,12
2018/2019,08060265,CFA PREMIÀ DE MAR,08172,081727,PREMIÀ DE MAR,3,4,7
2018/2019,08060277,CFA PAU CASALS,08184,081846,RUBÍ,7,4,11
2018/2019,08060289,CFA FONDO,08245,082457,SANTA COLOMA DE GRAMENET,7,6,13
2018/2019,08060290,CFA SINGUERLÍN,08245,082457,SANTA COLOMA DE GRAMENET,7,3,10
2018/2019,08060319,ESCOLA LES FONTS,08009,080095,ARGENTONA,23,2,25
2018/2019,08060411,CFA SANTS-SANT RAIMON DE PENYAFORT,08019,080193,BARCELONA,2,4,6
2018/2019,08060423,ESCOLA MAS PRATS,08155,081555,PALAFOLLS,29,1,30
2018/2019,08060484,ESCOLA TAULA RODONA,08238,082384,SANT QUIRZE DEL VALLÈS,23,5,28
2018/2019,08060514,INSTITUT DE MASQUEFA,08119,081192,MASQUEFA,39,18,57
2018/2019,08060526,ESCOLA CREIXÀ,08161,081614,PIERA,9,3,12
2018/2019,08060538,EOI DEL PRAT DE LLOBREGAT,08169,081691,EL PRAT DE LLOBREGAT,9,2,11
2018/2019,08060599,ESCOLA GARIGOT,08056,080569,CASTELLDEFELS,26,5,31
2018/2019,08060605,ESCOLA FONT DEL ROURE,08119,081192,MASQUEFA,27,3,30
2018/2019,08060629,ESCOLA EL CORB,08072,080728,CORBERA DE LLOBREGAT,19,3,22
2018/2019,08060757,ESCOLA JOAN TORREDEMER CANELA,08120,081206,MATADEPERA,26,2,28
2018/2019,08060836,ESCOLA TURÓ DEL DRAC,08040,080403,CANET DE MAR,29,4,33
2018/2019,08060848,ESCOLA DE SANT ANDREU DE LA BARCA,08196,081960,SANT ANDREU DE LA BARCA,24,6,30
2018/2019,08060851,ESCOLA L'OLIVERA,08295,082956,VALLIRANA,26,2,28
2018/2019,08060873,ESCOLA EULÀLIA BOTA,08019,080193,BARCELONA,26,5,31
2018/2019,08060903,ESCOLA EL COLOMER,08023,080235,BIGUES I RIELLS,24,4,28
2018/2019,08060915,INSTITUT MARIA DE BELL-LLOC,08023,080235,BIGUES I RIELLS,32,15,47
2018/2019,08060927,ESCOLA VORA DEL MAR,08074,080749,CUBELLES,28,2,30
2018/2019,08060939,ESCOLA GUERAU DE LIOST,08086,080863,LES FRANQUESES DEL VALLÈS,26,3,29
2018/2019,08060940,ESCOLA ROSA ORIOL ANGUERA,08107,081075,LLIÇÀ D'AMUNT,21,4,25
2018/2019,08060952,ESCOLA ELS VINYALS,08108,081081,LLIÇÀ DE VALL,13,2,15
2018/2019,08060964,ESCOLA QUATRE VENTS,08112,081120,MANLLEU,36,6,42
2018/2019,08060976,INSTITUT DEL VOLTREGANÈS,08117,081173,LES MASIES DE VOLTREGÀ,28,7,35
2018/2019,08060988,ESCOLA CAL MÚSIC,08124,081249,MOLLET DEL VALLÈS,22,6,28
2018/2019,08060991,ESCOLA MOGENT,08181,081810,LA ROCA DEL VALLÈS,23,5,28
2018/2019,08061002,ESCOLA LES PARELLADES,08231,082310,SANT PERE DE RIBES,15,5,20
2018/2019,08061014,INSTITUT VINYET,08270,082704,SITGES,32,16,48
2018/2019,08061026,ESCOLA LA FALGUERA,08902,089024,VILANOVA DEL VALLÈS,17,4,21
2018/2019,08061038,INSTITUT DE VILANOVA DEL VALLÈS,08902,089024,VILANOVA DEL VALLÈS,29,26,55
2018/2019,08061041,ESCOLA SANT JORDI,08307,083073,VILANOVA I LA GELTRÚ,30,6,36
2018/2019,08061051,ESCOLA ÍTACA,08307,083073,VILANOVA I LA GELTRÚ,22,3,25
2018/2019,08061063,ESCOLA LA SERRETA,08003,080039,ALELLA,15,2,17
2018/2019,08061087,ESCOLA MARINA,08126,081265,MONTGAT,27,3,30
2018/2019,08061099,INSTITUT FONT DEL FERRO,08155,081555,PALAFOLLS,41,16,57
2018/2019,08061105,ESCOLA SOT DEL CAMP,08264,082649,SANT VICENÇ DE MONTALT,21,0,21
2018/2019,08061117,INSTITUT TURÓ D'EN BALDIRI,08281,082819,TEIÀ,13,8,21
2018/2019,08061129,INSTITUT MONTSERRAT COLOMER,08208,082080,SANT ESTEVE SESROVIRES,39,13,52
2018/2019,08061142,ESCOLA MIQUEL MARTÍ I POL,08252,082520,BARBERÀ DEL VALLÈS,30,1,31
2018/2019,08061154,ESCOLA CA N'ALZAMORA,08184,081846,RUBÍ,29,2,31
2018/2019,08061166,ESCOLA DE CAN LLONG,08187,081878,SABADELL,23,6,29
2018/2019,08061178,ESCOLA TURÓ DE CAN MATES,08205,082055,SANT CUGAT DEL VALLÈS,27,2,29
2018/2019,08061181,ESCOLA SANTIGA,08260,082606,SANTA PERPÈTUA DE MOGODA,21,0,21
2018/2019,08061191,ESCOLA FONT DE L'ORPINA,08291,082917,VACARISSES,17,2,19
2018/2019,08061208,INSTITUT VACARISSES,08291,082917,VACARISSES,30,18,48
2018/2019,08061221,CFA VALLÈS,08096,080961,GRANOLLERS,7,5,12
2018/2019,08061348,ESCOLA BUFALÀ,08015,080155,BADALONA,26,3,29
2018/2019,08061361,INSTITUT TORRELLES DE LLOBREGAT,08289,082896,TORRELLES DE LLOBREGAT,11,11,22
2018/2019,08061521,ESCOLA VALL DE NÉSPOLA - ZER EL MOIANÈS PONENT,08139,081398,MURA,4,1,5
2018/2019,08061543,ESCOLA ROSER CAPDEVILA,08167,081672,POLINYÀ,22,6,28
2018/2019,08061555,CFA CAN FOLGUERA,08260,082606,SANTA PERPÈTUA DE MOGODA,5,2,7
2018/2019,08061580,AFA LLOREDA-LA PAU,08015,080155,BADALONA,4,2,6
2018/2019,08061609,ESCOLA MERCÈ RODOREDA,08114,081141,MARTORELL,38,1,39
2018/2019,08061610,ESCOLA LA SÍNIA,08123,081234,MOLINS DE REI,22,6,28
2018/2019,08061622,ESCOLA CAN COLL,08289,082896,TORRELLES DE LLOBREGAT,16,2,18
2018/2019,08061683,CFA PALAU DE MAR,08019,080193,BARCELONA,5,3,8
2018/2019,08061701,CFA MARIA RUBIES,08019,080193,BARCELONA,5,5,10
2018/2019,08061725,EOI BARCELONA III,08019,080193,BARCELONA,6,5,11
2018/2019,08061762,ESCOLA MAS MARIA,08030,080305,CABRILS,21,5,26
2018/2019,08061774,ESCOLA LES ARENES,08279,082798,TERRASSA,26,5,31
2018/2019,08061907,CFA BARCELONETA,08019,080193,BARCELONA,6,2,8
2018/2019,08061919,CFA RIUS I TAULET,08019,080193,BARCELONA,7,1,8
2018/2019,08061932,CFA BON PASTOR,08019,080193,BARCELONA,4,2,6
2018/2019,08061944,CFA MADRID,08019,080193,BARCELONA,5,0,5
2018/2019,08061956,CFA PROSPERITAT,08019,080193,BARCELONA,2,3,5
2018/2019,08061968,CFA LES CORTS,08019,080193,BARCELONA,5,2,7
2018/2019,08061971,CFA BERGUEDÀ,08022,080229,BERGA,2,4,6
2018/2019,08061993,CFA EUGENI D'ORS,08077,080771,ESPLUGUES DE LLOBREGAT,8,2,10
2018/2019,08062018,CFA ANOIA,08102,081022,IGUALADA,3,2,5
2018/2019,08062021,CFA MONTCADA I REIXAC,08125,081252,MONTCADA I REIXAC,5,2,7
2018/2019,08062031,CFA MARE DE DÉU DE MONTSERRAT,08147,081477,OLESA DE MONTSERRAT,3,2,5
2018/2019,08062043,CFA PARETS DEL VALLÈS,08159,081593,PARETS DEL VALLÈS,3,1,4
2018/2019,08062055,CFA SANT JUST DESVERN,08221,082212,SANT JUST DESVERN,2,2,4
2018/2019,08062079,CFA RAMON LLULL,08279,082798,TERRASSA,4,1,5
2018/2019,08062080,CFA EGARA,08279,082798,TERRASSA,6,4,10
2018/2019,08062092,CFA VILAFRANCA DEL PENEDÈS,08305,083054,VILAFRANCA DEL PENEDÈS,6,3,9
2018/2019,08062109,AFA CIUTAT MERIDIANA,08019,080193,BARCELONA,3,4,7
2018/2019,08062110,CFA SANFELIU,08101,081017,L'HOSPITALET DE LLOBREGAT,4,2,6
2018/2019,08062122,CFA MARTORELL,08114,081141,MARTORELL,3,5,8
2018/2019,08062134,CFA PLA DE BESÒS,08194,081944,SANT ADRIÀ DE BESÒS,7,1,8
2018/2019,08062146,CFA LA VERNEDA,08019,080193,BARCELONA,4,4,8
2018/2019,08062158,EOI DE MARTORELL,08114,081141,MARTORELL,7,1,8
2018/2019,08062161,EOI DE SANT CUGAT DEL VALLÈS,08205,082055,SANT CUGAT DEL VALLÈS,7,2,9
2018/2019,08062171,EOI D'IGUALADA,08102,081022,IGUALADA,8,0,8
2018/2019,08062183,EOI OSONA,08298,082981,VIC,5,2,7
2018/2019,08062195,EOI BARCELONA IV,08019,080193,BARCELONA,8,5,13
2018/2019,08062201,EOI BARCELONA V,08019,080193,BARCELONA,4,4,8
2018/2019,08062213,EOI VALLÈS ORIENTAL,08096,080961,GRANOLLERS,4,4,8
2018/2019,08062225,EOI GARRAF,08307,083073,VILANOVA I LA GELTRÚ,5,4,9
2018/2019,08062249,CFA EL CARMEL,08019,080193,BARCELONA,6,3,9
2018/2019,08062250,CFA TORRENT D'EN MELIS,08019,080193,BARCELONA,4,1,5
2018/2019,08062262,CFA MONTSERRAT ROIG,08019,080193,BARCELONA,6,3,9
2018/2019,08062331,CFA PERE CALDERS,08019,080193,BARCELONA,6,3,9
2018/2019,08062468,CFA BELLAVISTA,08086,080863,LES FRANQUESES DEL VALLÈS,2,2,4
2018/2019,08062471,CFA GAVÀ,08089,080898,GAVÀ,2,4,6
2018/2019,08062481,CFA SANT JOSEP,08101,081017,L'HOSPITALET DE LLOBREGAT,4,2,6
2018/2019,08062493,CFA SANT RAMON,08101,081017,L'HOSPITALET DE LLOBREGAT,6,2,8
2018/2019,08062511,CFA ALARONA,08121,081213,MATARÓ,4,1,5
2018/2019,08062523,CFA MARINADA,08136,081363,MONTORNÈS DEL VALLÈS,3,1,4
2018/2019,08062614,ESCOLA JOAN BLANQUER,08051,080517,CASTELLAR DEL VALLÈS,16,0,16
2018/2019,08062626,ESCOLA COLLSEROLA,08266,082665,CERDANYOLA DEL VALLÈS,16,1,17
2018/2019,08062638,ESCOLA LA TRAMA,08187,081878,SABADELL,22,2,24
2018/2019,08062641,ESCOLA L'OLIVERA,08205,082055,SANT CUGAT DEL VALLÈS,27,3,30
2018/2019,08062675,ESCOLA PERE IV,08019,080193,BARCELONA,27,3,30
2018/2019,08062687,ESCOLA PONENT,08279,082798,TERRASSA,26,3,29
2018/2019,08062705,ESCOLA LA CABANA,08027,080272,LES CABANYES,10,3,13
2018/2019,08062717,INSTITUT CABRILS,08030,080305,CABRILS,22,14,36
2018/2019,08062729,INSTITUT PLA MARCELL,08046,080462,CARDEDEU,41,14,55
2018/2019,08062730,INSTITUT ELS ROURES,08075,080752,DOSRIUS,17,5,22
2018/2019,08062742,ESCOLA BENVIURE,08054,080543,CASTELLBISBAL,17,2,19
2018/2019,08062754,ESCOLA LES FONTS,08091,080919,GELIDA,22,7,29
2018/2019,08062778,ESCOLA AMETLLERS,08218,082188,SANT JOAN DE VILATORRADA,24,4,28
2018/2019,08062781,ESCOLA MEDITERRÀNIA,08231,082310,SANT PERE DE RIBES,27,3,30
2018/2019,08062791,INSTITUT VILAMAJOR,08234,082346,SANT PERE DE VILAMAJOR,29,17,46
2018/2019,08062808,INSTITUT ESTEVE ALBERT,08264,082649,SANT VICENÇ DE MONTALT,29,20,49
2018/2019,08062811,ESCOLA MATAGALLS,08259,082592,SANTA MARIA DE PALAUTORDERA,14,2,16
2018/2019,08062821,ESCOLA MONTAGUT,08261,082613,SANTA SUSANNA,21,2,23
2018/2019,08062833,ESCOLA AGNÈS DE SITGES,08270,082704,SITGES,14,1,15
2018/2019,08062857,INSTITUT TIANA,08282,082824,TIANA,18,9,27
2018/2019,08062869,ESCOLA SERRA DE MIRALLES,08284,082845,TORDERA,16,5,21
2018/2019,08062870,INSTITUT LA PLANA,08298,082981,VIC,36,14,50
2018/2019,08062924,ESCOLA JOSEP GUINOVART,08056,080569,CASTELLDEFELS,17,4,21
2018/2019,08062948,ESCOLA MIQUEL MARTÍ I POL,08301,083015,VILADECANS,38,5,43
2018/2019,08063072,ESCOLA FRUCTUÓS GELABERT,08019,080193,BARCELONA,27,2,29
2018/2019,08063229,INSTITUT MONTPEDRÓS,08244,082444,SANTA COLOMA DE CERVELLÓ,34,19,53
2018/2019,08063394,ESCOLA MIQUEL MARTÍ I POL,08211,082114,SANT FELIU DE LLOBREGAT,26,3,29
2018/2019,08063618,CFA ESPARREGUERA,08076,080765,ESPARREGUERA,3,2,5
2018/2019,08063621,CFA MARTÍ I POL,08112,081120,MANLLEU,4,1,5
2018/2019,08063643,CFA LA COOPERATIVA,08285,082858,TORELLÓ,1,2,3
2018/2019,08063710,ESCOLA ESCOLA NOVA,08068,080689,CERVELLÓ,20,1,21
2018/2019,08063734,ESCOLA PUIGVENTÓS,08147,081477,OLESA DE MONTSERRAT,25,5,30
2018/2019,08063746,INSTITUT SALVADOR CLARAMUNT,08161,081614,PIERA,17,8,25
2018/2019,08063758,ESCOLA CAN SALVI,08196,081960,SANT ANDREU DE LA BARCA,27,4,31
2018/2019,08063761,ESCOLA VICENTE FERRER,08200,082009,SANT BOI DE LLOBREGAT,12,4,16
2018/2019,08063771,ESCOLA PLA DE LES VINYES,08244,082444,SANTA COLOMA DE CERVELLÓ,26,1,27
2018/2019,08063783,ESCOLA MEDITERRÀNIA,08301,083015,VILADECANS,17,2,19
2018/2019,08063795,ESCOLA MARTA MATA,08302,083020,VILANOVA DEL CAMÍ,13,3,16
2018/2019,08063801,INSTITUT DE COLLBATÓ,08069,080692,COLLBATÓ,22,10,32
2018/2019,08063813,INSTITUT CREU DE SABA,08147,081477,OLESA DE MONTSERRAT,28,17,45
2018/2019,08063837,INSTITUT LES MARGUES,08037,080370,CALLDETENES,23,10,33
2018/2019,08063862,ESCOLA L'OLIVAR,08062,080620,CASTELLNOU DE BAGES,13,3,16
2018/2019,08063874,ESCOLA ANTONIO MACHADO,08121,081213,MATARÓ,25,3,28
2018/2019,08063886,ESCOLA ARRELS,08251,082515,SANTA MARGARIDA I ELS MONJOS,15,2,17
2018/2019,08063898,ESCOLA LA SÈQUIA,08113,081136,MANRESA,25,6,31
2018/2019,08063904,INSTITUT MONTGRÒS,08231,082310,SANT PERE DE RIBES,27,16,43
2018/2019,08063916,ESCOLA VILA PARIETES,08159,081593,PARETS DEL VALLÈS,15,3,18
2018/2019,08063928,ESCOLA MUNTANYOLA,08129,081290,MUNTANYOLA,6,0,6
2018/2019,08063931,ESCOLA LES FALGUERES,08082,080826,FOGARS DE LA SELVA,15,0,15
2018/2019,08063965,ESCOLA CAU DE LA GUINEU,08072,080728,CORBERA DE LLOBREGAT,13,3,16
2018/2019,08064003,INSTITUT CAN MARGARIT,08072,080728,CORBERA DE LLOBREGAT,22,13,35
2018/2019,08064027,ESCOLA EL SOL I LA LLUNA,08051,080517,CASTELLAR DEL VALLÈS,21,5,26
2018/2019,08064052,ESCOLA MAS RAMPINYO,08125,081252,MONTCADA I REIXAC,27,2,29
2018/2019,08064064,ESCOLA CAN PERIQUET,08156,081568,PALAU-SOLITÀ I PLEGAMANS,4,0,4
2018/2019,08064076,ESCOLA RIVO RUBEO,08184,081846,RUBÍ,27,3,30
2018/2019,08064088,ESCOLA MAS BOADELLA,08187,081878,SABADELL,27,2,29
2018/2019,08064118,ESCOLA CIUTAT D'ALBA,08205,082055,SANT CUGAT DEL VALLÈS,28,3,31
2018/2019,08064131,ESCOLA ELS AIGÜEROLS,08260,082606,SANTA PERPÈTUA DE MOGODA,16,4,20
2018/2019,08064143,ESCOLA LA NOVA ELECTRA,08279,082798,TERRASSA,33,8,41
2018/2019,08064155,INSTITUT QUATRE CANTONS,08019,080193,BARCELONA,28,17,45
2018/2019,08064167,ESCOLA SANT MARTÍ,08019,080193,BARCELONA,28,1,29
2018/2019,08064179,ESCOLA LA LLACUNA DEL POBLENOU,08019,080193,BARCELONA,26,3,29
2018/2019,08064222,ESCOLA LA ROUREDA,08284,082845,TORDERA,25,2,27
2018/2019,08064623,CFA CONCEPCIÓ ARENAL,08019,080193,BARCELONA,3,1,4
2018/2019,08064635,CFA SANTIAGO RUSIÑOL,08181,081810,LA ROCA DEL VALLÈS,12,3,15
2018/2019,08064647,CFA ARTUR MARTORELL,08208,082080,SANT ESTEVE SESROVIRES,16,7,23
2018/2019,08064659,CFA SALVADOR DALÍ,08181,081810,LA ROCA DEL VALLÈS,18,6,24
2018/2019,08064738,ESCOLA DOLORS PIERA,08305,083054,VILAFRANCA DEL PENEDÈS,26,7,33
2018/2019,08064741,ESCOLA ÍTACA,08113,081136,MANRESA,25,5,30
2018/2019,08064751,ESCOLA MAR I CEL,08074,080749,CUBELLES,19,3,22
2018/2019,08064787,ESCOLA EMILI TEIXIDOR,08183,081831,RODA DE TER,18,0,18
2018/2019,08064805,ESCOLA ELS QUATRE VENTS,08041,080410,CANOVELLES,26,9,35
2018/2019,08064817,ESCOLA CAMINS,08086,080863,LES FRANQUESES DEL VALLÈS,29,3,32
2018/2019,08064829,ESCOLA VALLDENEU,08224,082248,SANT MARTÍ DE CENTELLES,8,0,8
2018/2019,08064830,INSTITUT SERRA DE NOET,08022,080229,BERGA,22,2,24
2018/2019,08064854,ESCOLA MARTINET,08073,080734,CORNELLÀ DE LLOBREGAT,23,6,29
2018/2019,08064866,ESCOLA DOLORS MARTÍ I BADIA,08102,081022,IGUALADA,27,5,32
2018/2019,08064881,ESCOLA CAMPDERRÓS,08295,082956,VALLIRANA,22,3,25
2018/2019,08064908,INSTITUT BEGUES,08020,080207,BEGUES,16,5,21
2018/2019,08064911,INSTITUT VALÈRIA HALINÉ,08056,080569,CASTELLDEFELS,23,11,34
2018/2019,08064921,INSTITUT DE SANT ANDREU,08196,081960,SANT ANDREU DE LA BARCA,26,8,34
2018/2019,08064945,ESCOLA MANSUET,08069,080692,COLLBATÓ,14,2,16
2018/2019,08064970,INSTITUT NOU DE VILAFRANCA DEL PENEDÈS,08305,083054,VILAFRANCA DEL PENEDÈS,21,14,35
2018/2019,08064982,ESCOLA DE SANT QUIRZE SAFAJA - ZER EL MOIANÈS LLEVANT,08239,082397,SANT QUIRZE SAFAJA,2,3,5
2018/2019,08064994,ESCOLA MARIA-MERCÈ MARÇAL,08121,081213,MATARÓ,26,5,31
2018/2019,08065007,ESCOLA POBLE NOU,08163,081635,PINEDA DE MAR,13,3,16
2018/2019,08065019,INSTITUT DE VALLBONA D'ANOIA,08292,082922,VALLBONA D'ANOIA,20,3,23
2018/2019,08065238,ESCOLA LA SAGRERA,08248,082482,SANTA EULÀLIA DE RONÇANA,24,5,29
2018/2019,08065251,ESCOLA PLA DEL PUIG,08213,082135,SANT FRUITÓS DE BAGES,14,1,15
2018/2019,08065263,ESCOLA PUIGSOLER,08262,082628,SANT VICENÇ DE CASTELLET,15,6,21
2018/2019,08065275,ESCOLA VOLERANY,08307,083073,VILANOVA I LA GELTRÚ,25,3,28
2018/2019,08065287,ESCOLA MARTA MATA,08121,081213,MATARÓ,28,0,28
2018/2019,08065299,ESCOLA EL CALDERÍ,08033,080333,CALDES DE MONTBUI,16,0,16
2018/2019,08065305,ESCOLA SOLER DE VILARDELL,08202,082021,SANT CELONI,20,0,20
2018/2019,08065329,INSTITUT DE L'ALT FOIX,08227,082270,SANT MARTÍ SARROCA,22,17,39
2018/2019,08065330,INSTITUT CAL GRAVAT,08113,081136,MANRESA,37,18,55
2018/2019,08065342,INSTITUT XALOC,08231,082310,SANT PERE DE RIBES,15,8,23
2018/2019,08065354,INSTITUT BAIX A MAR,08307,083073,VILANOVA I LA GELTRÚ,34,14,48
2018/2019,08065366,INSTITUT DE PINEDA DE MAR,08163,081635,PINEDA DE MAR,25,11,36
2018/2019,08065391,INSTITUT EL TIL·LER,08086,080863,LES FRANQUESES DEL VALLÈS,23,18,41
2018/2019,08065408,INSTITUT HIPÀTIA D'ALEXANDRIA,08107,081075,LLIÇÀ D'AMUNT,16,6,22
2018/2019,08065411,INSTITUT AIGUAVIVA,08124,081249,MOLLET DEL VALLÈS,33,12,45
2018/2019,08065421,INSTITUT MARTA MATA,08136,081363,MONTORNÈS DEL VALLÈS,31,14,45
2018/2019,08065433,INSTITUT LA SÍNIA,08159,081593,PARETS DEL VALLÈS,14,7,21
2018/2019,08065469,INSTITUT CAN RECORD,08207,082074,SANT ESTEVE DE PALAUTORDERA,19,3,22
2018/2019,08065482,ESCOLA ELS VENTETS - ZER EL MOIANÈS LLEVANT,08070,080706,COLLSUSPINA,3,0,3
2018/2019,08065512,ESCOLA SERRA DE L'OBAC,08279,082798,TERRASSA,25,4,29
2018/2019,08065652,EOI DE L'ALT PENEDÈS,08305,083054,VILAFRANCA DEL PENEDÈS,4,3,7
2018/2019,08065664,EOI DEL BERGUEDÀ,08022,080229,BERGA,4,1,5
2018/2019,08066048,ESCOLA ROSER CAPDEVILA,08279,082798,TERRASSA,30,2,32
2018/2019,08066051,ESCOLA ELS PINETONS,08180,081803,RIPOLLET,36,7,43
2018/2019,08066322,INSTITUT CARDENER,08218,082188,SANT JOAN DE VILATORRADA,15,8,23
2018/2019,08066334,ESCOLA LA SERRETA,08192,081923,SANTPEDOR,13,3,16
2018/2019,08066371,ESCOLA EL DESPUJOL,08117,081173,LES MASIES DE VOLTREGÀ,14,2,16
2018/2019,08066413,ESCOLA COLORS,08086,080863,LES FRANQUESES DEL VALLÈS,16,3,19
2018/2019,08066437,INSTITUT MONT PERDUT,08279,082798,TERRASSA,38,23,61
2018/2019,08066462,ESCOLA DELS ENCANTS,08019,080193,BARCELONA,26,3,29
2018/2019,08066504,ESCOLA L'UNIVERS,08019,080193,BARCELONA,19,3,22
2018/2019,08066516,ESCOLA CONGRÉS-INDIANS,08019,080193,BARCELONA,27,2,29
2018/2019,08066528,INSTITUT MARTÍ POUS,08019,080193,BARCELONA,11,5,16
2018/2019,08066531,ESCOLA FLUVIÀ,08019,080193,BARCELONA,26,3,29
2018/2019,08066541,INSTITUT MARIA ESPINALT,08019,080193,BARCELONA,20,14,34
2018/2019,08066565,INSTITUT 22@,08019,080193,BARCELONA,5,4,9
2018/2019,08066851,EOI DE MOLLET DEL VALLÈS,08124,081249,MOLLET DEL VALLÈS,5,4,9
2018/2019,08066887,EOI DE VILADECANS,08301,083015,VILADECANS,7,3,10
2018/2019,08066905,INSTITUT VILADOMAT,08019,080193,BARCELONA,15,6,21
2018/2019,08067016,ESCOLA ERNEST LLUCH,08101,081017,L'HOSPITALET DE LLOBREGAT,15,5,20
2018/2019,08067041,ESCOLA XORIGUER,08067,080673,CENTELLES,14,1,15
2018/2019,08067090,ESCOLA CAN MANENT,08046,080462,CARDEDEU,24,4,28
2018/2019,08067120,ESCOLA SANTA AGNÈS DE MALANYANES,08181,081810,LA ROCA DEL VALLÈS,13,1,14
2018/2019,08067132,ESCOLA JOSEFINA IBÁÑEZ,08001,080018,ABRERA,17,1,18
2018/2019,08067144,INSTITUT DE CERVELLÓ,08068,080689,CERVELLÓ,21,12,33
2018/2019,08067181,ESCOLA DE RELLINARS,08179,081799,RELLINARS,7,3,10
2018/2019,08067193,ESCOLA DEL BOSC,08184,081846,RUBÍ,21,3,24
2018/2019,08067201,ESCOLA LOLA ANGLADA,08238,082384,SANT QUIRZE DEL VALLÈS,23,5,28
2018/2019,08067211,INSTITUT SALAS I XANDRI,08238,082384,SANT QUIRZE DEL VALLÈS,15,7,22
2018/2019,08067235,ESCOLA ROC ALABERN,08279,082798,TERRASSA,24,6,30
2018/2019,08067247,ESCOLA EL VAPOR,08279,082798,TERRASSA,28,4,32
2018/2019,08067430,ESCOLA MONTSERRAT SOLÀ,08121,081213,MATARÓ,25,5,30
2018/2019,08067582,ESCOLA MARTA MATA,08252,082520,BARBERÀ DEL VALLÈS,17,3,20
2018/2019,08067594,INSTITUT ESCOLA LES VINYES,08054,080543,CASTELLBISBAL,35,10,45
2018/2019,08067600,ESCOLA VALLDAURA,08113,081136,MANRESA,19,1,20
2018/2019,08067636,INSTITUT MANRESA SIS,08113,081136,MANRESA,7,4,11
2018/2019,08067648,INSTITUT LES VINYES,08074,080749,CUBELLES,15,9,24
2018/2019,08067661,ESCOLA JOAN COROMINES,08121,081213,MATARÓ,25,3,28
2018/2019,08067764,ESCOLA LA MAQUINISTA,08019,080193,BARCELONA,29,1,30
2018/2019,08067818,ESCOLA LA SÍNIA,08298,082981,VIC,33,2,35
2018/2019,08068136,CFA VÍCTOR CATALÀ,08208,082080,SANT ESTEVE SESROVIRES,18,5,23
2018/2019,08068197,ZER EL CARDENER,08229,082299,SANT MATEU DE BAGES,1,2,3
2018/2019,08068331,ESCOLA BADALONA PORT,08015,080155,BADALONA,13,3,16
2018/2019,08068343,ESCOLA LES CIÈNCIES,08015,080155,BADALONA,15,3,18
2018/2019,08068379,ESCOLA MAR NOVA,08172,081727,PREMIÀ DE MAR,13,0,13
2018/2019,08068380,INSTITUT GURB,08100,081000,GURB,21,11,32
2018/2019,08068410,ESCOLA PALAU D'AMETLLA,08136,081363,MONTORNÈS DEL VALLÈS,12,7,19
2018/2019,08068495,INSTITUT JOSEFINA CASTELLVÍ I PIULACHS,08301,083015,VILADECANS,32,13,45
2018/2019,08068537,INSTITUT LES AIMERIGUES,08279,082798,TERRASSA,33,13,46
2018/2019,08068616,INSTITUT BAGES SUD,08053,080538,CASTELLBELL I EL VILAR,15,5,20
2018/2019,08069499,ESCOLA VIC-CENTRE,08298,082981,VIC,18,3,21
2018/2019,08069581,CFA CARME KARR,08218,082188,SANT JOAN DE VILATORRADA,12,3,15
2018/2019,08069736,ESCOLA PACO CANDEL,08101,081017,L'HOSPITALET DE LLOBREGAT,26,3,29
2018/2019,08069748,ESCOLA MONTIGALÀ,08015,080155,BADALONA,13,2,15
2018/2019,08069751,ESCOLA SANTA COLOMA,08245,082457,SANTA COLOMA DE GRAMENET,17,2,19
2018/2019,08070040,ESCOLA SALA I BADRINAS,08279,082798,TERRASSA,23,2,25
2018/2019,08070143,ESCOLA RIERA ALTA,08245,082457,SANTA COLOMA DE GRAMENET,26,3,29
2018/2019,08070234,ESCOLA CAN FABRA,08019,080193,BARCELONA,27,2,29
2018/2019,08070799,ESCOLA TIZIANA,08282,082824,TIANA,16,1,17
2018/2019,08070908,INSTITUT ESCOLA LA TORDERA,08259,082592,SANTA MARIA DE PALAUTORDERA,45,5,50
2018/2019,08071020,ESCOLA ENXANETA,08301,083015,VILADECANS,19,3,22
2018/2019,08071147,ESCOLA ROSER CAPDEVILA,08217,082172,SANT JOAN DESPÍ,25,4,29
2018/2019,08071172,ESCOLA VIROLET,08187,081878,SABADELL,20,8,28
2018/2019,08071196,INSTITUT CAN ROCA,08279,082798,TERRASSA,33,17,50
2018/2019,08071214,INSTITUT ESCOLA CASTELLTERÇOL,08064,080641,CASTELLTERÇOL,28,7,35
2018/2019,08071226,INSTITUT ESCOLA COSTA I LLOBERA,08019,080193,BARCELONA,39,25,64
2018/2019,08071238,INSTITUT ESCOLA JACINT VERDAGUER,08240,082401,SANT SADURNÍ D'ANOIA,39,16,55
2018/2019,08071317,INSTITUT VALL DEL MEDIONA,08236,082362,SANT QUINTÍ DE MEDIONA,14,9,23
2018/2019,08071421,ZER EL MOIANÈS LLEVANT,08055,080556,CASTELLCIR,2,2,4
2018/2019,08071573,EASD ESCOLA SUP. DE DISSENY I D'ARTS PLÀSTIQUES - ESDAP,08019,080193,BARCELONA,2,1,3
2018/2019,08071691,INSTITUT ESCOLA DEL PRAT,08169,081691,EL PRAT DE LLOBREGAT,21,9,30
2018/2019,08072176,INSTITUT DEL TER,08112,081120,MANLLEU,20,6,26
2018/2019,08072188,INSTITUT ESCOLA SANT JORDI,08141,081419,NAVÀS,41,10,51
2018/2019,08072255,INSTITUT PREMIÀ DE MAR,08172,081727,PREMIÀ DE MAR,54,51,105
2018/2019,08072292,INSTITUT ESCOLA TURÓ DE ROQUETES,08019,080193,BARCELONA,47,13,60
2018/2019,08072383,INSTITUT DOMUS D'OLIVET,08041,080410,CANOVELLES,17,9,26
2018/2019,08072395,ESCOLA POLINYÀ,08167,081672,POLINYÀ,15,2,17
2018/2019,08072401,INSTITUT TORRENT DELS ALOUS,08184,081846,RUBÍ,35,15,50
2018/2019,08072589,EOI GUINARDÓ,08019,080193,BARCELONA,5,5,10
2018/2019,08072590,EOI DE RUBÍ,08184,081846,RUBÍ,4,2,6
2018/2019,08072607,EOI DE CORNELLÀ DE LLOBREGAT,08073,080734,CORNELLÀ DE LLOBREGAT,7,3,10
2018/2019,08072978,INSTITUT SUNSI MÓRA,08040,080403,CANET DE MAR,14,14,28
2018/2019,08073028,INSTITUT DE SANT POL DE MAR,08235,082359,SANT POL DE MAR,25,12,37
2018/2019,08073031,INSTITUT DE CORNELLÀ,08073,080734,CORNELLÀ DE LLOBREGAT,20,6,26
2018/2019,08073077,INSTITUT MARIA CANELA,08114,081141,MARTORELL,17,5,22
2018/2019,08073119,INSTITUT CAN PERIQUET,08156,081568,PALAU-SOLITÀ I PLEGAMANS,10,3,13
2018/2019,08073171,INSTITUT LA RIERA,08015,080155,BADALONA,10,3,13
2018/2019,08073193,INSTITUT BADIA I MARGARIT,08102,081022,IGUALADA,13,15,28
2018/2019,08073651,INSTITUT PIC DEL VENT,08033,080333,CALDES DE MONTBUI,15,8,23
2018/2019,08073843,INSTITUT TORDÀRIA,08284,082845,TORDERA,15,8,23
2018/2019,08073958,ESCOLA NOVA ARGENTONA,08009,080095,ARGENTONA,20,4,24
2018/2019,08073961,INSTITUT PLA DEL BOSC,08043,080431,CANYELLES,15,6,21
2018/2019,08074070,EOI DE CALELLA,08035,080351,CALELLA,4,3,7
2018/2019,08074380,ESCOLA CASTELL DE DOSRIUS,08075,080752,DOSRIUS,23,8,31
2018/2019,08074410,INSTITUT LA SERRA,08187,081878,SABADELL,14,5,19
2018/2019,08074483,ESCOLA PEPA COLOMER,08169,081691,EL PRAT DE LLOBREGAT,32,4,36
2018/2019,08074631,INSTITUT LES SALINES,08169,081691,EL PRAT DE LLOBREGAT,38,41,79
2018/2019,08074641,ESCOLA 30 PASSOS,08019,080193,BARCELONA,12,1,13
2018/2019,08074801,INSTITUT MARTA ESTRADA,08096,080961,GRANOLLERS,14,8,22
2018/2019,08074811,ESCOLA DE GRANOLLERS,08096,080961,GRANOLLERS,24,6,30
2018/2019,08074823,ESCOLA ELS PICOTS,08107,081075,LLIÇÀ D'AMUNT,26,4,30
2018/2019,08074835,ESCOLA JAUME LLULL,08197,081976,SANT ANDREU DE LLAVANERES,25,7,32
2018/2019,08074847,INSTITUT DE NÀUTICA DE BARCELONA,08019,080193,BARCELONA,8,18,26
2018/2019,08075074,INSTITUT DE SANTA COLOMA DE GRAMENET,08245,082457,SANTA COLOMA DE GRAMENET,4,3,7
2018/2019,08075207,ESCOLA ENTENÇA,08019,080193,BARCELONA,12,0,12
2018/2019,08075244,ESCOLA LES BASES,08113,081136,MANRESA,6,1,7
2018/2019,08075256,INSTITUT ESCOLA MARTA MATA,08285,082858,TORELLÓ,37,7,44
2018/2019,08075268,ESCOLA LA MIRADA,08205,082055,SANT CUGAT DEL VALLÈS,12,1,13
2018/2019,08075281,INSTITUT BITÀCOLA,08252,082520,BARBERÀ DEL VALLÈS,10,7,17
2018/2019,08075293,INSTITUT ESCOLA GAVÀ MAR,08089,080898,GAVÀ,36,6,42
2018/2019,08075384,INSTITUT ESCOLA LA MINA,08194,081944,SANT ADRIÀ DE BESÒS,48,20,68
2018/2019,08075608,ESCOLA 9 GRAONS,08019,080193,BARCELONA,4,3,7
2018/2019,08075611,ESCOLA GAIA,08019,080193,BARCELONA,11,0,11
2018/2019,08075621,ESCOLA TEIXIDORES DE GRÀCIA,08019,080193,BARCELONA,7,0,7
2018/2019,08075633,ESCOLA ANGLESOLA,08019,080193,BARCELONA,5,2,7
2018/2019,08075645,ESCOLA LA FLOR DE MAIG,08019,080193,BARCELONA,11,0,11
2018/2019,08075657,INSTITUT ESCOLA ANTAVIANA,08019,080193,BARCELONA,35,12,47
2018/2019,08075669,INSTITUT ESCOLA EL TIL·LER,08019,080193,BARCELONA,20,5,25
2018/2019,08075670,INSTITUT ESCOLA TRINITAT NOVA,08019,080193,BARCELONA,40,13,53
2018/2019,08075682,INSTITUT VILADECANS VI,08301,083015,VILADECANS,10,6,16
2018/2019,08075700,ESCOLA XIRINACS,08019,080193,BARCELONA,6,1,7
2018/2019,08075712,INSTITUT LES CINC SÉNIES,08121,081213,MATARÓ,12,5,17
2018/2019,08075724,ESCOLA NORAI,08126,081265,MONTGAT,4,0,4
2018/2019,08076091,INSTITUT CA N'ORIAC,08187,081878,SABADELL,5,2,7
2018/2019,08076108,INSTITUT JOAN MARQUÈS,08279,082798,TERRASSA,6,1,7
2018/2019,08076111,INSTITUT NOU DE L'HOSPITALET DE LLOBREGAT,08101,081017,L'HOSPITALET DE LLOBREGAT,17,11,28
2018/2019,08076145,INSTITUT ESCOLA MAR MEDITERRÀNIA,08121,081213,MATARÓ,34,7,41
2018/2019,08076157,INSTITUT ESCOLA ÀNGELA BRANSUELA,08121,081213,MATARÓ,22,8,30
2018/2019,08076169,INSTITUT ESCOLA GORNAL,08101,081017,L'HOSPITALET DE LLOBREGAT,16,8,24
2018/2019,08076194,INSTITUT TECNOLÒGIC DE BARCELONA,08019,080193,BARCELONA,6,7,13
2018/2019,17000019,ESCOLA LLUÍS MARIÀ VIDAL - ZER LES SALINES,17001,170010,AGULLANA,6,2,8
2018/2019,17000032,ESCOLA VILADEMANY,17002,170025,AIGUAVIVA,12,2,14
2018/2019,17000056,ESCOLA LA BRANCA - ZER MONTGRÍ,17004,170046,ALBONS,7,0,7
2018/2019,17000068,ESCOLA DEL FAR D'EMPORDÀ,17005,170059,EL FAR D'EMPORDÀ,12,0,12
2018/2019,17000071,ESCOLA BAC DE CERDANYA,17006,170062,ALP,15,1,16
2018/2019,17000093,ESCOLA GASPAR DE QUERALT,17007,170078,AMER,15,2,17
2018/2019,17000123,ESCOLA SANT JORDI,17903,179032,SANT JULIÀ DEL LLOR I BONMATÍ,15,0,15
2018/2019,17000135,ESCOLA POMPEU FABRA,17008,170084,ANGLÈS,28,5,33
2018/2019,17000160,ESCOLA DOCTOR CARULLA,17009,170097,ARBÚCIES,30,3,33
2018/2019,17000241,ESCOLA FLUVIANETS,17011,170118,L'ARMENTERA,12,2,14
2018/2019,17000251,ESCOLA GONÇAL COMELLAS,17012,170123,AVINYONET DE PUIGVENTÓS,14,1,15
2018/2019,17000263,ESCOLA DOCTOR ARRUGA,17013,170139,BEGUR,12,4,16
2018/2019,17000305,INSTITUT PERE ALSIUS I TORRENT,17015,170157,BANYOLES,38,24,62
2018/2019,17000329,ESCOLA PLA DE L'AMETLLER,17015,170157,BANYOLES,28,3,31
2018/2019,17000330,INSTITUT JOSEP BRUGULAT,17015,170157,BANYOLES,52,35,87
2018/2019,17000342,ESCOLA BALDIRI REIXAC,17015,170157,BANYOLES,26,5,31
2018/2019,17000354,ESCOLA JOAN REGLÀ,17016,170160,BÀSCARA,15,0,15
2018/2019,17000381,ESCOLA EL RAJARET - ZER MONTGRÍ,17018,170182,BELLCAIRE D'EMPORDÀ,7,0,7
2018/2019,17000408,ESCOLA DOCTOR SOBREQUÉS,17020,170209,BESCANÓ,34,4,38
2018/2019,17000411,ESCOLA JOAN DE MARGARIT,17022,170221,LA BISBAL D'EMPORDÀ,24,5,29
2018/2019,17000469,ESCOLA JOAQUIM RUYRA,17023,170237,BLANES,19,1,20
2018/2019,17000470,ESCOLA CARLES FAUST,17023,170237,BLANES,11,5,16
2018/2019,17000548,ESCOLA MOSSÈN JOAN BATLLE,17023,170237,BLANES,21,7,28
2018/2019,17000551,INSTITUT SA PALOMERA,17023,170237,BLANES,47,27,74
2018/2019,17000561,ESCOLA DE BORDILS,17025,170255,BORDILS,14,3,17
2018/2019,17000573,ESCOLA SANT ANDREU DE BORRASSÀ,17026,170268,BORRASSÀ,10,0,10
2018/2019,17000585,ESCOLA MONTSENY,17027,170274,BREDA,22,5,27
2018/2019,17000603,ESCOLA SANTA CECÍLIA - ZER LES SALINES,17029,170293,BOADELLA I LES ESCAULES,3,0,3
2018/2019,17000627,ESCOLA CARITAT SERINYANA,17032,170329,CADAQUÉS,15,4,19
2018/2019,17000676,ESCOLA SANT ESTEVE,17033,170335,CALDES DE MALAVELLA,23,4,27
2018/2019,17000688,ESCOLA PERE ROSSELLÓ,17034,170340,CALONGE I SANT ANTONI,29,2,31
2018/2019,17000706,INSTITUT PUIG CARGOL,17034,170340,CALONGE I SANT ANTONI,32,15,47
2018/2019,17000718,ESCOLA LLEVANTÍ DE MAR,17034,170340,CALONGE I SANT ANTONI,15,1,16
2018/2019,17000731,ESCOLA PIRINEU,17036,170366,CAMPDEVÀNOL,21,1,22
2018/2019,17000779,ESCOLA DOCTOR ROBERT,17039,170391,CAMPRODON,18,2,20
2018/2019,17000822,ESCOLA ELS DÒLMENS - ZER REQUESENS,17042,170427,CAPMANY,2,2,4
2018/2019,17000846,ESCOLA PUIG D'ARQUES,17044,170448,CASSÀ DE LA SELVA,24,5,29
2018/2019,17000861,ESCOLA CASTELLROC,17046,170464,CASTELLFOLLIT DE LA ROCA,11,1,12
2018/2019,17000871,ESCOLA RUIZ AMADO,17047,170470,CASTELLÓ D'EMPÚRIES,27,3,30
2018/2019,17000883,ESCOLA VALL D'ARO,17048,170486,CASTELL-PLATJA D'ARO,13,3,16
2018/2019,17000895,ESCOLA ELS ESTANYS,17048,170486,CASTELL-PLATJA D'ARO,26,5,31
2018/2019,17000913,ESCOLA L'AULET,17049,170499,CELRÀ,23,3,26
2018/2019,17000925,ESCOLA L'AIXART,17050,170502,CERVIÀ DE TER,12,1,13
2018/2019,17000937,ESCOLA MOSSÈN JOSEP MARIA ALBERT - ZER EMPORDÀ,17051,170519,CISTELLA,2,0,2
2018/2019,17000950,ESCOLA PUIG D'ESQUERS - ZER CAP DE CREUS,17054,170545,COLERA,3,0,3
2018/2019,17000986,ESCOLA LA VALL DEL TERRI,17056,170561,CORNELLÀ DEL TERRI,21,3,24
2018/2019,17000998,ESCOLA EL RODONELL,17057,170577,CORÇÀ,14,2,16
2018/2019,17001024,ESCOLA LES GAVARRES - ZER EMPORDANET-GAVARRES,17901,179011,"CRUÏLLES, MONELLS I SANT SADURNÍ L'HEURA",6,0,6
2018/2019,17001036,ESCOLA MONT-ROIG - ZER REQUESENS,17060,170600,DARNIUS,3,1,4
2018/2019,17001048,ESCOLA EMPÚRIES,17062,170622,L'ESCALA,34,6,40
2018/2019,17001085,ESCOLA ANTONI BALMANYA - ZER REQUESENS,17064,170643,ESPOLLA,4,0,4
2018/2019,17001097,ESCOLA CARLES DE FORTUNY,17065,170656,ESPONELLÀ,8,0,8
2018/2019,17001103,ESCOLA SALVADOR DALÍ,17066,170669,FIGUERES,30,3,33
2018/2019,17001115,ESCOLA JOSEP POUS I PAGÈS,17066,170669,FIGUERES,19,4,23
2018/2019,17001218,INSTITUT RAMON MUNTANER,17066,170669,FIGUERES,49,18,67
2018/2019,17001221,INSTITUT NARCÍS MONTURIOL,17066,170669,FIGUERES,49,33,82
2018/2019,17001279,ESCOLA SANT PAU,17066,170669,FIGUERES,26,6,32
2018/2019,17001280,ESCOLA JOAQUIM CUSÍ I FURTUNET,17066,170669,FIGUERES,25,7,32
2018/2019,17001292,ESCOLA LES MORERES,17067,170675,FLAÇÀ,12,3,15
2018/2019,17001346,ESCOLA FORN D'ANELLS,17073,170736,FORNELLS DE LA SELVA,21,4,25
2018/2019,17001361,ESCOLA TERESA DE PALLEJÀ,17074,170741,FORTIÀ,12,0,12
2018/2019,17001371,ESCOLA DE GARRIGÀS - ZER EMPORDÀ,17075,170754,GARRIGÀS,3,0,3
2018/2019,17001383,ESCOLA JOAQUIM GIFRE,17077,170773,GARRIGUELLA,11,4,15
2018/2019,17001395,ESCOLA SANTA COLOMA - ZER CERDANYA,17078,170789,GER,7,1,8
2018/2019,17001425,ESCOLA EIXIMENIS,17079,170792,GIRONA,16,1,17
2018/2019,17001449,ESCOLA ANNEXA - JOAN PUIGBERT,17079,170792,GIRONA,25,5,30
2018/2019,17001450,ESCOLA JOAN BRUGUERA,17079,170792,GIRONA,13,3,16
2018/2019,17001462,ESCOLA VERD,17079,170792,GIRONA,16,2,18
2018/2019,17001486,ESCOLA MONTJUÏC,17079,170792,GIRONA,15,3,18
2018/2019,17001516,ESCOLA PLA DE GIRONA,17079,170792,GIRONA,25,3,28
2018/2019,17001693,CEE FONT DE L'ABELLA,17079,170792,GIRONA,37,5,42
2018/2019,17001723,INSTITUT JAUME VICENS VIVES,17079,170792,GIRONA,53,21,74
2018/2019,17001735,INSTITUT MONTILIVI,17079,170792,GIRONA,88,62,150
2018/2019,17001759,INSTITUT ESCOLA D'HOSTALERIA I TURISME DE GIRONA,17079,170792,GIRONA,23,23,46
2018/2019,17001838,ESCOLA ÀGORA,17079,170792,GIRONA,16,2,18
2018/2019,17001887,ESCOLA CARME AUGUET,17079,170792,GIRONA,13,2,15
2018/2019,17001930,ESCOLA JOSEP DALMAU I CARLES,17079,170792,GIRONA,26,6,32
2018/2019,17001954,ESCOLA DE VILA-ROJA,17079,170792,GIRONA,13,0,13
2018/2019,17001981,ESCOLA MARE DE DÉU DELS SOCORS,17083,170834,HOSTALRIC,28,3,31
2018/2019,17002004,ESCOLA JOSEP PEÑUELAS DEL RIO,17086,170865,LA JONQUERA,23,8,31
2018/2019,17002028,ESCOLA MONTSERRAT VAYREDA I TRULLOL,17088,170887,LLADÓ,10,2,12
2018/2019,17002031,ESCOLA LACUSTÀRIA,17089,170890,LLAGOSTERA,31,2,33
2018/2019,17002065,ESCOLA LES MORERES - ZER VALL DE TER,17091,170911,LLANARS,4,0,4
2018/2019,17002077,ESCOLA POMPEU FABRA,17092,170926,LLANÇÀ,25,5,30
2018/2019,17002089,ESCOLA DE LLERS,17093,170932,LLERS,13,2,15
2018/2019,17002090,ESCOLA JAUME I - ZER CERDANYA,17094,170947,LLÍVIA,8,1,9
2018/2019,17002107,ESCOLA PERE TORRENT,17095,170950,LLORET DE MAR,31,7,38
2018/2019,17002168,ESCOLA LES SALINES - ZER LES SALINES,17102,171024,MAÇANET DE CABRENYS,4,1,5
2018/2019,17002181,ESCOLA SANT JORDI,17103,171030,MAÇANET DE LA SELVA,21,9,30
2018/2019,17002193,ESCOLA SANTA FE,17904,,MEDINYÀ,10,2,12
2018/2019,17002201,ESCOLA FINESTRES,17105,171058,MIERES,7,0,7
2018/2019,17002247,ESCOLA MONT CÓS - ZER EL LLIERCA,17109,171096,MONTAGUT I OIX,8,0,8
2018/2019,17002259,ESCOLA TORRES JONAMA,17110,171100,MONT-RAS,12,4,16
2018/2019,17002260,ESCOLA JOAQUIM VALLMAJÓ,17111,171117,NAVATA,14,1,15
2018/2019,17002296,ESCOLA MALAGRIDA,17114,171143,OLOT,29,2,31
2018/2019,17002302,ESCOLA LLAR LLUÍS MARIA MESTRES I MARTÍ,17114,171143,OLOT,15,4,19
2018/2019,17002314,ESCOLA PLA DE DALT,17114,171143,OLOT,25,4,29
2018/2019,17002326,ESCOLA VOLCÀ BISAROQUES,17114,171143,OLOT,28,2,30
2018/2019,17002387,INSTITUT MONTSACOPA,17114,171143,OLOT,51,13,64
2018/2019,17002399,INSTITUT LA GARROTXA,17114,171143,OLOT,68,40,108
2018/2019,17002429,ESCOLA SANT ROC,17114,171143,OLOT,27,3,30
2018/2019,17002430,ESCOLA MARIA PAGÈS I TRAYTER,17115,171156,ORDIS,3,3,6
2018/2019,17002442,ESCOLA LA VALL,17116,171169,OSOR,5,1,6
2018/2019,17002481,ESCOLA TORRES JONAMA,17117,171175,PALAFRUGELL,33,3,36
2018/2019,17002491,ESCOLA JOSEP BARCELÓ I MATAS,17117,171175,PALAFRUGELL,28,8,36
2018/2019,17002545,INSTITUT FREDERIC MARTÍ I CARRERAS,17117,171175,PALAFRUGELL,47,24,71
2018/2019,17002557,INSTITUT BAIX EMPORDÀ,17117,171175,PALAFRUGELL,59,46,105
2018/2019,17002569,ESCOLA LA VILA,17118,171181,PALAMÓS,30,2,32
2018/2019,17002612,ESCOLA VILA-ROMÀ,17118,171181,PALAMÓS,25,4,29
2018/2019,17002624,ESCOLA MARTÍ INGLÈS,17120,171208,PALAU-SAVERDERA,14,1,15
2018/2019,17002651,ESCOLA QUERMANY,17124,171241,PALS,16,2,18
2018/2019,17002703,ESCOLA PAU,17128,171289,PAU,5,3,8
2018/2019,17002715,ESCOLA PEDRA BLANCA - ZER EMPORDANET-GAVARRES,17130,171306,LA PERA,5,1,6
2018/2019,17002740,ESCOLA RAMON MUNTANER,17132,171328,PERALADA,15,1,16
2018/2019,17002752,ESCOLA SANT CRISTÒFOL,17133,171334,LES PLANES D'HOSTOLES,16,1,17
2018/2019,17002764,ESCOLA NÚRIA MORER I PI - ZER COMTE ARNAU,17134,171349,PLANOLES,4,0,4
2018/2019,17002776,ESCOLA TRAMUNTANA - ZER EMPORDÀ,17135,171352,PONT DE MOLINS,4,1,5
2018/2019,17002791,ESCOLA L'ENTORN,17137,171371,PORQUERES,27,5,32
2018/2019,17002818,ESCOLA FRIGOLET,17137,171371,PORQUERES,9,1,10
2018/2019,17002831,ESCOLA SANT JAUME,17138,171387,PORTBOU,6,1,7
2018/2019,17002879,ESCOLA LES CLISQUES - ZER CAP DE CREUS,17140,171404,EL PORT DE LA SELVA,6,0,6
2018/2019,17002880,ESCOLA ALFONS I,17141,171411,PUIGCERDÀ,29,5,34
2018/2019,17002922,ESCOLA SANTA MARGARIDA,17142,171426,QUART,18,3,21
2018/2019,17002958,ESCOLA MARE DE DÉU DE NÚRIA,17145,171450,RIBES DE FRESER,14,1,15
2018/2019,17002983,ESCOLA EL BRUC,17146,171463,RIELLS I VIABREA,15,2,17
2018/2019,17002995,ESCOLA JOAN MARAGALL,17147,171479,RIPOLL,21,1,22
2018/2019,17003070,ESCOLA JOSEP BOADA,17148,171485,RIUDARENES,17,0,17
2018/2019,17003082,ESCOLA LLUÍS CASTELLS,17149,171498,RIUDAURA,8,3,11
2018/2019,17003094,ESCOLA DE RIUDELLOTS DE LA SELVA,17150,171501,RIUDELLOTS DE LA SELVA,16,2,18
2018/2019,17003136,ESCOLA NARCÍS MONTURIOL,17152,171523,ROSES,15,2,17
2018/2019,17003151,ESCOLA SILVESTRE SANTALÓ,17155,171557,SALT,20,5,25
2018/2019,17003203,INSTITUT SALVADOR ESPRIU,17155,171557,SALT,48,17,65
2018/2019,17003215,ESCOLA LA FARGA,17155,171557,SALT,31,6,37
2018/2019,17003227,ESCOLA SANT SEBASTIÀ - ZER REQUESENS,17158,171582,SANT CLIMENT SESCEBES,6,0,6
2018/2019,17003264,ESCOLA GAZIEL,17160,171609,SANT FELIU DE GUÍXOLS,22,7,29
2018/2019,17003306,INSTITUT SANT ELM,17160,171609,SANT FELIU DE GUÍXOLS,31,14,45
2018/2019,17003318,INSTITUT DE SANT FELIU DE GUÍXOLS,17160,171609,SANT FELIU DE GUÍXOLS,66,30,96
2018/2019,17003321,ESCOLA MOSSÈN BALDIRI REIXACH,17160,171609,SANT FELIU DE GUÍXOLS,25,6,31
2018/2019,17003343,ESCOLA ROCALBA,17161,171616,SANT FELIU DE PALLEROLS,13,2,15
2018/2019,17003392,ESCOLA AGUSTÍ GIFRE,17163,171637,SANT GREGORI,29,8,37
2018/2019,17003422,ESCOLA TAIALÀ,17079,170792,GIRONA,35,4,39
2018/2019,17003434,ESCOLA GUILLERIES,17164,171642,SANT HILARI SACALM,26,4,30
2018/2019,17003461,ESCOLA LES ESCOMES - ZER EL LLIERCA,17165,171655,SANT JAUME DE LLIERCA,9,0,9
2018/2019,17003471,ESCOLA SANT JORDI,17166,171668,SANT JORDI DESVALLS,9,1,10
2018/2019,17003537,ESCOLA DE VALLFOGONA DE RIPOLLÈS - ZER COMTE ARNAU,17170,171707,VALLFOGONA DE RIPOLLÈS,2,0,2
2018/2019,17003598,ESCOLA VALLGARRIGA,17175,171753,SANT MIQUEL DE FLUVIÀ,6,4,10
2018/2019,17003616,ESCOLA ELS PINETS - ZER VALL DE TER,17177,171772,SANT PAU DE SEGÚRIES,7,0,7
2018/2019,17003628,ESCOLA LLAGUT,17178,171788,SANT PERE PESCADOR,17,6,23
2018/2019,17003631,ESCOLA LA PEDRA DRETA - ZER EMPORDANET-GAVARRES,17901,179011,"CRUÏLLES, MONELLS I SANT SADURNÍ L'HEURA",4,1,5
2018/2019,17003641,ESCOLA SANT SALVADOR D'HORTA,17180,171805,SANTA COLOMA DE FARNERS,31,2,33
2018/2019,17003689,ESCOLA PEDRALTA,17181,171812,SANTA CRISTINA D'ARO,24,5,29
2018/2019,17003719,ESCOLA JOAN MARAGALL,17184,171848,SANTA PAU,12,3,15
2018/2019,17003732,ESCOLA CASTANYER,17185,171851,SANT JOAN LES FONTS,17,2,19
2018/2019,17003756,ESCOLA MONTSERRAT,17186,171864,SARRIÀ DE TER,27,3,30
2018/2019,17003768,ESCOLA ELS TERRAPRIMS,17187,171870,"SAUS, CAMALLERA I LLAMPAIES",15,0,15
2018/2019,17003781,ESCOLA JUNCADELLA,17189,171899,LA CELLERA DE TER,14,2,16
2018/2019,17003801,ESCOLA BORA GRAN,17190,171903,SERINYÀ,14,2,16
2018/2019,17003823,ESCOLA VERDAGUER,17193,171931,SILS,24,3,27
2018/2019,17003860,ESCOLA PORTITXOL,17199,171997,TORROELLA DE MONTGRÍ,19,5,24
2018/2019,17003872,ESCOLA GUILLEM DE MONTGRÍ,17199,171997,TORROELLA DE MONTGRÍ,37,8,45
2018/2019,17003902,ESCOLA JOAN ROURA I PARELLA - ZER EL LLIERCA,17200,172001,TORTELLÀ,6,3,9
2018/2019,17003926,ESCOLA IGNASI MELÉ I FARRÉ,17202,172023,TOSSA DE MAR,27,5,32
2018/2019,17003938,ESCOLA PUIG RODÓ - ZER MONTGRÍ,17204,172044,ULLÀ,6,0,6
2018/2019,17003941,ESCOLA L'ESTANY - ZER EMPORDANET-GAVARRES,17205,172057,ULLASTRET,4,0,4
2018/2019,17003951,PARVULARI DE SANT ESTEVE D'EN BAS,17207,172076,LA VALL D'EN BAS,4,0,4
2018/2019,17004001,ESCOLA VERNTALLAT,17207,172076,LA VALL D'EN BAS,21,2,23
2018/2019,17004049,ESCOLA OLIVERES MIL·LENÀRIES - ZER TRAMUNTANA,17210,172109,VENTALLÓ,8,0,8
2018/2019,17004062,ESCOLA SANTA BÀRBARA - ZER ELS CASTELLS,17212,172121,VIDRÀ,2,0,2
2018/2019,17004074,ESCOLA SANT ISCLE,17213,172137,VIDRERES,20,4,24
2018/2019,17004098,ESCOLA TORRE D'EN REIG,17214,172142,VILABERTRAN,15,1,16
2018/2019,17004116,ESCOLA MADRENC,17215,172155,VILABLAREIX,23,1,24
2018/2019,17004128,ESCOLA PUIG SEGALAR - ZER TRAMUNTANA,17217,172174,VILADAMAT,3,1,4
2018/2019,17004153,ESCOLA DE SANT ESTEVE DE GUIALBES,17218,172180,VILADEMULS,9,3,12
2018/2019,17004189,ESCOLA ELS CASTANYERS - ZER GUILLERIES,17220,172207,VILADRAU,7,1,8
2018/2019,17004190,ESCOLA SOL I VENT,17221,172214,VILAFANT,14,2,16
2018/2019,17004207,ESCOLA SANTIAGO RATÉS,17223,172235,VILAJUÏGA,13,3,16
2018/2019,17004219,ESCOLA LA DAINA - ZER VALL DE TER,17224,172240,VILALLONGA DE TER,3,0,3
2018/2019,17004220,ESCOLA ELS VALENTINS - ZER TRAMUNTANA,17225,172253,VILAMACOLUM,3,2,5
2018/2019,17004232,ESCOLA JOSEP DE RIBOT I OLIVAS,17226,172266,VILAMALLA,14,2,16
2018/2019,17004244,ESCOLA TRAMUNTANA - ZER EMPORDÀ,17228,172288,VILANANT,3,0,3
2018/2019,17004281,ESCOLA JOSEP MADRENYS,17233,172333,VILOBÍ D'ONYAR,21,2,23
2018/2019,17004293,ESCOLA MANUEL DE PEDROLO - ZER LES SALINES,17234,172348,BIURE,2,1,3
2018/2019,17004335,ESCOLA SANTA EUGÈNIA,17079,170792,GIRONA,17,1,18
2018/2019,17004347,ESCOLA FONT DE LA PÓLVORA,17079,170792,GIRONA,13,2,15
2018/2019,17004360,CEE LA MAÇANA,17155,171557,SALT,10,0,10
2018/2019,17004438,INSTITUT ALEXANDRE DEULOFEU,17066,170669,FIGUERES,49,27,76
2018/2019,17004451,ESCOLA JAUME VICENS I VIVES,17152,171523,ROSES,24,6,30
2018/2019,17004463,ESCOLA ANICET DE PAGÈS I DE PUIG,17066,170669,FIGUERES,26,7,33
2018/2019,17004487,INSTITUT RAFAEL CAMPALANS,17008,170084,ANGLÈS,33,21,54
2018/2019,17004499,INSTITUT NARCÍS XIFRA I MASMITJÀ,17079,170792,GIRONA,90,46,136
2018/2019,17004517,INSTITUT ANTON BUSQUETS I PUNSET,17164,171642,SANT HILARI SACALM,19,8,27
2018/2019,17004529,ESCOLA MIGDIA,17079,170792,GIRONA,27,2,29
2018/2019,17004530,INSTITUT SANTIAGO SOBREQUÉS I VIDAL,17079,170792,GIRONA,44,22,66
2018/2019,17004566,ESCOLA NAPOLEÓ SOLIVA,17023,170237,BLANES,21,5,26
2018/2019,17004578,INSTITUT CASTELL D'ESTELA,17007,170078,AMER,19,12,31
2018/2019,17004657,ESCOLA ESTEVE CARLES,17095,170950,LLORET DE MAR,19,3,22
2018/2019,17004682,ESCOLA L'ESTACIÓ,17160,171609,SANT FELIU DE GUÍXOLS,26,5,31
2018/2019,17004694,ESCOLA CASSIÀ COSTAL,17079,170792,GIRONA,25,4,29
2018/2019,17004712,CEE VENTIJOL,17023,170237,BLANES,22,3,25
2018/2019,17004724,CEE PALAU,17079,170792,GIRONA,15,2,17
2018/2019,17004736,CEE ELS ÀNGELS,17118,171181,PALAMÓS,21,1,22
2018/2019,17004748,CEE MARE DE DÉU DEL MONT,17221,172214,VILAFANT,24,3,27
2018/2019,17004751,ESCOLA TOMÀS RAGUER,17147,171479,RIPOLL,14,3,17
2018/2019,17004761,CEE DOCTOR RAMON SURIÑACH,17147,171479,RIPOLL,7,0,7
2018/2019,17004827,ESCOLA ALZINA RECLAMADORA,17071,170715,FONTCOBERTA,14,1,15
2018/2019,17004852,EOI DE GIRONA,17079,170792,GIRONA,32,7,39
2018/2019,17004864,ESCOLA EL PLA,17155,171557,SALT,28,9,37
2018/2019,17004876,ESCOLA L'OLIVAR VELL,17013,170139,BEGUR,9,2,11
2018/2019,17004888,ESCOLA SANTA CECÍLIA - ZER CERDANYA,17024,170242,BOLVIR,4,0,4
2018/2019,17004891,ESCOLA JOSEP PALLACH,17066,170669,FIGUERES,29,3,32
2018/2019,17004906,ESCOLA SALVADOR ESPRIU,17213,172137,VIDRERES,28,3,31
2018/2019,17004943,ESCOLA MONTFALGARS,17079,170792,GIRONA,24,7,31
2018/2019,17004955,ESCOLA POMPEU FABRA,17095,170950,LLORET DE MAR,31,9,40
2018/2019,17005017,ESCOLA QUATRE VENTS,17023,170237,BLANES,22,8,30
2018/2019,17005029,ESCOLA L'ESQUIROL - ZER VALL DE TER,17112,171122,OGASSA,3,0,3
2018/2019,17005042,INSTITUT CARLES RAHOLA I LLORENS,17079,170792,GIRONA,43,16,59
2018/2019,17005182,ESCOLA CAN PUIG,17015,170157,BANYOLES,27,4,31
2018/2019,17005248,ESCOLA MAS CLARÀ,17022,170221,LA BISBAL D'EMPORDÀ,24,6,30
2018/2019,17005251,INSTITUT EL PEDRÓ,17062,170622,L'ESCALA,29,22,51
2018/2019,17005261,ESCOLA MONTPALAU - ZER EL LLIERCA,17010,170101,ARGELAGUER,4,1,5
2018/2019,17005339,CFA LES BERNARDES,17155,171557,SALT,9,9,18
2018/2019,17005340,EASD D'OLOT,17114,171143,OLOT,24,14,38
2018/2019,17005352,INSTITUT DE PALAMÓS,17118,171181,PALAMÓS,50,33,83
2018/2019,17005364,INSTITUT CAP NORFEU,17152,171523,ROSES,39,23,62
2018/2019,17005376,INSTITUT DE SANTA COLOMA DE FARNERS,17180,171805,SANTA COLOMA DE FARNERS,57,37,94
2018/2019,17005388,INSTITUT VALLVERA,17155,171557,SALT,73,25,98
2018/2019,17005522,ESCOLA VEÏNAT,17155,171557,SALT,20,3,23
2018/2019,17005649,INSTITUT CENDRASSOS,17066,170669,FIGUERES,55,34,89
2018/2019,17005650,INSTITUT DE CASSÀ DE LA SELVA,17044,170448,CASSÀ DE LA SELVA,45,12,57
2018/2019,17005662,INSTITUT SERRALLARGA,17023,170237,BLANES,60,37,97
2018/2019,17005704,INSTITUT ABAT OLIBA,17147,171479,RIPOLL,45,32,77
2018/2019,17005731,INSTITUT S'AGULLA,17023,170237,BLANES,51,23,74
2018/2019,17005741,INSTITUT PERE BORRELL,17141,171411,PUIGCERDÀ,58,25,83
2018/2019,17005893,INSTITUT BOSC DE LA COMA,17114,171143,OLOT,53,31,84
2018/2019,17005911,INSTITUT RAMON COLL I RODÉS,17095,170950,LLORET DE MAR,56,27,83
2018/2019,17005923,INSTITUT MONTGRÍ,17199,171997,TORROELLA DE MONTGRÍ,35,18,53
2018/2019,17006083,INSTITUT CASTELLÓ D'EMPÚRIES,17047,170470,CASTELLÓ D'EMPÚRIES,35,24,59
2018/2019,17006605,INSTITUT MONTSORIU,17009,170097,ARBÚCIES,29,23,52
2018/2019,17006666,INSTITUT PLA DE L'ESTANY,17015,170157,BANYOLES,43,26,69
2018/2019,17006678,INSTITUT CAP DE CREUS,17032,170329,CADAQUÉS,10,4,14
2018/2019,17006681,INSTITUT GERMANS VILA-RIERA,17039,170391,CAMPRODON,10,5,15
2018/2019,17006691,INSTITUT RIDAURA,17048,170486,CASTELL-PLATJA D'ARO,39,15,54
2018/2019,17006708,INSTITUT DE CELRÀ,17049,170499,CELRÀ,44,20,64
2018/2019,17006711,ESCOLA M. ÀNGELS ANGLADA,17066,170669,FIGUERES,14,4,18
2018/2019,17006721,ESCOLA MARTA MATA,17079,170792,GIRONA,27,5,32
2018/2019,17006733,INSTITUT VESCOMTAT DE CABRERA,17083,170834,HOSTALRIC,48,20,68
2018/2019,17006745,INSTITUT DE LA JONQUERA,17086,170865,LA JONQUERA,24,7,31
2018/2019,17006757,INSTITUT DE LLAGOSTERA,17089,170890,LLAGOSTERA,26,20,46
2018/2019,17006769,INSTITUT DE LLANÇÀ,17092,170926,LLANÇÀ,25,20,45
2018/2019,17006770,INSTITUT ROCAGROSSA,17095,170950,LLORET DE MAR,41,27,68
2018/2019,17006782,ESCOLA CARRILET,17117,171175,PALAFRUGELL,30,5,35
2018/2019,17006794,INSTITUT JOAN TRIADÚ,17145,171450,RIBES DE FRESER,6,6,12
2018/2019,17006800,ESCOLA ELS GRECS,17152,171523,ROSES,26,4,30
2018/2019,17006812,INSTITUT DE TOSSA DE MAR,17202,172023,TOSSA DE MAR,22,9,31
2018/2019,17006824,INSTITUT VIDRERES,17213,172137,VIDRERES,36,23,59
2018/2019,17006836,ESCOLA LES MÈLIES,17221,172214,VILAFANT,27,2,29
2018/2019,17006851,INSTITUT ILLA DE RODES,17152,171523,ROSES,38,21,59
2018/2019,17006873,ESCOLA CASTELLUM,17169,171693,SANT JULIÀ DE RAMIS,20,3,23
2018/2019,17006939,INSTITUT SANTA EUGÈNIA,17079,170792,GIRONA,58,48,106
2018/2019,17006940,ESCOLA DE LLIURONA,17003,170031,ALBANYÀ,3,0,3
2018/2019,17006952,ESCOLA LA DRAGA,17015,170157,BANYOLES,28,3,31
2018/2019,17007014,CFA LLORET DE MAR,17095,170950,LLORET DE MAR,5,2,7
2018/2019,17007129,CFA ES PITEUS,17023,170237,BLANES,7,5,12
2018/2019,17007178,CFA MARIA VERDAGUER,17066,170669,FIGUERES,8,1,9
2018/2019,17007181,CFA GIRONA,17079,170792,GIRONA,13,4,17
2018/2019,17007300,INSTITUT LA BISBAL,17022,170221,LA BISBAL D'EMPORDÀ,57,33,90
2018/2019,17007427,ZER TRAMUNTANA,17210,172109,VENTALLÓ,4,0,4
2018/2019,17007439,ZER CERDANYA,17094,170947,LLÍVIA,4,1,5
2018/2019,17007440,ZER VALL DE TER,17177,171772,SANT PAU DE SEGÚRIES,3,2,5
2018/2019,17007452,ZER EL LLIERCA,17165,171655,SANT JAUME DE LLIERCA,3,1,4
2018/2019,17007464,ZER COMTE ARNAU,17170,171707,VALLFOGONA DE RIPOLLÈS,3,0,3
2018/2019,17007488,ZER REQUESENS,17042,170427,CAPMANY,2,2,4
2018/2019,17007518,ZER LES SALINES,17001,170010,AGULLANA,4,0,4
2018/2019,17007531,ZER MONTGRÍ,17018,170182,BELLCAIRE D'EMPORDÀ,3,0,3
2018/2019,17007609,INSTITUT OLIVAR GRAN,17066,170669,FIGUERES,45,29,74
2018/2019,17007658,CFA SANT FELIU DE GUÍXOLS,17160,171609,SANT FELIU DE GUÍXOLS,6,3,9
2018/2019,17007671,CFA LA GARROTXA,17114,171143,OLOT,9,2,11
2018/2019,17007695,ZER EMPORDÀ,17228,172288,VILANANT,3,1,4
2018/2019,17007828,ESCOLA PINYA DE ROSA,17023,170237,BLANES,26,7,33
2018/2019,17007907,ESCOLA JOANA D'EMPÚRIES,17047,170470,CASTELLÓ D'EMPÚRIES,26,2,28
2018/2019,17007919,ESCOLA MAS MASÓ,17155,171557,SALT,34,4,38
2018/2019,17007981,EOI D'OLOT,17114,171143,OLOT,10,0,10
2018/2019,17008006,ESCOLA AMISTAT,17066,170669,FIGUERES,25,5,30
2018/2019,17008018,ESCOLA ARDENYA,17160,171609,SANT FELIU DE GUÍXOLS,28,2,30
2018/2019,17008080,ESCOLA ÀNGELS ALEMANY I BORIS,17095,170950,LLORET DE MAR,40,6,46
2018/2019,17008110,EOI DE SANT FELIU DE GUÍXOLS,17160,171609,SANT FELIU DE GUÍXOLS,6,1,7
2018/2019,17008122,EOI DE BLANES,17023,170237,BLANES,8,1,9
2018/2019,17008134,EOI DE FIGUERES,17066,170669,FIGUERES,7,2,9
2018/2019,17008146,CFA PALAFRUGELL,17117,171175,PALAFRUGELL,5,2,7
2018/2019,17008237,ESCOLA MONTSERRAT VAYREDA,17152,171523,ROSES,25,3,28
2018/2019,17008249,ESCOLA CASTELL DE FARNERS,17180,171805,SANTA COLOMA DE FARNERS,29,2,31
2018/2019,17008274,ESCOLA SA FORCANERA,17023,170237,BLANES,21,2,23
2018/2019,17008286,ESCOLA DOMENY,17079,170792,GIRONA,28,3,31
2018/2019,17008298,ESCOLA EL GEGANT DEL REC,17155,171557,SALT,30,6,36
2018/2019,17008365,CFA PLA DE L'ESTANY,17015,170157,BANYOLES,5,2,7
2018/2019,17008377,CFA RIPOLLÈS,17147,171479,RIPOLL,3,1,4
2018/2019,17008389,CFA LA SELVA,17180,171805,SANTA COLOMA DE FARNERS,5,2,7
2018/2019,17008390,INSTITUT DE VILAFANT,17221,172214,VILAFANT,31,13,44
2018/2019,17008407,INSTITUT SALVADOR SUNYER I AIMERIC,17155,171557,SALT,23,9,32
2018/2019,17008419,ESCOLA LLUMS DEL NORD,17141,171411,PUIGCERDÀ,12,4,16
2018/2019,17008444,ESCOLA PARC DE LES AIGÜES,17066,170669,FIGUERES,28,3,31
2018/2019,17008468,ESCOLA LA SÍNIA,17034,170340,CALONGE I SANT ANTONI,14,1,15
2018/2019,17008471,ESCOLA LES FALGUERES,17049,170499,CELRÀ,28,1,29
2018/2019,17008481,ESCOLA L'ESCULAPI,17062,170622,L'ESCALA,16,1,17
2018/2019,17008493,ESCOLA VALL-LLOBREGA,17209,172095,VALL-LLOBREGA,14,0,14
2018/2019,17008501,ESCOLA ALDRIC,17044,170448,CASSÀ DE LA SELVA,27,2,29
2018/2019,17008523,ESCOLA PI VERD,17117,171175,PALAFRUGELL,29,8,37
2018/2019,17008547,ESCOLA NOVA DE MAÇANET DE LA SELVA,17103,171030,MAÇANET DE LA SELVA,20,2,22
2018/2019,17008641,ESCOLA DE CABANES,17030,170307,CABANES,10,1,11
2018/2019,17008651,INSTITUT DE CALDES DE MALAVELLA,17033,170335,CALDES DE MALAVELLA,23,7,30
2018/2019,17008663,ESCOLA EL BRUEL,17047,170470,CASTELLÓ D'EMPÚRIES,13,3,16
2018/2019,17008675,ESCOLA PERICOT,17079,170792,GIRONA,22,7,29
2018/2019,17008687,ESCOLA LES DEVESES,17155,171557,SALT,31,4,35
2018/2019,17008729,INSTITUT EMPURIABRAVA,17047,170470,CASTELLÓ D'EMPÚRIES,11,3,14
2018/2019,17008778,ESCOLA EL MORROT,17114,171143,OLOT,17,2,19
2018/2019,17008781,ESCOLA LA BENAULA,17033,170335,CALDES DE MALAVELLA,18,0,18
2018/2019,17008808,ESCOLA CARME GUASCH I DARNÉ,17066,170669,FIGUERES,25,4,29
2018/2019,17008821,EOI DE BANYOLES,17015,170157,BANYOLES,4,1,5
2018/2019,17008882,ESCOLA LA BÒBILA,17139,171390,LES PRESES,17,0,17
2018/2019,17008894,ESCOLA ALZINES BALLADORES,17159,171595,SANT FELIU DE BUIXALLEU,15,1,16
2018/2019,17008951,INSTITUT MAÇANET DE LA SELVA,17103,171030,MAÇANET DE LA SELVA,24,9,33
2018/2019,17008997,ESCOLA FORALLAC,17902,179026,FORALLAC,12,3,15
2018/2019,17009126,ESCOLA EL BOSC DE LA PABORDIA,17079,170792,GIRONA,26,3,29
2018/2019,17009138,ESCOLA PUIG DE LES CADIRETES,17089,170890,LLAGOSTERA,29,3,32
2018/2019,17009199,ESCOLA ELS ESTANYS,17193,171931,SILS,11,4,15
2018/2019,17009205,INSTITUT DE VILABLAREIX,17215,172155,VILABLAREIX,32,17,49
2018/2019,17009242,ESCOLA NOU DE QUART,17142,171426,QUART,14,2,16
2018/2019,17009278,ESCOLA FANALS D'ARO,17048,170486,CASTELL-PLATJA D'ARO,13,2,15
2018/2019,17009308,INSTITUT DE SILS,17193,171931,SILS,30,6,36
2018/2019,17009345,ESCOLA CAMINS,17015,170157,BANYOLES,16,2,18
2018/2019,17009473,ZER EMPORDANET-GAVARRES,17130,171306,LA PERA,4,0,4
2018/2019,17009631,ZER CAP DE CREUS,17140,171404,EL PORT DE LA SELVA,3,2,5
2018/2019,17009710,ESCOLA EMPORDANET,17022,170221,LA BISBAL D'EMPORDÀ,17,1,18
2018/2019,17009783,INSTITUT LA MIQUELA,17020,170209,BESCANÓ,23,7,30
2018/2019,17009795,INSTITUT ESCOLA FRANCESC CAMBÓ I BATLLE,17211,172116,VERGES,35,12,47
2018/2019,17009801,INSTITUT ESCOLA SALVADOR VILARRASA,17019,170195,BESALÚ,31,9,40
2018/2019,17009813,INSTITUT ESCOLA MESTRE ANDREU,17167,171674,SANT JOAN DE LES ABADESSES,28,9,37
2018/2019,17009850,ESCOLA LES ARRELS,17155,171557,SALT,29,7,36
2018/2019,17009898,INSTITUT ESCOLA LLORET DE MAR,17095,170950,LLORET DE MAR,52,9,61
2018/2019,17010037,INSTITUT EL BRUC,17146,171463,RIELLS I VIABREA,16,4,20
2018/2019,17010049,ESCOLA BALANDRAU,17079,170792,GIRONA,16,2,18
2018/2019,17010189,INSTITUT VALL DE LLÉMENA,17163,171637,SANT GREGORI,12,9,21
2018/2019,17010414,INSTITUT ERMESSENDA DE GIRONA,17079,170792,GIRONA,33,8,41
2018/2019,17010441,CFA NOU GIRONA,17079,170792,GIRONA,6,4,10
2018/2019,17010451,CFA TRAMUNTANA,17066,170669,FIGUERES,12,6,18
2018/2019,25000031,ESCOLA ANDREU FARRAN - ZER MONTSEC,25002,250024,ÀGER,4,1,5
2018/2019,25000067,ESCOLA MACIÀ-COMPANYS,25003,250030,AGRAMUNT,26,2,28
2018/2019,25000110,ESCOLA ARRELS - ZER L'HORTA DE LLEIDA,25004,250045,ELS ALAMÚS,5,1,6
2018/2019,25000122,ESCOLA SANT ESTEVE - ZER URGELLET,25005,250058,ALÀS I CERC,2,0,2
2018/2019,25000146,ESCOLA MARE DE DÉU DE MONTSERRAT - ZER VALL DE L'ARANYÓ,25006,250061,L'ALBAGÉS,2,1,3
2018/2019,25000158,ESCOLA SANT SALVADOR,25007,250077,ALBATÀRREC,13,3,16
2018/2019,25000161,ESCOLA L'ÀLBER,25008,250083,ALBESA,13,2,15
2018/2019,25000171,ESCOLA ELS AUBIS - ZER RIU SET,25009,250096,L'ALBI,7,1,8
2018/2019,25000183,ESCOLA LA DULA - ZER L'ERAL,25010,250100,ALCANÓ,3,0,3
2018/2019,25000195,ESCOLA COMTES DE TORREGROSSA,25011,250117,ALCARRÀS,35,5,40
2018/2019,25000225,ESCOLA MARE DE DÉU DEL CARME,25012,250122,ALCOLETGE,20,6,26
2018/2019,25000274,ESCOLA D'ALFÉS - ZER L'ERAL,25014,250143,ALFÉS,2,1,3
2018/2019,25000286,ESCOLA SANT BLAI - ZER SERRA LLARGA,25015,250156,ALGERRI,2,1,3
2018/2019,25000316,ESCOLA D'ALINS - ZER ALT PALLARS SOBIRÀ,25017,250175,ALINS,3,0,3
2018/2019,25000341,ESCOLA ANTÒNIA SIMÓ ARNÓ,25019,250194,ALMACELLES,33,4,37
2018/2019,25000468,ESCOLA DOCTOR SERÉS,25023,250236,ALPICAT,28,4,32
2018/2019,25000481,ESCOLA SANT ISIDRE - ZER PONENT,25912,259123,GIMENELLS I EL PLA DE LA FONT,5,1,6
2018/2019,25000511,ESCOLA INOCENCIO PARDOS - ZER PONENT,25912,259123,GIMENELLS I EL PLA DE LA FONT,3,0,3
2018/2019,25000535,ESCOLA LOSERON - ZER VAL D'ARAN,25025,250254,NAUT ARAN,6,0,6
2018/2019,25000559,ESCOLA SANT MARTÍ - ZER VAL D'ARAN,25025,250254,NAUT ARAN,3,0,3
2018/2019,25000560,ESCOLA RUDA - ZER VAL D'ARAN,25025,250254,NAUT ARAN,7,0,7
2018/2019,25000584,ESCOLA SANTA CREU,25027,250273,ANGLESOLA,18,0,18
2018/2019,25000602,ESCOLA ALBIRKA,25029,250292,ARBECA,13,2,15
2018/2019,25000626,ESCOLA ELS TIL.LERS,25033,250334,ARTESA DE LLEIDA,13,3,16
2018/2019,25000638,ESCOLA ELS PLANELLS,25034,250349,ARTESA DE SEGRE,27,3,30
2018/2019,25000675,ESCOLA MARE DE DÉU DE LA GUARDIOLA - ZER EL ROMANÍ,25035,250352,LA SENTIU DE SIÓ,3,0,3
2018/2019,25000699,ESCOLA DE LES AVELLANES - ZER MONTSEC,25037,250371,LES AVELLANES I SANTA LINYA,2,1,3
2018/2019,25000717,ESCOLA DE TARTAREU - ZER MONTSEC,25037,250371,LES AVELLANES I SANTA LINYA,2,0,2
2018/2019,25000730,ESCOLA FRANCESC FELIU,25038,250387,AITONA,23,4,27
2018/2019,25000778,ESCOLA GASPAR DE PORTOLÀ,25040,250404,BALAGUER,25,6,31
2018/2019,25000781,ESCOLA ÀNGEL GUIMERÀ,25040,250404,BALAGUER,17,3,20
2018/2019,25000833,INSTITUT CIUTAT DE BALAGUER,25040,250404,BALAGUER,31,20,51
2018/2019,25000857,ESCOLA LA NOGUERA,25040,250404,BALAGUER,12,5,17
2018/2019,25000869,ESCOLA SANT ROC - ZER RIU ONDARA,25041,250411,BARBENS,6,1,7
2018/2019,25000951,ESCOLA PERE TEIXINÉ - ZER RIU CORB,25046,250463,BELIANES,4,1,5
2018/2019,25000961,ESCOLA BONAVISTA,25047,250479,BELLCAIRE D'URGELL,13,1,14
2018/2019,25000985,ESCOLA RAMON FARRERONS,25048,250485,BELL-LLOC D'URGELL,17,1,18
2018/2019,25001001,ESCOLA SANT BARTOMEU - ZER ESPERNALLAC,25049,250498,BELLMUNT D'URGELL,3,0,3
2018/2019,25001011,ESCOLA VALERI SERRA,25050,250501,BELLPUIG,22,1,23
2018/2019,25001059,ESCOLA MARE DE DÉU DE TALLÓ,25051,250518,BELLVER DE CERDANYA,14,2,16
2018/2019,25001084,ESCOLA JOAQUIM PALACÍN,25052,250523,BELLVÍS,15,2,17
2018/2019,25001096,ESCOLA SANT JOAN,25053,250539,BENAVENT DE SEGRIÀ,15,1,16
2018/2019,25001126,ESCOLA VALLMAJOR - ZER ELAIA,25056,250560,BOVERA,3,0,3
2018/2019,25001138,ESCOLA CASTETH LEON - ZER VAL D'ARAN,25057,250576,ES BÒRDES,4,0,4
2018/2019,25001141,ESCOLA JOAN XXIII,25058,250582,LES BORGES BLANQUES,26,4,30
2018/2019,25001199,ESCOLA SANT RÒC,25059,250595,BOSSÒST,11,1,12
2018/2019,25001229,ESCOLA DOS RIUS - ZER EL JONC,25062,250621,CAMARASA,5,1,6
2018/2019,25001242,ESCOLA CASTELL-CIUTAT - ZER URGELLET,25203,252038,LA SEU D'URGELL,4,0,4
2018/2019,25001254,ESCOLA TIMORELL - ZER VALL DE L'ARANYÓ,25067,250674,CASTELLDANS,6,2,8
2018/2019,25001266,ESCOLA L'ESTEL - ZER VENT SERÈ,25068,250680,CASTELLNOU DE SEANA,4,2,6
2018/2019,25001278,ESCOLA SANTA MARIA - ZER SERRA LLARGA,25069,250693,CASTELLÓ DE FARFANYA,3,1,4
2018/2019,25001281,ESCOLA EL TERRALL - ZER ESPERNALLAC,25070,250707,CASTELLSERÀ,10,0,10
2018/2019,25001291,ESCOLA JAUME BALMES,25072,250729,CERVERA,26,2,28
2018/2019,25001311,INSTITUT ANTONI TORROJA,25072,250729,CERVERA,25,13,38
2018/2019,25001321,ESCOLA MOSSÈN JOSEP ARQUES,25072,250729,CERVERA,27,5,32
2018/2019,25001333,ESCOLA EL CÉRVOL - ZER RIU SET,25073,250735,CERVIÀ DE LES GARRIGUES,5,0,5
2018/2019,25001357,ESCOLA DE CIUTADILLA - ZER GUICIVERVI,25074,250740,CIUTADILLA,2,0,2
2018/2019,25001400,ESCOLA SANT CLIMENT - ZER NARIEDA,25077,250772,COLL DE NARGÓ,4,1,5
2018/2019,25001424,ESCOLA SOL IXENT,25078,250788,CORBINS,15,0,15
2018/2019,25001436,ESCOLA SOL NAIXENT - ZER EL ROMANÍ,25079,250791,CUBELLS,2,1,3
2018/2019,25001473,ESCOLA PORCEL DE CERVERA - ZER PEDRERA,25081,250812,L'ESPLUGA CALBA,2,0,2
2018/2019,25001539,ESCOLA LA CLOSA,25086,250864,ESTERRI D'ÀNEU,13,2,15
2018/2019,25001606,ESCOLA MINYONS D'URGELL,25093,250931,FONDARELLA,12,0,12
2018/2019,25001618,ESCOLA GUILLEM ISARN,25096,250962,LA FULIOLA,12,3,15
2018/2019,25001692,ESCOLA FRANCESC ARENES,25099,250997,GOLMÉS,14,1,15
2018/2019,25001709,ESCOLA SANTA MARGARIDA - ZER ALT BERGUEDÀ,25100,251001,GÓSOL,1,1,2
2018/2019,25001710,ESCOLA DE LA GRANADELLA - ZER ELAIA,25101,251018,LA GRANADELLA,4,1,5
2018/2019,25001722,ESCOLA SANT JAUME - ZER L'OLIVER,25102,251023,LA GRANJA D'ESCARP,6,2,8
2018/2019,25001758,ESCOLA DE GUIMERÀ - ZER GUICIVERVI,25109,251095,GUIMERÀ,1,1,2
2018/2019,25001761,ESCOLA RAMON FAUS I ESTEVE,25110,251109,GUISSONA,32,2,34
2018/2019,25001795,ESCOLA SANT SEBASTIÀ - ZER SERRA LLARGA,25112,251121,IVARS DE NOGUERA,3,1,4
2018/2019,25001801,ESCOLA MARE DE DÉU DE L'HORTA,25113,251137,IVARS D'URGELL,15,1,16
2018/2019,25001886,ESCOLA AESO - ZER PALLARS JUSSÀ,25115,251155,ISONA I CONCA DELLÀ,7,0,7
2018/2019,25001916,ESCOLA L'ESPÍGOL - ZER GARRIGUES ALTES,25118,251180,JUNCOSA,2,1,3
2018/2019,25001928,ESCOLA MANUEL ORTIZ I CASTELLÓ,25119,251193,JUNEDA,23,3,26
2018/2019,25001953,ESCOLA ENRIC FARRENY,25120,251207,LLEIDA,12,4,16
2018/2019,25001990,ESCOLA ANTONI BERGÓS - ZER L'HORTA DE LLEIDA,25120,251207,LLEIDA,3,1,4
2018/2019,25002003,ESCOLA SANTA MARIA DE GARDENY,25120,251207,LLEIDA,25,5,30
2018/2019,25002052,ESCOLA BALÀFIA,25120,251207,LLEIDA,17,3,20
2018/2019,25002064,ESCOLA CAMPS ELISIS,25120,251207,LLEIDA,13,6,19
2018/2019,25002076,ESCOLA CERVANTES,25120,251207,LLEIDA,15,3,18
2018/2019,25002088,ESCOLA RIU SEGRE,25120,251207,LLEIDA,24,8,32
2018/2019,25002091,ESCOLA MAGÍ MORERA I GALÍCIA,25120,251207,LLEIDA,18,4,22
2018/2019,25002106,ESCOLA PARDINYES,25120,251207,LLEIDA,17,3,20
2018/2019,25002121,ESCOLA PRÍNCEP DE VIANA,25120,251207,LLEIDA,17,4,21
2018/2019,25002131,ESCOLA CREU DEL BATLLE - ZER L'HORTA DE LLEIDA,25120,251207,LLEIDA,2,1,3
2018/2019,25002659,ESCOLA SANT JOSEP DE CALASSANÇ,25120,251207,LLEIDA,16,4,20
2018/2019,25002672,ESCOLA DE PRÀCTIQUES I,25120,251207,LLEIDA,13,4,17
2018/2019,25002684,INSTITUT SAMUEL GILI I GAYA,25120,251207,LLEIDA,38,17,55
2018/2019,25002696,INSTITUT MARIUS TORRES,25120,251207,LLEIDA,51,28,79
2018/2019,25002726,INSTITUT GUINDÀVOLS,25120,251207,LLEIDA,38,32,70
2018/2019,25002787,INSTITUT JOAN ORÓ,25120,251207,LLEIDA,40,24,64
2018/2019,25002799,INSTITUT CAPARRELLA,25120,251207,LLEIDA,51,67,118
2018/2019,25002854,ESCOLA EL SEGRIÀ - ZER L'HORTA DE LLEIDA,25120,251207,LLEIDA,7,1,8
2018/2019,25002921,ESCOLA EL VILOT - ZER PONENT,25120,251207,LLEIDA,7,1,8
2018/2019,25002957,ESCOLA ESTUDI ALEJANDRO CASONA,25121,251214,LES,11,0,11
2018/2019,25002970,ESCOLA EL SITJAR,25122,251229,LINYOLA,17,1,18
2018/2019,25002982,ESCOLA DE LLADURS - ZER EL SOLSONÈS,25124,251240,LLADURS,3,1,4
2018/2019,25003019,ESCOLA ARC D'ADÀ - ZER L'OLIVER,25125,251253,LLARDECANS,3,1,4
2018/2019,25003032,ESCOLA DE LLAVORSÍ - ZER ALT PALLARS SOBIRÀ,25126,251266,LLAVORSÍ,4,0,4
2018/2019,25003056,ESCOLA PORTELLA BLANCA - ZER BARIDÀ-BATLLIA,25127,251272,LLES DE CERDANYA,3,0,3
2018/2019,25003093,ESCOLA DE LLOBERA - ZER EL SOLSONÈS,25129,251291,LLOBERA,4,0,4
2018/2019,25003111,ESCOLA DE MASSALCOREIG - ZER L'OLIVER,25131,251312,MASSALCOREIG,4,0,4
2018/2019,25003123,ESCOLA OTOGESA - ZER L'OLIVER,25133,251333,MAIALS,6,2,8
2018/2019,25003135,ESCOLA JOAN ROS I PORTA - ZER EL JONC,25134,251348,MENÀRGUENS,4,1,5
2018/2019,25003147,ESCOLA SANT MIQUEL,25135,251351,MIRALCAMP,13,4,17
2018/2019,25003202,INSTITUT MOLLERUSSA,25137,251370,MOLLERUSSA,30,39,69
2018/2019,25003238,ESCOLA DE BUTSÈNIT - ZER EL SIÓ,25138,251386,MONTGAI,1,1,2
2018/2019,25003241,ESCOLA COLOMINA - ZER EL ROMANÍ,25138,251386,MONTGAI,3,0,3
2018/2019,25003263,ESCOLA PERE SARRET - ZER BARIDÀ-BATLLIA,25139,251399,MONTELLÀ I MARTINET,3,0,3
2018/2019,25003275,ESCOLA RIDOLAINA - ZER BARIDÀ-BATLLIA,25139,251399,MONTELLÀ I MARTINET,6,0,6
2018/2019,25003299,ESCOLA ROSA CAMPÀ,25140,251403,MONTFERRER I CASTELLBÒ,10,2,12
2018/2019,25003305,ESCOLA SANT ISIDRE - ZER LA COMA,25142,251425,MONTOLIU DE LLEIDA,1,2,3
2018/2019,25003330,ESCOLA AIGUADORA - ZER EL SOLSONÈS,25146,251462,NAVÈS,4,1,5
2018/2019,25003469,ESCOLA MIRET I SANS - ZER NARIEDA,25155,251556,ORGANYÀ,7,0,7
2018/2019,25003470,ESCOLA L'ESPÍGOL - ZER MONTSEC,25156,251569,OS DE BALAGUER,6,1,7
2018/2019,25003482,ESCOLA LEANDRE CRISTÒFOL - ZER MONTSEC,25156,251569,OS DE BALAGUER,4,1,5
2018/2019,25003494,ESCOLA ARNAU BERENGUER,25158,251581,EL PALAU D'ANGLESOLA,16,2,18
2018/2019,25003500,ESCOLA DE LES PALLARGUES - ZER LA SEGARRA,25911,259118,ELS PLANS DE SIÓ,4,0,4
2018/2019,25003536,ESCOLA DE LA COMA - ZER EL SOLSONÈS,25163,251636,LA COMA I LA PEDRA,3,0,3
2018/2019,25003551,ESCOLA RAMON GOMBAL - ZER ESPERNALLAC,25164,251641,PENELLES,4,0,4
2018/2019,25003585,ESCOLA SANT MIQUEL - ZER NARIEDA,25165,251654,PERAMOLA,3,0,3
2018/2019,25003627,ESCOLA DE SANT CLIMENT - ZER EL SOLSONÈS,25166,251667,PINELL DE SOLSONÈS,2,1,3
2018/2019,25003652,ESCOLA EL ROSER - ZER PLAURCÉN,25168,251689,EL POAL,6,0,6
2018/2019,25003676,ESCOLA ELS SET FOCS - ZER ELAIA,25170,251706,BELLAGUARDA,2,0,2
2018/2019,25003688,ESCOLA ELS RAIERS,25171,251713,LA POBLA DE SEGUR,24,2,26
2018/2019,25003718,ESCOLA DE PONTS,25172,251728,PONTS,15,6,21
2018/2019,25003755,ESCOLA RIBAGORÇANA,25173,251734,EL PONT DE SUERT,17,0,17
2018/2019,25003792,ESCOLA BLANCA DE VILLALONGA - ZER ALT SEGRIÀ,25174,251749,LA PORTELLA,5,0,5
2018/2019,25003809,ESCOLA MONTALBÀ - ZER RIU CORB,25176,251765,PREIXANA,3,1,4
2018/2019,25003810,ESCOLA DE PREIXENS - ZER EL SIÓ,25177,251771,PREIXENS,2,1,3
2018/2019,25003822,ESCOLA DE LES VENTOSES - ZER EL SIÓ,25177,251771,PREIXENS,1,1,2
2018/2019,25003846,ESCOLA EL PUIG - ZER BARIDÀ-BATLLIA,25179,251790,PRULLANS,3,0,3
2018/2019,25003858,ESCOLA DE PUIGVERD D'AGRAMUNT - ZER EL SIÓ,25181,251811,PUIGVERD D'AGRAMUNT,2,1,3
2018/2019,25003861,ESCOLA SANT JORDI,25182,251826,PUIGVERD DE LLEIDA,12,1,13
2018/2019,25003871,ESCOLA MONTSENT DE PALLARS - ZER ALT PALLARS SOBIRÀ,25183,251832,RIALP,5,1,6
2018/2019,25003895,ESCOLA ELS MINAIRONS - ZER ALT PALLARS SOBIRÀ,25901,259010,VALL DE CARDÓS,6,0,6
2018/2019,25003950,ESCOLA ARNAU MIR - ZER URGELLET,25185,251850,RIBERA D'URGELLET,6,0,6
2018/2019,25003974,ESCOLA DE FREIXINET DE SOLSONA - ZER EL SOLSONÈS,25186,251863,RINER,1,2,3
2018/2019,25004000,ESCOLA LA ROSELLA,25189,251898,ROSSELLÓ,23,2,25
2018/2019,25004024,ESCOLA DE SANAÜJA - ZER LA SEGARRA,25191,251919,SANAÜJA,2,1,3
2018/2019,25004036,ESCOLA L'ESTEL,25192,251924,SANT GUIM DE FREIXENET,12,3,15
2018/2019,25004048,ESCOLA VALL DE LORD,25193,251930,SANT LLORENÇ DE MORUNYS,10,1,11
2018/2019,25004073,ESCOLA MARE DE DÉU DE LA MERCÈ,25194,251945,SANT RAMON,9,2,11
2018/2019,25004085,ESCOLA VALL ONDARA - ZER LA SEGARRA,25905,259059,RIBERA D'ONDARA,3,2,5
2018/2019,25004103,ESCOLA EL TALLAT - ZER RIU CORB,25902,259025,SANT MARTÍ DE RIUCORB,4,2,6
2018/2019,25004115,ESCOLA LA ROCA - ZER L'ERAL,25200,252000,SARROCA DE LLEIDA,3,0,3
2018/2019,25004140,ESCOLA MOSSÈN ALBERT VIVES,25203,252038,LA SEU D'URGELL,26,6,32
2018/2019,25004188,INSTITUT JOAN BRUDIEU,25203,252038,LA SEU D'URGELL,49,33,82
2018/2019,25004218,ESCOLA MIQUEL BARÓ DABAN,25204,252043,SERÒS,19,0,19
2018/2019,25004221,ESCOLA EL TIMÓ - ZER PLAURCÉN,25205,252056,SIDAMON,6,2,8
2018/2019,25004231,ESCOLA DEL SOLERÀS - ZER GARRIGUES ALTES,25206,252069,EL SOLERÀS,3,0,3
2018/2019,25004243,ESCOLA SETELSIS,25207,252075,SOLSONA,27,3,30
2018/2019,25004395,ESCOLA JAUME MIRET,25210,252108,SOSES,16,1,17
2018/2019,25004401,ESCOLA EL ROSER - ZER LA COMA,25211,252115,SUDANELL,7,0,7
2018/2019,25004413,ESCOLA DE SUNYER - ZER L'ERAL,25212,252120,SUNYER,2,1,3
2018/2019,25004462,ESCOLA JACINT VERDAGUER,25217,252173,TÀRREGA,28,2,30
2018/2019,25004498,INSTITUT MANUEL DE PEDROLO,25217,252173,TÀRREGA,37,14,51
2018/2019,25004528,EASD ONDARA,25217,252173,TÀRREGA,15,14,29
2018/2019,25004531,ESCOLA ÀNGEL GUIMERÀ,25217,252173,TÀRREGA,27,4,31
2018/2019,25004565,ESCOLA ALFRED POTRONY,25220,252206,TÉRMENS,13,0,13
2018/2019,25004577,ESCOLA DE TÍRVIA - ZER ALT PALLARS SOBIRÀ,25221,252213,TÍRVIA,1,0,1
2018/2019,25004607,ESCOLA SANT GIL,25223,252234,TORÀ,9,2,11
2018/2019,25004644,ESCOLA ESPÍGOL - ZER RIU ONDARA,25225,252252,TORNABOUS,8,0,8
2018/2019,25004656,ESCOLA DE TORREBESSES - ZER L'ERAL,25226,252265,TORREBESSES,2,1,3
2018/2019,25004711,ESCOLA LA CREU,25228,252287,TORREFARRERA,34,5,39
2018/2019,25004723,ESCOLA LA BASSA,25230,252304,TORREGROSSA,15,2,17
2018/2019,25004747,ESCOLA CARRASSUMADA,25232,252326,TORRES DE SEGRE,15,0,15
2018/2019,25004759,ESCOLA EL ROSER - ZER ALT SEGRIÀ,25233,252332,TORRE-SERONA,3,0,3
2018/2019,25004772,ESCOLA VALLDEFLORS,25234,252347,TREMP,29,2,31
2018/2019,25004826,ESCOLA DE TUIXENT - ZER URGELLET,25910,259101,JOSA I TUIXÉN,3,1,4
2018/2019,25004851,ESCOLA SALVADOR ESPRIU,25240,252402,VALLFOGONA DE BALAGUER,12,2,14
2018/2019,25004863,ESCOLA JARDÍ - ZER GUICIVERVI,25242,252424,VERDÚ,5,3,8
2018/2019,25004929,ESCOLA GARONA,25243,252430,VIELHA E MIJARAN,37,3,40
2018/2019,25004966,ESCOLA RAMON PERELLÓ - ZER GUICIVERVI,25244,252445,VILAGRASSA,7,1,8
2018/2019,25004981,ESCOLA VIDAL I ABAD - ZER ALTA RIBAGORÇA,25245,252458,VILALLER,5,0,5
2018/2019,25005016,ESCOLA MARINADA,25248,252483,VILANOVA DE BELLPUIG,11,3,14
2018/2019,25005053,ESCOLA MARE DE DÉU DEL PUIG DE MEIÀ - ZER EL ROMANÍ,25250,252509,VILANOVA DE MEIÀ,4,0,4
2018/2019,25005065,ESCOLA DE VILANOVA DE SEGRIÀ - ZER ALT SEGRIÀ,25251,252516,VILANOVA DE SEGRIÀ,7,0,7
2018/2019,25005077,ESCOLA MOSSÈN TON CLAVÉ - ZER VENT SERÈ,25252,252521,VILA-SANA,8,0,8
2018/2019,25005090,ESCOLA MESTRAL - ZER ARGELAGA,25254,252542,VILANOVA DE LA BARCA,8,1,9
2018/2019,25005107,ESCOLA SANT BONIFACI - ZER RIU SET,25255,252555,VINAIXA,2,0,2
2018/2019,25005119,ESCOLA PINYANA,25013,250138,ALFARRÀS,20,2,22
2018/2019,25005120,ESCOLA TERESA BERGADÀ,25016,250169,ALGUAIRE,21,2,23
2018/2019,25005132,ESCOLA SANT JORDI,25149,251497,OLIANA,15,0,15
2018/2019,25005144,ESCOLA ÀNGEL SERAFÍ I CASANOVAS,25209,252094,SORT,23,2,25
2018/2019,25005171,ESCOLA MESTRE IGNASI PERAIRE,25137,251370,MOLLERUSSA,25,7,32
2018/2019,25005260,INSTITUT RIBERA DEL SIÓ,25003,250030,AGRAMUNT,24,10,34
2018/2019,25005429,INSTITUT ELS PLANELLS,25034,250349,ARTESA DE SEGRE,26,4,30
2018/2019,25005430,ESCOLA JOAN XXIII,25120,251207,LLEIDA,26,5,31
2018/2019,25005442,INSTITUT ESCOLA DEL TREBALL,25120,251207,LLEIDA,38,31,69
2018/2019,25005454,INSTITUT FRANCESC RIBALTA,25207,252075,SOLSONA,42,17,59
2018/2019,25005491,ESCOLA MAGRANERS,25120,251207,LLEIDA,12,5,17
2018/2019,25005533,ESCOLA PAU CLARIS,25203,252038,LA SEU D'URGELL,20,3,23
2018/2019,25005545,ESCOLA POMPEU FABRA,25137,251370,MOLLERUSSA,27,3,30
2018/2019,25005557,CEE SILOÉ,25137,251370,MOLLERUSSA,9,1,10
2018/2019,25005582,INSTITUT TERRES DE PONENT,25137,251370,MOLLERUSSA,38,10,48
2018/2019,25005673,ESCOLA JOAN MARAGALL,25120,251207,LLEIDA,22,5,27
2018/2019,25005685,INSTITUT LA SEGARRA,25072,250729,CERVERA,47,16,63
2018/2019,25005727,INSTITUT ALMATÀ,25040,250404,BALAGUER,37,18,55
2018/2019,25005880,ESCOLA FREDERIC GODAS,25120,251207,LLEIDA,28,4,32
2018/2019,25005892,ESCOLA MALDANELL - ZER RIU CORB,25130,251305,MALDÀ,1,1,2
2018/2019,25005909,ESCOLA MOSSÈN RAMON MUNTANYOLA - ZER RIU CORB,25154,251543,ELS OMELLS DE NA GAIA,0,2,2
2018/2019,25005910,ESCOLA ABAT RUERA - ZER PEDRERA,25180,251804,PUIGGRÒS,3,1,4
2018/2019,25005983,ESCOLA SANT SERNI - ZER BARIDÀ-BATLLIA,25175,251752,PRATS I SANSOR,3,1,4
2018/2019,25006069,ESCOLA D'ARDÈVOL - ZER EL SOLSONÈS,25167,251673,PINÓS,3,0,3
2018/2019,25006148,INSTITUT D'OSTALARIA DE LES-VAL D'ARAN,25121,251214,LES,5,5,10
2018/2019,25006227,INSTITUT D'ALMENAR,25021,250215,ALMENAR,28,15,43
2018/2019,25006239,INSTITUT D'ARAN,25243,252430,VIELHA E MIJARAN,34,18,52
2018/2019,25006240,INSTITUT EL PONT DE SUERT,25173,251734,EL PONT DE SUERT,26,18,44
2018/2019,25006252,EOI DE LLEIDA,25120,251207,LLEIDA,31,10,41
2018/2019,25006264,ESCOLA ESPIGA,25120,251207,LLEIDA,25,3,28
2018/2019,25006276,ESCOLA SANT JORDI,25120,251207,LLEIDA,12,4,16
2018/2019,25006288,INSTITUT DE TREMP,25234,252347,TREMP,33,19,52
2018/2019,25006291,INSTITUT HUG ROGER III,25209,252094,SORT,27,9,36
2018/2019,25006409,ESCOLA JOC DE LA BOLA,25120,251207,LLEIDA,30,2,32
2018/2019,25006410,CFA SEGRIÀ,25120,251207,LLEIDA,7,4,11
2018/2019,25006471,INSTITUT AUBENÇ,25149,251497,OLIANA,11,6,17
2018/2019,25006483,INSTITUT CANIGÓ,25019,250194,ALMACELLES,28,15,43
2018/2019,25006495,INSTITUT JOSEP LLADONOSA,25120,251207,LLEIDA,33,22,55
2018/2019,25006501,ESCOLA ALBA,25078,250788,CORBINS,25,4,29
2018/2019,25006513,INSTITUT MANUEL DE MONTSUAR,25120,251207,LLEIDA,31,13,44
2018/2019,25006525,INSTITUT JOSEP VALLVERDÚ,25058,250582,LES BORGES BLANQUES,45,20,65
2018/2019,25006549,ESCOLA D'ESPLUGA DE SERRA - ZER ALTA RIBAGORÇA,25234,252347,TREMP,2,0,2
2018/2019,25006574,INSTITUT DE PONTS,25172,251728,PONTS,14,9,23
2018/2019,25006598,INSTITUT LO PLA D'URGELL,25050,250501,BELLPUIG,29,16,45
2018/2019,25006720,INSTITUT D'HOTELERIA I TURISME,25120,251207,LLEIDA,12,19,31
2018/2019,25006732,INSTITUT TORREVICENS,25120,251207,LLEIDA,99,22,121
2018/2019,25006744,CEE ESPERANÇA,25120,251207,LLEIDA,8,5,13
2018/2019,25006771,INSTITUT RONDA,25120,251207,LLEIDA,66,17,83
2018/2019,25006781,INSTITUT ALFONS COSTAFREDA,25217,252173,TÀRREGA,41,32,73
2018/2019,25007025,INSTITUT MORELLÓ,25086,250864,ESTERRI D'ÀNEU,7,5,12
2018/2019,25007153,INSTITUT D'ALCARRÀS,25011,250117,ALCARRÀS,39,19,58
2018/2019,25007189,INSTITUT MARIA RÚBIES,25120,251207,LLEIDA,41,21,62
2018/2019,25007499,INSTITUT L'OLIVERA,25101,251018,LA GRANADELLA,6,6,12
2018/2019,25007505,INSTITUT DE GUISSONA,25110,251109,GUISSONA,44,22,66
2018/2019,25007517,INSTITUT LA SERRA,25137,251370,MOLLERUSSA,38,20,58
2018/2019,25007529,INSTITUT SERÒS,25204,252043,SERÒS,24,10,34
2018/2019,25007611,CFA JOAN CARLES I,25120,251207,LLEIDA,8,3,11
2018/2019,25007700,INSTITUT ERMENGOL IV,25047,250479,BELLCAIRE D'URGELL,25,6,31
2018/2019,25007761,ZER GUICIVERVI,25244,252445,VILAGRASSA,4,0,4
2018/2019,25007773,ZER LA SEGARRA,25905,259059,RIBERA D'ONDARA,2,2,4
2018/2019,25007797,ZER BARIDÀ-BATLLIA,25139,251399,MONTELLÀ I MARTINET,2,2,4
2018/2019,25007803,ZER ALT PALLARS SOBIRÀ,25126,251266,LLAVORSÍ,4,0,4
2018/2019,25007815,ZER ELAIA,25101,251018,LA GRANADELLA,2,1,3
2018/2019,25007827,ZER NARIEDA,25155,251556,ORGANYÀ,3,1,4
2018/2019,25007839,ZER PALLARS JUSSÀ,25115,251155,ISONA I CONCA DELLÀ,2,2,4
2018/2019,25007840,ZER MONTSEC,25037,250371,LES AVELLANES I SANTA LINYA,3,1,4
2018/2019,25007852,ZER EL SIÓ,25138,251386,MONTGAI,3,1,4
2018/2019,25007864,ZER URGELLET,25203,252038,LA SEU D'URGELL,2,1,3
2018/2019,25007876,ZER RIU CORB,25046,250463,BELIANES,2,2,4
2018/2019,25007888,ZER GARRIGUES ALTES,25118,251180,JUNCOSA,1,2,3
2018/2019,25007891,ZER ALTA RIBAGORÇA,25245,252458,VILALLER,4,1,5
2018/2019,25007906,ZER SERRA LLARGA,25015,250156,ALGERRI,2,2,4
2018/2019,25007918,ZER L'OLIVER,25133,251333,MAIALS,3,1,4
2018/2019,25007921,ZER L'HORTA DE LLEIDA,25120,251207,LLEIDA,4,0,4
2018/2019,25007931,ZER VAL D'ARAN,25025,250254,NAUT ARAN,3,1,4
2018/2019,25007943,ZER PLAURCÉN,25168,251689,EL POAL,3,1,4
2018/2019,25007992,ESCOLA D'ALMENAR,25021,250215,ALMENAR,20,4,24
2018/2019,25008042,ZER RIU SET,25009,250096,L'ALBI,3,1,4
2018/2019,25008054,ZER VALL DE L'ARANYÓ,25067,250674,CASTELLDANS,2,1,3
2018/2019,25008066,ZER ESPERNALLAC,25070,250707,CASTELLSERÀ,3,1,4
2018/2019,25008078,ZER EL ROMANÍ,25138,251386,MONTGAI,2,2,4
2018/2019,25008081,ZER EL JONC,25062,250621,CAMARASA,3,2,5
2018/2019,25008091,ZER VENT SERÈ,25068,250680,CASTELLNOU DE SEANA,3,1,4
2018/2019,25008108,ZER L'ERAL,25200,252000,SARROCA DE LLEIDA,4,0,4
2018/2019,25008111,ZER LA COMA,25211,252115,SUDANELL,3,0,3
2018/2019,25008133,ZER PONENT,25120,251207,LLEIDA,3,1,4
2018/2019,25008145,ZER ALT SEGRIÀ,25251,252516,VILANOVA DE SEGRIÀ,3,1,4
2018/2019,25008157,ZER RIU ONDARA,25225,252252,TORNABOUS,3,1,4
2018/2019,25008212,ESCOLA PRÀCTIQUES II,25120,251207,LLEIDA,28,2,30
2018/2019,25008224,ZER ARGELAGA,25254,252542,VILANOVA DE LA BARCA,2,1,3
2018/2019,25008236,ZER PEDRERA,25081,250812,L'ESPLUGA CALBA,2,1,3
2018/2019,25008248,INSTITUT DE SANT LLORENÇ DE MORUNYS,25193,251930,SANT LLORENÇ DE MORUNYS,3,3,6
2018/2019,25008352,INSTITUT DE LA POBLA DE SEGUR,25171,251713,LA POBLA DE SEGUR,23,14,37
2018/2019,25008534,ESCOLA DE LA VALL DE BOÍ - ZER ALTA RIBAGORÇA,25043,250432,LA VALL DE BOÍ,7,0,7
2018/2019,25008546,EOI DE TÀRREGA,25217,252173,TÀRREGA,5,1,6
2018/2019,25008558,EOI DE LA SEU D'URGELL,25203,252038,LA SEU D'URGELL,6,2,8
2018/2019,25008561,CFA BALAGUER,25040,250404,BALAGUER,1,3,4
2018/2019,25008571,CFA JOAN COMORERA,25072,250729,CERVERA,1,3,4
2018/2019,25008583,CFA LA SEU D'URGELL,25203,252038,LA SEU D'URGELL,5,1,6
2018/2019,25008595,CFA TÀRREGA,25217,252173,TÀRREGA,4,2,6
2018/2019,25008625,CFA MOLLERUSSA,25137,251370,MOLLERUSSA,7,2,9
2018/2019,25008649,ESCOLA FRANCESCO TONUCCI,25120,251207,LLEIDA,16,2,18
2018/2019,25008741,CFA VAL D'ARAN,25243,252430,VIELHA E MIJARAN,3,0,3
2018/2019,25008753,CFA SOLSONÈS,25207,252075,SOLSONA,6,0,6
2018/2019,25008765,ESCOLA LA VALL FOSCA - ZER PALLARS JUSSÀ,25227,252271,LA TORRE DE CABDELLA,6,0,6
2018/2019,25008777,ESCOLA PARC DE L'AIGUA,25120,251207,LLEIDA,25,6,31
2018/2019,25008789,ESCOLA MONT-ROIG,25040,250404,BALAGUER,22,3,25
2018/2019,25008790,ESCOLA MARIA-MERCÈ MARÇAL,25217,252173,TÀRREGA,16,6,22
2018/2019,25008893,ESCOLA PARC DEL SALADAR,25011,250117,ALCARRÀS,29,5,34
2018/2019,25008923,CFA ENRIC GRANADOS,25120,251207,LLEIDA,8,7,15
2018/2019,25008935,ESCOLA LA RÀPITA - ZER EL JONC,25240,252402,VALLFOGONA DE BALAGUER,5,0,5
2018/2019,25008984,CFA TREMP,25234,252347,TREMP,3,0,3
2018/2019,25009009,ZER EL SOLSONÈS,25207,252075,SOLSONA,3,2,5
2018/2019,25009034,ESCOLA CIUTAT JARDÍ,25120,251207,LLEIDA,25,4,29
2018/2019,25009071,ESCOLA PAÏSOS CATALANS,25120,251207,LLEIDA,28,3,31
2018/2019,25009095,ESCOLA LES SAVINES,25072,250729,CERVERA,16,1,17
2018/2019,25009101,ESCOLA EL VINYET,25207,252075,SOLSONA,16,1,17
2018/2019,25009113,ESCOLA MESTRE RAMON ESTADELLA I TORRADEFLOT,25110,251109,GUISSONA,22,1,23
2018/2019,25009149,ESCOLA PINYANA,25120,251207,LLEIDA,19,6,25
2018/2019,25009186,INSTITUT LA VALIRA,25203,252038,LA SEU D'URGELL,12,8,20
2018/2019,25009344,ESCOLA LA MITJANA,25120,251207,LLEIDA,27,2,29
2018/2019,25009356,ESCOLA LES ARRELS,25137,251370,MOLLERUSSA,15,3,18
2018/2019,25009368,ESCOLA LA VALIRA,25203,252038,LA SEU D'URGELL,9,1,10
2018/2019,25009721,INSTITUT D'ALPICAT,25023,250236,ALPICAT,9,3,12
2018/2019,25009733,INSTITUT JOAN SOLÀ,25228,252287,TORREFARRERA,34,15,49
2018/2019,25009800,ESCOLA TORRELAMEU - ZER ARGELAGA,25231,252311,TORRELAMEU,5,0,5
2018/2019,25009836,INSTITUT LA MITJANA,25120,251207,LLEIDA,41,8,49
2018/2019,25010085,ESCOLA JOSEP MAÑÉ I GAVALDÀ - ZER PONENT,25120,251207,LLEIDA,4,0,4
2018/2019,25010127,INSTITUT CASTELL DELS TEMPLERS,25120,251207,LLEIDA,17,14,31
2018/2019,25010231,ESCOLA DE SALÀS DE PALLARS - ZER PALLARS JUSSÀ,25190,251902,SALÀS DE PALLARS,3,0,3
2018/2019,25010280,INSTITUT ESCOLA TORRE QUERALT,25120,251207,LLEIDA,25,10,35
2018/2019,43000020,ESCOLA SANT MIQUEL,43001,430017,AIGUAMÚRCIA,7,1,8
2018/2019,43000081,ESCOLA JOAN BAPTISTA SERRA,43004,430043,ALCANAR,43,5,48
2018/2019,43000135,ESCOLA MARE DE DÉU DEL REMEI,43005,430056,ALCOVER,32,4,36
2018/2019,43000184,ESCOLA TERESA SALVAT I LLAURADÓ - ZER BAIX CAMP NORD,43007,430075,L'ALEIXAR,6,0,6
2018/2019,43000214,ESCOLA JOSEP FUSTÉ,43009,430094,ALFORJA,16,0,16
2018/2019,43000226,ESCOLA LA BARQUERA - ZER ATZAVARA,43010,430108,ALIÓ,4,0,4
2018/2019,43000251,ESCOLA LA PORTALADA,43012,430120,ALTAFULLA,27,2,29
2018/2019,43000263,ESCOLA SANT JORDI,43013,430136,L'AMETLLA DE MAR,34,7,41
2018/2019,43000275,ESCOLA MIQUEL GRANELL,43014,430141,AMPOSTA,24,7,31
2018/2019,43000329,INSTITUT RAMON BERENGUER IV,43014,430141,AMPOSTA,53,26,79
2018/2019,43000378,ESCOLA SANT JULIÀ,43016,430167,L'ARBOÇ,24,8,32
2018/2019,43000421,ESCOLA LA MIRANDA - ZER PORTS-ALGARS,43018,430189,ARNES,3,1,4
2018/2019,43000433,ESCOLA SANT MIQUEL,43019,430192,ASCÓ,13,2,15
2018/2019,43000470,ESCOLA VALLDEMUR - ZER CONCA DE BARBERÀ,43021,430213,BARBERÀ DE LA CONCA,6,0,6
2018/2019,43000512,ESCOLA EL SARRAÍ - ZER BAIX PRIORAT,43023,430234,BELLMUNT DEL PRIORAT,2,0,2
2018/2019,43000548,ESCOLA LA MUNTANYETA,43024,430249,BELLVEI,15,5,20
2018/2019,43000551,ESCOLA LLORENÇ VALLESPÍ I VIDIELLA - ZER RIU I SERRA,43025,430252,BENIFALLET,5,0,5
2018/2019,43000561,ESCOLA ANTONI NAT - ZER BENISSANET-MIRAVET,43026,430265,BENISSANET,7,1,8
2018/2019,43000597,ESCOLA ULL DEL VENT,43028,430287,LA BISBAL DEL PENEDÈS,18,6,24
2018/2019,43000603,ESCOLA DE BLANCAFORT - ZER POBLET,43029,430290,BLANCAFORT,2,2,4
2018/2019,43000615,ESCOLA L'ESTEL - ZER ELS CEPS,43030,430304,BONASTRE,2,5,7
2018/2019,43000627,ESCOLA ROCABRUNA,43031,430311,LES BORGES DEL CAMP,12,5,17
2018/2019,43000639,ESCOLA SANT BLAI - ZER TERRA ALTA-CENTRE,43032,430326,BOT,4,0,4
2018/2019,43000640,ESCOLA MARE DE DÉU DE LA CANDELA,43033,430332,BOTARELL,15,0,15
2018/2019,43000652,ESCOLA SANT JAUME DE BRÀFIM - ZER ATZAVARA,43034,430347,BRÀFIM,4,3,7
2018/2019,43000676,ESCOLA EL CASTELL - ZER MONTSANT,43035,430350,CABACÉS,3,0,3
2018/2019,43000688,ESCOLA DE CABRA DEL CAMP - ZER LA PARELLADA,43036,430363,CABRA DEL CAMP,3,2,5
2018/2019,43000706,ESCOLA SANTA CREU DE CALAFELL,43037,430379,CALAFELL,26,10,36
2018/2019,43000721,ESCOLA MOSSÈN JACINT VERDAGUER,43037,430379,CALAFELL,27,6,33
2018/2019,43000731,ESCOLA JOAN ARDÈVOL,43038,430385,CAMBRILS,21,8,29
2018/2019,43000779,INSTITUT RAMON BERENGUER IV,43038,430385,CAMBRILS,41,22,63
2018/2019,43000792,ESCOLA SANT ISIDRE - ZER LES VINYES,43040,430402,CAPÇANES,3,1,4
2018/2019,43000809,ESCOLA LA GESSERA - ZER PORTS-ALGARS,43041,430419,CASERES,2,1,3
2018/2019,43000871,ESCOLA JAUME I,43044,430445,LA SÉNIA,33,5,38
2018/2019,43000895,ESCOLA MOSSÈN RAMON BERGADÀ,43047,430477,CONSTANTÍ,28,8,36
2018/2019,43000950,ESCOLA DOCTOR FERRAN - ZER TERRA ALTA-CENTRE,43048,430483,CORBERA D'EBRE,6,2,8
2018/2019,43000962,ESCOLA DR. PIÑOL I AGUADÉ - ZER MONTSANT-SERRA DE PRADES,43049,430496,CORNUDELLA DE MONTSANT,8,1,9
2018/2019,43000998,ESCOLA POMPEU FABRA,43051,430516,CUNIT,22,5,27
2018/2019,43001000,ESCOLA DE XERTA,43052,430521,XERTA,8,1,9
2018/2019,43001036,ESCOLA MARTÍ POCH,43054,430542,L'ESPLUGA DE FRANCOLÍ,14,2,16
2018/2019,43001051,ESCOLA ANTONI VILANOVA,43055,430555,FALSET,23,5,28
2018/2019,43001097,ESCOLA LOS CASTELLETS - ZER TERRA ALTA NORD,43056,430568,LA FATARELLA,8,0,8
2018/2019,43001115,ESCOLA MARE DE DÉU DE L'ESPERANÇA - ZER LA PARELLADA,43059,430593,FIGUEROLA DEL CAMP,5,0,5
2018/2019,43001127,ESCOLA ENRIC GRAU I FONTSERÈ,43060,430607,FLIX,16,4,20
2018/2019,43001231,ESCOLA PUIG CAVALLER,43064,430640,GANDESA,19,7,26
2018/2019,43001280,ESCOLA PÀMIES - ZER LA FONT DE L'AIGUADÍ,43067,430672,GINESTAR,6,0,6
2018/2019,43001310,ESCOLA LLICORELLA - ZER L'AGLÀ,43069,430691,GRATALLOPS,3,0,3
2018/2019,43001334,ESCOLA SANT FELIU - ZER LES VINYES,43070,430705,ELS GUIAMETS,3,0,3
2018/2019,43001346,ESCOLA MONTSAGRE,43071,430712,HORTA DE SANT JOAN,8,2,10
2018/2019,43001361,ESCOLA LES COMETES,43074,430748,LLORENÇ DEL PENEDÈS,19,5,24
2018/2019,43001383,ESCOLA ANICET VILLAR - ZER LES VINYES,43076,430764,MARÇÀ,4,0,4
2018/2019,43001395,ESCOLA TERESA SUBIRATS I MESTRE - ZER MONTSIÀ,43077,430770,MAS DE BARBERANS,3,1,4
2018/2019,43001437,ESCOLA ROSA GISBERT - ZER MONTSIÀ,43078,430786,MASDENVERGE,6,2,8
2018/2019,43001462,ESCOLA ELS TIL·LERS - ZER EL FRANCOLÍ,43080,430803,LA MASÓ,3,0,3
2018/2019,43001498,ESCOLA ONZE DE SETEMBRE - ZER BAIX PRIORAT,43082,430825,EL MASROIG,4,0,4
2018/2019,43001553,ESCOLA LES MURALLES,43086,430862,MONTBLANC,30,5,35
2018/2019,43001607,ESCOLA JOSEP M. SOLER I GENÉ,43088,430884,MONTBRIÓ DEL CAMP,19,4,23
2018/2019,43001656,ESCOLA TERESA GODES I DOMÈNECH,43090,430901,EL MONTMELL,12,3,15
2018/2019,43001668,ESCOLA MARE DE DÉU DE LA ROCA,43092,430923,MONT-ROIG DEL CAMP,28,6,34
2018/2019,43001681,ESCOLA LLUÍS VIÑAS I VIÑOLES,43093,430939,MÓRA D'EBRE,27,4,31
2018/2019,43001735,ESCOLA VENTURA GASSOL,43095,430957,EL MORELL,29,4,33
2018/2019,43001796,ESCOLA SANT SEBASTIÀ - ZER ATZAVARA,43098,430982,NULLES,5,2,7
2018/2019,43001826,ESCOLA SANT SEBASTIÀ,43100,431009,ELS PALLARESOS,21,5,26
2018/2019,43001851,ESCOLA SANT ROC - ZER RIU I SERRA,43102,431021,PAÜLS,4,2,6
2018/2019,43001929,ESCOLA JAUME II,43104,431042,EL PERELLÓ,16,7,23
2018/2019,43001942,ESCOLA CÈSAR MARTINELL - ZER TERRA ALTA-CENTRE,43106,431068,EL PINELL DE BRAI,5,1,6
2018/2019,43001954,ESCOLA ANTONI TOUS - ZER CONCA DE BARBERÀ,43107,431074,PIRA,5,2,7
2018/2019,43001966,ESCOLA SANT RAMON,43108,431080,EL PLA DE SANTA MARIA,12,4,16
2018/2019,43002016,ESCOLA L'AMETLLER - ZER TERRA ALTA NORD,43110,431107,LA POBLA DE MASSALUCA,3,0,3
2018/2019,43002053,ESCOLA GARBÍ - ZER MONTSANT-SERRA DE PRADES,43112,431129,POBOLEDA,3,0,3
2018/2019,43002144,ESCOLA MARE DE DÉU DE LA FONTCALDA - ZER PORTS-ALGARS,43117,431172,PRAT DE COMTE,3,0,3
2018/2019,43002171,ESCOLA JOAN PLANA,43119,431191,PUIGPELAT,13,2,15
2018/2019,43002211,ESCOLA PRAT DE LA RIBA,43123,431233,REUS,16,2,18
2018/2019,43002235,ESCOLA POMPEU FABRA,43123,431233,REUS,17,4,21
2018/2019,43002247,ESCOLA MISERICÒRDIA,43123,431233,REUS,16,5,21
2018/2019,43002259,ESCOLA MARIÀ FORTUNY,43123,431233,REUS,30,7,37
2018/2019,43002260,ESCOLA CIUTAT DE REUS,43123,431233,REUS,9,3,12
2018/2019,43002272,ESCOLA GENERAL PRIM,43123,431233,REUS,22,5,27
2018/2019,43002570,INSTITUT GAUDÍ,43123,431233,REUS,58,19,77
2018/2019,43002582,INSTITUT SALVADOR VILASECA,43123,431233,REUS,45,17,62
2018/2019,43002594,INSTITUT BAIX CAMP,43123,431233,REUS,91,49,140
2018/2019,43002661,ESCOLA SANT AGUSTÍ - ZER EBRE,43125,431251,RIBA-ROJA D'EBRE,8,0,8
2018/2019,43002752,ESCOLA BEAT BONAVENTURA GRAN,43129,431299,RIUDOMS,28,2,30
2018/2019,43002776,ESCOLA SALVADOR ESPRIU,43131,431310,RODA DE BERÀ,18,8,26
2018/2019,43002831,ESCOLA MESTRE MARCEL·LÍ DOMINGO,43133,431331,ROQUETES,33,9,42
2018/2019,43002892,ESCOLA CARLES III,43136,431362,SANT CARLES DE LA RÀPITA,40,5,45
2018/2019,43003008,ESCOLA JAUME BALMES,43138,431384,SANTA BÀRBARA,19,7,26
2018/2019,43003011,ESCOLA COR DE ROURE,43139,431397,SANTA COLOMA DE QUERALT,12,4,16
2018/2019,43003069,ESCOLA SALVADOR NINOT,43142,431423,SARRAL,14,2,16
2018/2019,43003082,ESCOLA GUILLEM DE CLARAMUNT,43144,431444,LA SECUITA,13,2,15
2018/2019,43003100,ESCOLA ABEL FERRATER,43145,431457,LA SELVA DEL CAMP,28,5,33
2018/2019,43003124,ESCOLA SAGRAT COR - ZER CONCA DE BARBERÀ,43147,431476,SOLIVELLA,4,1,5
2018/2019,43003136,ESCOLA BONAVISTA,43148,431482,TARRAGONA,35,5,40
2018/2019,43003185,ESCOLA LA CANONJA,43907,439076,LA CANONJA,35,6,41
2018/2019,43003227,ESCOLA SANT SALVADOR,43148,431482,TARRAGONA,26,7,33
2018/2019,43003306,ESCOLA SERRALLO,43148,431482,TARRAGONA,19,2,21
2018/2019,43003321,ESCOLA SANT PERE I SANT PAU,43148,431482,TARRAGONA,20,3,23
2018/2019,43003641,INSTITUT ANTONI DE MARTÍ I FRANQUÈS,43148,431482,TARRAGONA,72,38,110
2018/2019,43003653,INSTITUT COMTE DE RIUS,43148,431482,TARRAGONA,42,52,94
2018/2019,43003690,ESCOLA DE PRÀCTIQUES,43148,431482,TARRAGONA,25,5,30
2018/2019,43003720,ESCOLA EL MIRACLE,43148,431482,TARRAGONA,17,0,17
2018/2019,43003732,INSTITUT PONS D'ICART,43148,431482,TARRAGONA,38,17,55
2018/2019,43003756,ESCOLA TORREFORTA,43148,431482,TARRAGONA,24,8,32
2018/2019,43003768,ESCOLA ELS ÀNGELS,43148,431482,TARRAGONA,36,5,41
2018/2019,43003801,ESCOLA LA PINEDA - ZER RIU AVALL,43149,431495,TIVENYS,6,0,6
2018/2019,43003835,ESCOLA JOSEP RIBA - ZER LES VINYES,43150,431508,TIVISSA,3,1,4
2018/2019,43003847,ESCOLA MARCEL·LÍ DOMINGO,43150,431508,TIVISSA,11,1,12
2018/2019,43003884,ESCOLA ANTONI ROIG,43153,431536,TORREDEMBARRA,28,4,32
2018/2019,43003951,ESCOLA BÍTEM - ZER RIU AVALL,43155,431554,TORTOSA,7,2,9
2018/2019,43003975,ESCOLA SANT ÀNGEL,43903,439039,CAMARLES,14,3,17
2018/2019,43003987,ESCOLA PORT RODÓ - ZER MESTRAL,43155,431554,TORTOSA,7,2,9
2018/2019,43004013,ESCOLA SANT MIQUEL,43901,439018,DELTEBRE,28,4,32
2018/2019,43004037,ESCOLA MARIA GARCÍA I CABANES,43904,439044,L'ALDEA,13,3,16
2018/2019,43004050,ESCOLA 21 D'ABRIL,43904,439044,L'ALDEA,16,1,17
2018/2019,43004074,ESCOLA L'ASSUMPCIÓ,43901,439018,DELTEBRE,18,8,26
2018/2019,43004116,ESCOLA DEL LLIGALLO DEL GÀNGUIL - ZER MESTRAL,43903,439039,CAMARLES,7,1,8
2018/2019,43004189,ESCOLA SANT JAUME,43902,439023,SANT JAUME D'ENVEJA,18,2,20
2018/2019,43004232,ESCOLA LA MERCÈ,43155,431554,TORTOSA,20,3,23
2018/2019,43004244,ESCOLA EL TEMPLE,43155,431554,TORTOSA,32,5,37
2018/2019,43004256,ESCOLA FERRERIES,43155,431554,TORTOSA,24,10,34
2018/2019,43004268,ESCOLA REMOLINS,43155,431554,TORTOSA,18,3,21
2018/2019,43004438,INSTITUT DERTOSA,43155,431554,TORTOSA,51,44,95
2018/2019,43004441,INSTITUT DE L'EBRE,43155,431554,TORTOSA,53,54,107
2018/2019,43004463,ESCOLA RAMÓN Y CAJAL,43156,431567,ULLDECONA,35,9,44
2018/2019,43004487,ESCOLA MONTSANT - ZER MONTSANT-SERRA DE PRADES,43157,431573,ULLDEMOLINS,3,1,4
2018/2019,43004505,ESCOLA MARE DE DÉU DEL ROSER,43160,431606,VALLMOLL,12,3,15
2018/2019,43004517,ESCOLA ROCABRUNA - ZER EL FRANCOLÍ,43161,431613,VALLS,6,1,7
2018/2019,43004529,ESCOLA MARE DE DÉU DE LA CANDELA,43161,431613,VALLS,15,5,20
2018/2019,43004530,ESCOLA BALTASAR SEGÚ,43161,431613,VALLS,17,4,21
2018/2019,43004608,INSTITUT NARCÍS OLLER,43161,431613,VALLS,55,28,83
2018/2019,43004611,INSTITUT JAUME HUGUET,43161,431613,VALLS,59,42,101
2018/2019,43004633,ESCOLA EUGENI D'ORS,43161,431613,VALLS,29,2,31
2018/2019,43004657,ESCOLA MESTRAL,43162,431628,VANDELLÒS I L'HOSPITALET DE L'INFANT,35,7,42
2018/2019,43004700,ESCOLA VALDELORS,43162,431628,VANDELLÒS I L'HOSPITALET DE L'INFANT,7,2,9
2018/2019,43004736,ESCOLA ELS SECALLETS,43163,431634,EL VENDRELL,15,4,19
2018/2019,43004748,ESCOLA ÀNGEL GUIMERÀ,43163,431634,EL VENDRELL,29,9,38
2018/2019,43004797,INSTITUT BAIX PENEDÈS,43163,431634,EL VENDRELL,42,29,71
2018/2019,43004803,INSTITUT ANDREU NIN,43163,431634,EL VENDRELL,66,55,121
2018/2019,43004815,ESCOLA PAU CASALS,43163,431634,EL VENDRELL,25,6,31
2018/2019,43004864,ESCOLA PERE VIRGILI,43166,431665,VILALLONGA DEL CAMP,23,4,27
2018/2019,43004888,ESCOLA FONT DE L'ARC - ZER BAIX CAMP SUD,43167,431671,VILANOVA D'ESCORNALBOU,5,1,6
2018/2019,43004921,ESCOLA BERNARDÍ TOLRÀ,43170,431704,VILA-RODONA,14,2,16
2018/2019,43004931,ESCOLA SANTA MARIA DEL MAR,43905,439057,SALOU,23,8,31
2018/2019,43004979,ESCOLA TORROJA I MIRET,43171,431711,VILA-SECA,28,3,31
2018/2019,43005005,ESCOLA SANT BERNAT CALVÓ,43171,431711,VILA-SECA,26,3,29
2018/2019,43005017,ESCOLA DEL MONTGOI - ZER POBLET,43172,431726,VILAVERD,2,2,4
2018/2019,43005081,ESCOLA MARE DE DÉU DELS TORRENTS - ZER POBLET,43176,431763,VIMBODÍ I POBLET,6,2,8
2018/2019,43005108,ESCOLA LES ERES - ZER RIBERA D'EBRE NORD,43177,431779,VINEBRE,5,0,5
2018/2019,43005121,ESCOLA SANTA CATERINA,43178,431785,VINYOLS I ELS ARCS,13,4,17
2018/2019,43005133,ESCOLA MARE DE DÉU DEL PRIORAT,43020,430206,BANYERES DEL PENEDÈS,15,4,19
2018/2019,43005145,ESCOLA ELS AMETLLERS,43111,431114,LA POBLA DE MONTORNÈS,12,5,17
2018/2019,43005157,ESCOLA MONTOLIU,43126,431264,LA RIERA DE GAIÀ,14,2,16
2018/2019,43005169,ESCOLA PAU DELCLÒS,43148,431482,TARRAGONA,23,7,30
2018/2019,43005170,ESCOLA LA FLORESTA,43148,431482,TARRAGONA,14,2,16
2018/2019,43005194,ESCOLA MEDITERRANI,43906,439060,L'AMPOLLA,14,3,17
2018/2019,43005224,ESCOLA MESTRE AGUSTÍ BARBERÀ,43014,430141,AMPOSTA,25,6,31
2018/2019,43005297,ESCOLA JOAN PERUCHO,43002,430022,ALBINYANA,10,5,15
2018/2019,43005303,ESCOLA SANT JORDI - ZER RIU I SERRA,43006,430069,ALDOVER,6,0,6
2018/2019,43005315,ESCOLA D'ALFARA DE CARLES - ZER MONT CARO,43008,430081,ALFARA DE CARLES,4,0,4
2018/2019,43005327,ESCOLA RAMON SUGRAÑES,43011,430115,ALMOSTER,10,6,16
2018/2019,43005339,ESCOLA MONTSANT - ZER MONTSANT,43027,430271,LA BISBAL DE FALSET,3,0,3
2018/2019,43005340,ESCOLA SANTA ANNA,43042,430424,CASTELLVELL DEL CAMP,20,2,22
2018/2019,43005364,ESCOLA LES ERES,43050,430509,CREIXELL,16,5,21
2018/2019,43005376,ESCOLA PUIGMARÍ - ZER BAIX CAMP SUD,43053,430537,DUESAIGÜES,3,0,3
2018/2019,43005388,ESCOLA MESTRE JOSEP RONCERO I PALLARÈS - ZER MONTSIÀ,43062,430629,FREGINALS,3,1,4
2018/2019,43005391,ESCOLA SANT LLORENÇ - ZER MONTSIÀ,43063,430635,LA GALERA,4,3,7
2018/2019,43005406,ESCOLA EL VERGER - ZER RIBERA D'EBRE NORD,43065,430653,GARCIA,5,1,6
2018/2019,43005418,ESCOLA SANT SALVADOR - ZER MONTSIÀ,43068,430688,GODALL,4,0,4
2018/2019,43005421,ESCOLA BERENGUER DE MONTOLIU - ZER ELS CEPS,43079,430799,MASLLORENÇ,5,0,5
2018/2019,43005443,ESCOLA ROC LLOP I CONVALIA - ZER BENISSANET-MIRAVET,43084,430846,MIRAVET,5,0,5
2018/2019,43005455,ESCOLA PIUS XII - ZER L'AGLÀ,43085,430859,EL MOLAR,2,1,3
2018/2019,43005467,ESCOLA LES CODINETES,43097,430976,LA NOU DE GAIÀ,9,4,13
2018/2019,43005479,ESCOLA 1 D'ABRIL - ZER EBRE,43099,430995,LA PALMA D'EBRE,3,0,3
2018/2019,43005480,ESCOLA MARE DE DÉU DEL LLEDÓ,43109,431093,LA POBLA DE MAFUMET,22,7,29
2018/2019,43005492,ESCOLA SANTA MAGDALENA - ZER LA PARELLADA,43113,431135,EL PONT D'ARMENTERA,3,2,5
2018/2019,08001832,ESCOLA CASTELLA,08019,080193,BARCELONA,19,2,21
2018/2019,43005509,ESCOLA ROSSEND GIOL - ZER BAIX PRIORAT,43114,431140,PORRERA,3,0,3
2018/2019,43005510,ESCOLA SERRA DE PRADES - ZER MONTSANT-SERRA DE PRADES,43116,431166,PRADES,5,0,5
2018/2019,43005522,ESCOLA SANTA MARINA,43118,431188,PRATDIP,5,3,8
2018/2019,43005534,ESCOLA LES ERES DE RASQUERA - ZER LA FONT DE L'AIGUADÍ,43121,431212,RASQUERA,7,0,7
2018/2019,43005546,ESCOLA DE LA RIBA - ZER EL FRANCOLÍ,43124,431248,LA RIBA,2,4,6
2018/2019,43005558,ESCOLA SANT MATEU,43127,431270,RIUDECANYES,10,2,12
2018/2019,43005561,ESCOLA MARE DE DÉU DEL ROSER,43128,431286,RIUDECOLS,8,2,10
2018/2019,43005571,ESCOLA LES COMES,43132,431325,RODONYÀ,12,2,14
2018/2019,43005583,ESCOLA ELS QUATRE VENTS,43137,431378,SANT JAUME DELS DOMENYS,20,4,24
2018/2019,43005595,ESCOLA LA PARELLADA,43140,431401,SANTA OLIVA,21,5,26
2018/2019,43005601,ESCOLA EL TORMO - ZER RIBERA D'EBRE NORD,43152,431520,LA TORRE DE L'ESPANYOL,5,0,5
2018/2019,43005613,ESCOLA SETZE DE FEBRER - ZER MEDITERRÀNIA,43902,439023,SANT JAUME D'ENVEJA,3,0,3
2018/2019,43005625,ESCOLA SANT ANTONI ABAT - ZER MONT CARO,43155,431554,TORTOSA,6,0,6
2018/2019,43005637,ESCOLA MANUEL DE CASTELLVÍ I FELIU - ZER ATZAVARA,43165,431652,VILABELLA,7,0,7
2018/2019,43005650,ESCOLA EL DIVÍ MESTRE - ZER TERRA ALTA NORD,43175,431750,VILALBA DELS ARCS,3,2,5
2018/2019,43005662,ESCOLA JOSEP NIN,43135,431359,SALOMÓ,8,3,11
2018/2019,43005674,ESCOLA RAVAL DE CRISTO - ZER MONT CARO,43133,431331,ROQUETES,5,2,7
2018/2019,43005686,ESCOLA RIU CLAR,43148,431482,TARRAGONA,14,4,18
2018/2019,43005698,ESCOLA MARJAL - ZER MEDITERRÀNIA,43004,430043,ALCANAR,7,2,9
2018/2019,43005704,INSTITUT FRANCESC VIDAL I BARRAQUER,43148,431482,TARRAGONA,64,41,105
2018/2019,43005753,ESCOLA DOCTOR ALBERICH I CASAS,43123,431233,REUS,29,5,34
2018/2019,43005765,ESCOLA EDUARD TODA I GÜELL,43123,431233,REUS,27,2,29
2018/2019,43005893,ESCOLA CENTCELLES,43047,430477,CONSTANTÍ,17,8,25
2018/2019,43005901,ESCOLA JOAN REBULL,43123,431233,REUS,38,4,42
2018/2019,43005911,ESCOLA CAMPCLAR,43148,431482,TARRAGONA,27,2,29
2018/2019,43005935,ESCOLA SANT BERNAT CALVÓ,43123,431233,REUS,26,7,33
2018/2019,43005947,ESCOLA CAL·LÍPOLIS,43171,431711,VILA-SECA,26,3,29
2018/2019,43005959,ESCOLA CÈSAR AUGUST,43148,431482,TARRAGONA,36,4,40
2018/2019,43005972,INSTITUT RAMON BARBAT I MIRACLE,43171,431711,VILA-SECA,38,30,68
2018/2019,43006046,ESCOLA DIVINA PASTORA - ZER MESTRAL,43155,431554,TORTOSA,3,0,3
2018/2019,43006061,ESCOLA RUBIÓ I ORS,43123,431233,REUS,29,7,36
2018/2019,43006101,INSTITUT MONTSIÀ,43014,430141,AMPOSTA,43,44,87
2018/2019,43006125,INSTITUT CAMPCLAR,43148,431482,TARRAGONA,47,21,68
2018/2019,43006174,ESCOLA LES MORERES,43001,430017,AIGUAMÚRCIA,7,1,8
2018/2019,43006186,ESCOLA SORIANO MONTAGUT,43014,430141,AMPOSTA,26,5,31
2018/2019,43006216,ESCOLA CÈLIA ARTIGA,43123,431233,REUS,15,1,16
2018/2019,43006228,ESCOLA ROSA SENSAT,43123,431233,REUS,18,2,20
2018/2019,43006241,ESCOLA LA PLANA,43171,431711,VILA-SECA,10,2,12
2018/2019,43006332,ESCOLA MESTRAL,43171,431711,VILA-SECA,26,3,29
2018/2019,43006356,ESCOLA MARINADA,43038,430385,CAMBRILS,27,3,30
2018/2019,43006371,ESCOLA SANT ROC - ZER CONCA DE BARBERÀ,43130,431303,ROCAFORT DE QUERALT,2,1,3
2018/2019,43006393,ESCOLA EUROPA,43905,439057,SALOU,23,6,29
2018/2019,43006496,INSTITUT MANUEL SALES I FERRÉ,43156,431567,ULLDECONA,26,14,40
2018/2019,43006541,ESCOLA TERESA MIQUEL I PÀMIES,43123,431233,REUS,24,6,30
2018/2019,43006551,ESCOLA HORTA VELLA,43136,431362,SANT CARLES DE LA RÀPITA,24,6,30
2018/2019,43006563,ESCOLA MARCEL·LÍ DOMINGO,43148,431482,TARRAGONA,25,3,28
2018/2019,43006575,ESCOLA ELADI HOMS,43161,431613,VALLS,23,1,24
2018/2019,43006587,ESCOLA ÀNGELS GARRIGA,43163,431634,EL VENDRELL,36,5,41
2018/2019,43006617,INSTITUT JOAN AMIGÓ I CALLAU,43054,430542,L'ESPLUGA DE FRANCOLÍ,16,8,24
2018/2019,43006630,INSTITUT PERE MARTELL,43148,431482,TARRAGONA,29,87,116
2018/2019,43006642,INSTITUT TERRA ALTA,43064,430640,GANDESA,35,17,52
2018/2019,43006654,INSTITUT CAMBRILS,43038,430385,CAMBRILS,32,15,47
2018/2019,43006678,INSTITUT GABRIEL FERRATER I SOLER,43123,431233,REUS,45,36,81
2018/2019,43006681,INSTITUT DE LA SÉNIA,43044,430445,LA SÉNIA,31,15,46
2018/2019,43006691,INSTITUT PRIORAT,43055,430555,FALSET,28,14,42
2018/2019,43006708,INSTITUT JOAN SEGURA I VALLS,43139,431397,SANTA COLOMA DE QUERALT,12,7,19
2018/2019,43006851,ESCOLA MOLÍ DE VENT,43153,431536,TORREDEMBARRA,28,3,31
2018/2019,43006861,ESCOLA ENXANETA,43161,431613,VALLS,15,1,16
2018/2019,43006873,ESCOLA RIUMAR,43901,439018,DELTEBRE,11,5,16
2018/2019,43006940,EOI DE TARRAGONA,43148,431482,TARRAGONA,28,7,35
2018/2019,43006952,INSTITUT TORREDEMBARRA,43153,431536,TORREDEMBARRA,35,21,56
2018/2019,43006964,INSTITUT DE DELTEBRE,43901,439018,DELTEBRE,43,18,61
2018/2019,43006976,INSTITUT MARE DE DÉU DE LA CANDELERA,43013,430136,L'AMETLLA DE MAR,25,19,44
2018/2019,43006988,CEE GARBÍ,43163,431634,EL VENDRELL,16,1,17
2018/2019,43007038,INSTITUT ESCOLA D'HOTELERIA I TURISME,43038,430385,CAMBRILS,24,28,52
2018/2019,43007051,CFA JOSEPA MASSANÉS I DALMAU,43148,431482,TARRAGONA,5,6,11
2018/2019,43007087,INSTITUT SÒL DE RIU,43004,430043,ALCANAR,25,22,47
2018/2019,43007105,ESCOLA MONTSANT,43123,431233,REUS,14,2,16
2018/2019,43007117,ESCOLA PAX,43148,431482,TARRAGONA,26,4,30
2018/2019,43007129,INSTITUT JULIO ANTONIO,43093,430939,MÓRA D'EBRE,31,25,56
2018/2019,43007166,INSTITUT LLUÍS DOMÈNECH I MONTANER,43123,431233,REUS,46,41,87
2018/2019,43007178,ESCOLA MOWGLI,43123,431233,REUS,14,3,17
2018/2019,43007208,INSTITUT BERENGUER D'ENTENÇA,43162,431628,VANDELLÒS I L'HOSPITALET DE L'INFANT,33,13,46
2018/2019,43007211,INSTITUT BLANCA D'ANJOU,43104,431042,EL PERELLÓ,12,9,21
2018/2019,43007221,INSTITUT ELS ALFACS,43136,431362,SANT CARLES DE LA RÀPITA,47,27,74
2018/2019,43007233,INSTITUT DE FLIX,43060,430607,FLIX,25,19,44
2018/2019,43007257,INSTITUT CAMÍ DE MAR,43037,430379,CALAFELL,55,29,84
2018/2019,43007385,INSTITUT D'HORTICULTURA I JARDINERIA,43123,431233,REUS,13,19,32
2018/2019,43007543,INSTITUT JAUME I,43905,439057,SALOU,58,23,81
2018/2019,43007580,INSTITUT DE L'ARBOÇ,43016,430167,L'ARBOÇ,32,31,63
2018/2019,43007646,INSTITUT DE CONSTANTÍ,43047,430477,CONSTANTÍ,31,11,42
2018/2019,43007658,INSTITUT JOAN GUINJOAN I GISPERT,43129,431299,RIUDOMS,36,24,60
2018/2019,43007661,INSTITUT RAMON DE LA TORRE,43153,431536,TORREDEMBARRA,42,21,63
2018/2019,43008389,ESCOLA SANT LLATZER,43155,431554,TORTOSA,12,1,13
2018/2019,43008390,INSTITUT TORREFORTA,43148,431482,TARRAGONA,38,17,55
2018/2019,43008407,INSTITUT EL MORELL,43095,430957,EL MORELL,31,19,50
2018/2019,43008419,INSTITUT CAMARLES,43903,439039,CAMARLES,27,13,40
2018/2019,43008420,INSTITUT ROQUETES,43133,431331,ROQUETES,45,21,66
2018/2019,43008432,INSTITUT SANT PERE I SANT PAU,43148,431482,TARRAGONA,38,15,53
2018/2019,43008444,INSTITUT JOSEP TAPIRÓ,43123,431233,REUS,44,19,63
2018/2019,43008456,INSTITUT LES PLANES,43138,431384,SANTA BÀRBARA,19,12,31
2018/2019,43008481,INSTITUT COLLBLANC,43907,439076,LA CANONJA,39,21,60
2018/2019,43008501,INSTITUT PONT DEL DIABLE,43148,431482,TARRAGONA,33,7,40
2018/2019,43008511,INSTITUT JOAN PUIG I FERRETER,43145,431457,LA SELVA DEL CAMP,34,16,50
2018/2019,43008523,INSTITUT VILA-SECA,43171,431711,VILA-SECA,30,23,53
2018/2019,43008535,ESCOLA SOLCUNIT,43051,430516,CUNIT,21,8,29
2018/2019,43008547,ESCOLA CAMBRILS,43038,430385,CAMBRILS,27,3,30
2018/2019,43008638,INSTITUT ANTONI BALLESTER,43092,430923,MONT-ROIG DEL CAMP,23,12,35
2018/2019,43008699,INSTITUT MONTSANT,43049,430496,CORNUDELLA DE MONTSANT,6,6,12
2018/2019,43008729,CFA TARRAGONA,43148,431482,TARRAGONA,9,4,13
2018/2019,43008754,CFA SEBASTIÀ JUAN ARBÓ,43014,430141,AMPOSTA,4,2,6
2018/2019,43008857,CFA REUS,43123,431233,REUS,5,5,10
2018/2019,43008912,ESCOLA CINTA CURTO,43155,431554,TORTOSA,15,2,17
2018/2019,43008924,ESCOLA TERESINA MARTORELL,43163,431634,EL VENDRELL,20,11,31
2018/2019,43009001,ZER MONTSANT-SERRA DE PRADES,43049,430496,CORNUDELLA DE MONTSANT,3,1,4
2018/2019,43009011,ZER RIU AVALL,43149,431495,TIVENYS,4,0,4
2018/2019,43009023,ZER L'AGLÀ,43069,430691,GRATALLOPS,3,0,3
2018/2019,43009035,ZER ATZAVARA,43098,430982,NULLES,3,1,4
2018/2019,43009047,ZER BAIX PRIORAT,43114,431140,PORRERA,4,1,5
2018/2019,43009059,ZER BAIX CAMP NORD,43007,430075,L'ALEIXAR,3,2,5
2018/2019,43009072,ZER CONCA DE BARBERÀ,43147,431476,SOLIVELLA,4,1,5
2018/2019,43009084,ZER MONTSIÀ,43078,430786,MASDENVERGE,5,0,5
2018/2019,43009096,ZER ELS CEPS,43079,430799,MASLLORENÇ,2,2,4
2018/2019,43009114,ZER EL FRANCOLÍ,43161,431613,VALLS,3,0,3
2018/2019,43009126,ZER BAIX CAMP SUD,43167,431671,VILANOVA D'ESCORNALBOU,3,1,4
2018/2019,43009138,ZER LA PARELLADA,43059,430593,FIGUEROLA DEL CAMP,4,0,4
2018/2019,43009141,ZER POBLET,43176,431763,VIMBODÍ I POBLET,4,0,4
2018/2019,43009187,INSTITUT MARTÍ L'HUMÀ,43086,430862,MONTBLANC,36,22,58
2018/2019,43009217,ESCOLA DEL POBLE NOU DEL DELTA - ZER MEDITERRÀNIA,43014,430141,AMPOSTA,3,0,3
2018/2019,43009229,ZER PORTS-ALGARS,43018,430189,ARNES,1,2,3
2018/2019,43009230,ESCOLA TARRAGONA,43148,431482,TARRAGONA,21,3,24
2018/2019,43009242,ESCOLA L'ANTINA,43153,431536,TORREDEMBARRA,26,4,30
2018/2019,43009308,ZER MEDITERRÀNIA,43004,430043,ALCANAR,2,2,4
2018/2019,43009311,ZER MONT CARO,43155,431554,TORTOSA,3,0,3
2018/2019,43009321,ZER RIU I SERRA,43025,430252,BENIFALLET,1,2,3
2018/2019,43009345,ZER RIBERA D'EBRE NORD,43065,430653,GARCIA,3,1,4
2018/2019,43009369,ESCOLA SAAVEDRA,43148,431482,TARRAGONA,17,2,19
2018/2019,43009370,ZER TERRA ALTA NORD,43175,431750,VILALBA DELS ARCS,4,0,4
2018/2019,43009394,ZER LA FONT DE L'AIGUADÍ,43067,430672,GINESTAR,3,1,4
2018/2019,43009451,ESCOLA SALOU,43905,439057,SALOU,26,3,29
2018/2019,43009461,ZER TERRA ALTA-CENTRE,43048,430483,CORBERA D'EBRE,2,2,4
2018/2019,43009497,INSTITUT FONTS DEL GLORIETA,43005,430056,ALCOVER,19,13,32
2018/2019,43009606,ZER BENISSANET-MIRAVET,43026,430265,BENISSANET,2,2,4
2018/2019,43009618,ZER MESTRAL,43155,431554,TORTOSA,3,1,4
2018/2019,43009710,EOI DE REUS,43123,431233,REUS,9,2,11
2018/2019,43009722,INSTITUT CAL·LÍPOLIS,43148,431482,TARRAGONA,73,30,103
2018/2019,43009771,CFA TORTOSA,43155,431554,TORTOSA,5,3,8
2018/2019,43009850,INSTITUT ERNEST LLUCH I MARTÍ,43051,430516,CUNIT,50,28,78
2018/2019,43009862,EOI DE TORTOSA,43155,431554,TORTOSA,7,4,11
2018/2019,43009886,ESCOLA JOSEP VECIANA,43103,431037,PERAFORT,16,1,17
2018/2019,43009898,ESCOLA CASTELL DE CALAFELL,43037,430379,CALAFELL,23,6,29
2018/2019,43009977,INSTITUT D'ALTAFULLA,43012,430120,ALTAFULLA,34,22,56
2018/2019,43010037,EOI DEL VENDRELL,43163,431634,EL VENDRELL,6,1,7
2018/2019,43010062,CFA EL VENDRELL,43163,431634,EL VENDRELL,4,2,6
2018/2019,43010074,CFA VALLS,43161,431613,VALLS,4,3,7
2018/2019,43010086,CFA VILASECA,43171,431711,VILA-SECA,4,2,6
2018/2019,43010098,ESCOLA LA GINESTA,43037,430379,CALAFELL,25,6,31
2018/2019,43010141,ESCOLA GUILLEM FORTUNY,43038,430385,CAMBRILS,25,5,30
2018/2019,43010153,ESCOLA VORA MAR,43905,439057,SALOU,30,4,34
2018/2019,43010165,ESCOLA MARTA MATA,43163,431634,EL VENDRELL,22,9,31
2018/2019,43010177,ESCOLA PLA DE MAR,43163,431634,EL VENDRELL,14,3,17
2018/2019,43010189,INSTITUT MEDITERRÀNIA,43163,431634,EL VENDRELL,29,16,45
2018/2019,43010220,ESCOLA DE MASPUJOLS,43081,430810,MASPUJOLS,13,1,14
2018/2019,43010311,CFA RIBERA D'EBRE,43093,430939,MÓRA D'EBRE,3,4,7
2018/2019,43010323,CFA MONTBLANC,43086,430862,MONTBLANC,3,1,4
2018/2019,43010335,INSTITUT LA MAR DE LA FRAU,43038,430385,CAMBRILS,30,14,44
2018/2019,43010347,INSTITUT MARTA MATA,43905,439057,SALOU,34,10,44
2018/2019,43010372,INSTITUT LA TALAIA,43037,430379,CALAFELL,30,20,50
2018/2019,43010396,ESCOLA DE PONENT,43148,431482,TARRAGONA,24,1,25
2018/2019,43010402,ESCOLA EL ROQUISSAR,43012,430120,ALTAFULLA,13,4,17
2018/2019,43010414,INSTITUT COSTER DE LA TORRE,43028,430287,LA BISBAL DEL PENEDÈS,41,18,59
2018/2019,43010487,ESCOLA MARCEL·LÍ ESQUIUS,43092,430923,MONT-ROIG DEL CAMP,13,3,16
2018/2019,43010499,CFA PAU CASALS,43043,430430,EL CATLLAR,10,6,16
2018/2019,43010505,ESCOLA LA VITXETA,43123,431233,REUS,25,4,29
2018/2019,43010529,ESCOLA CAVALLER ARNAU,43129,431299,RIUDOMS,16,2,18
2018/2019,43010530,ESCOLA MIRAMAR,43171,431711,VILA-SECA,27,3,30
2018/2019,43010554,ZER LES VINYES,43076,430764,MARÇÀ,1,3,4
2018/2019,43010578,INSTITUT FONTANELLES,43031,430311,LES BORGES DEL CAMP,34,15,49
2018/2019,43010581,ESCOLA MAS CLARIANA,43038,430385,CAMBRILS,26,3,29
2018/2019,43010591,ESCOLA ARQUITECTE JUJOL,43100,431009,ELS PALLARESOS,14,3,17
2018/2019,43010608,INSTITUT SERRA DE MIRAMAR,43161,431613,VALLS,25,14,39
2018/2019,43010621,ESCOLA CINGLE ROIG - ZER BAIX CAMP NORD,43169,431690,VILAPLANA,3,1,4
2018/2019,43010669,EOI D'AMPOSTA,43014,430141,AMPOSTA,6,1,7
2018/2019,43010670,EOI DE VALLS,43161,431613,VALLS,6,0,6
2018/2019,43010748,INSTITUT ELS PALLARESOS,43100,431009,ELS PALLARESOS,31,21,52
2018/2019,43010773,ESCOLA CONSOL FERRÉ,43014,430141,AMPOSTA,22,8,30
2018/2019,43010815,ESCOLA ELS COSSETANS,43051,430516,CUNIT,21,2,23
2018/2019,43010839,ESCOLA SERRA MAJOR - ZER L'AGLÀ,43174,431747,LA VILELLA BAIXA,3,0,3
2018/2019,43010852,INSTITUT ROSETA MAURI,43123,431233,REUS,47,7,54
2018/2019,43010864,ESCOLA ISABEL BESORA,43123,431233,REUS,25,6,31
2018/2019,43010876,ESCOLA L'ARRABASSADA,43148,431482,TARRAGONA,28,1,29
2018/2019,43010888,INSTITUT DE TECNIFICACIÓ,43014,430141,AMPOSTA,25,21,46
2018/2019,43010980,EOI RIBERA D'EBRE,43093,430939,MÓRA D'EBRE,3,1,4
2018/2019,43011029,ZER EBRE,43125,431251,RIBA-ROJA D'EBRE,3,1,4
2018/2019,43011121,ESCOLA VILAMAR,43037,430379,CALAFELL,14,4,18
2018/2019,43011145,ESCOLA ELS GANXETS,43123,431233,REUS,16,3,19
2018/2019,43011170,INSTITUT CRISTÒFOL DESPUIG,43155,431554,TORTOSA,36,11,47
2018/2019,43011194,ESCOLA EL CUCURULL,43131,431310,RODA DE BERÀ,14,2,16
2018/2019,43011200,EOI DE SALOU,43905,439057,SALOU,6,0,6
2018/2019,43011212,ESCOLA LA BÒBILA,43038,430385,CAMBRILS,25,5,30
2018/2019,43011303,ZER MONTSANT,43035,430350,CABACÉS,3,1,4
2018/2019,43011418,INSTITUT RODA DE BERÀ,43131,431310,RODA DE BERÀ,15,16,31
2018/2019,43011479,INSTITUT TARRAGONA,43148,431482,TARRAGONA,38,17,55
2018/2019,43011492,ESCOLA LA CANALETA,43171,431711,VILA-SECA,26,3,29
2018/2019,43012083,INSTITUT ESCOLA PI DEL BURGAR,43123,431233,REUS,42,14,56
2018/2019,43012095,ESCOLA JOAN MIRÓ,43092,430923,MONT-ROIG DEL CAMP,28,1,29
2018/2019,43012113,INSTITUT ESCOLA MARE DE DÉU DEL PORTAL,43022,430228,BATEA,23,8,31
2018/2019,43012289,INSTITUT ESCOLA 3 D'ABRIL,43094,430944,MÓRA LA NOVA,31,8,39
2018/2019,43012307,INSTITUT ESCOLA DANIEL MANGRANÉ,43155,431554,TORTOSA,40,15,55
2018/2019,43012769,CEE FONT DEL LLEÓ,43123,431233,REUS,12,0,12
2018/2019,43012812,INSTITUT ESCOLA L'AGULLA,43043,430430,EL CATLLAR,38,7,45
2018/2019,43012903,ESCOLA EL BOSC - ZER EL FRANCOLÍ,43091,430918,MONT-RAL,2,0,2
2018/2019,43012976,INSTITUT ESCOLA MEDITERRANI,43148,431482,TARRAGONA,21,5,26
2018/2019,43012988,INSTITUT DE MIAMI,43092,430923,MONT-ROIG DEL CAMP,19,8,27
2018/2019,08001650,ESCOLA EL POLVORÍ,08019,080193,BARCELONA,14,2,16
2018/2019,08002575,ESCOLA LA PAU,08019,080193,BARCELONA,17,2,19
2018/2019,08043292,ESCOLA TABOR,08019,080193,BARCELONA,23,7,30
2018/2019,08000013,ESCOLA FRANCESC PLATÓN I SARTÍ,08001,080018,ABRERA,33,6,39
2018/2019,08000049,ESCOLA FABRA,08003,080039,ALELLA,26,2,28
2018/2019,08000086,ESCOLA LA FORJA - ZER ALT LLUÇANÈS,08004,080044,ALPENS,4,0,4
2018/2019,08000098,ESCOLA BERTÍ,08005,080057,L'AMETLLA DEL VALLÈS,23,1,24
2018/2019,08000153,ESCOLA JOAN MARAGALL,08006,080060,ARENYS DE MAR,34,4,38
2018/2019,08000165,ESCOLA SANT MARTÍ,08007,080076,ARENYS DE MUNT,22,8,30
2018/2019,08000189,ESCOLA BERNAT DE RIUDEMEIA,08009,080095,ARGENTONA,14,2,16
2018/2019,08000244,ESCOLA DOCTOR FERRER,08010,080109,ARTÉS,26,3,29
2018/2019,08000271,ESCOLA SANTA MARIA D'AVIÀ,08011,080116,AVIÀ,19,2,21
2018/2019,08000323,ESCOLA BARNOLA,08012,080121,AVINYÓ,12,4,16
2018/2019,08000347,ESCOLA D'AVINYONET DEL PENEDÈS,08013,080137,AVINYONET DEL PENEDÈS,10,1,11
2018/2019,08000359,ESCOLA LA MUNTANYA,08014,080142,AIGUAFREDA,17,1,18
2018/2019,08000372,ESCOLA SANT JORDI,08015,080155,BADALONA,13,3,16
2018/2019,08000384,ESCOLA LOLA ANGLADA,08015,080155,BADALONA,30,1,31
2018/2019,08000396,ESCOLA VENTÓS I MIR,08015,080155,BADALONA,17,5,22
2018/2019,08000402,ESCOLA FELIU I VEGUÉS,08015,080155,BADALONA,27,6,33
2018/2019,08000414,ESCOLA ALEXANDRE GALÍ,08015,080155,BADALONA,22,6,28
2018/2019,08001391,ESCOLA PLANAS I CASALS,08015,080155,BADALONA,23,6,29
2018/2019,08001421,INSTITUT LA PINEDA,08015,080155,BADALONA,52,49,101
2018/2019,08001431,INSTITUT ISAAC ALBÉNIZ,08015,080155,BADALONA,30,31,61
2018/2019,08001443,INSTITUT EUGENI D'ORS,08015,080155,BADALONA,44,31,75
2018/2019,08001480,EASD PAU GARGALLO,08015,080155,BADALONA,26,24,50
2018/2019,08001509,ESCOLA ANTONI BOTEY,08015,080155,BADALONA,36,2,38
2018/2019,08001522,ESCOLA GALCERAN DE PINÓS,08016,080168,BAGÀ,13,1,14
2018/2019,08001534,ESCOLA JOAN XXIII,08017,080174,BALENYÀ,23,3,26
2018/2019,08001583,ESCOLA GUILLEM DE BALSARENY,08018,080180,BALSARENY,14,2,16
2018/2019,08001595,ESCOLA BAIXERAS,08019,080193,BARCELONA,17,2,19
2018/2019,08001601,ESCOLA PARC DE LA CIUTADELLA,08019,080193,BARCELONA,16,2,18
2018/2019,08001649,ESCOLA MOSSÈN JACINT VERDAGUER,08019,080193,BARCELONA,33,4,37
2018/2019,08001820,ESCOLA MILÀ I FONTANALS,08019,080193,BARCELONA,32,4,36
2018/2019,08001819,ESCOLA COLLASO I GIL,08019,080193,BARCELONA,30,7,37
2018/2019,08001807,ESCOLA DE LA CONCEPCIÓ,08019,080193,BARCELONA,12,4,16
2018/2019,08001790,ESCOLA PERE VILA,08019,080193,BARCELONA,30,9,39
2018/2019,08001789,ESCOLA CERVANTES,08019,080193,BARCELONA,17,1,18
2018/2019,08001777,ESCOLA RAMON LLULL,08019,080193,BARCELONA,30,4,34
2018/2019,08001731,ESCOLA POETA FOIX,08019,080193,BARCELONA,17,1,18
2018/2019,08001716,ESCOLA DOLORS MONSERDÀ-SANTAPAU,08019,080193,BARCELONA,25,4,29
2018/2019,08001674,ESCOLA CAN CLOS,08019,080193,BARCELONA,14,1,15
